miles	Noun	miles m pl
militar	Noun	militar m, f (plural militares)
yapa	Noun	yapa f (plural yapas)
fax	Noun	fax m (plural fax)
miga	Noun	miga f (plural migas)
pica	Noun	pica f (plural picas)
tarifa	Noun	tarifa f (plural tarifas)
rito	Noun	rito m (plural ritos)
pago	Noun	pago m (plural pagos)
pago	Noun	pago m (plural pagos)
hampa	Noun	hampa f (plural hampas)
termosfera	Noun	termosfera f (plural termosferas)
agorafobia	Noun	agorafobia f (uncountable)
sudoku	Noun	sudoku m (plural sudokus)
inglés	Noun	inglés m (plural ingleses, feminine inglesa)
feto	Noun	feto m (plural fetos)
pedofilia	Noun	pedofilia f (plural pedofilias)
dialectos	Noun	dialectos m pl
pandemia	Noun	pandemia f (plural pandemias)
hazara	Noun	hazara m, f (plural hazaras)
rotor	Noun	rotor m (plural rotores)
sommelier	Noun	sommelier m (plural sommeliers)
brigada	Noun	brigada f (plural brigadas)
pote	Noun	pote m (plural potes)
longitud	Noun	longitud f (plural longitudes)
tempero	Noun	tempero m (plural temperos)
coa	Noun	coa f (plural coas)
parking	Noun	parking m (uncountable)
amplitud	Noun	amplitud f (plural amplitudes)
perla	Noun	perla f (plural perlas)
perla	Noun	perla f (uncountable)
refugio	Noun	refugio m (plural refugios)
armada	Noun	armada f (plural armadas)
ruptura	Noun	ruptura f (plural rupturas)
ola	Noun	ola f (plural olas)
vulgo	Noun	vulgo m (plural vulgos)
auto	Noun	auto m (plural autos)
auto	Noun	auto m (plural autos)
box	Noun	box m (plural boxes)
tremor	Noun	tremor m (plural tremores)
stock	Noun	stock m (plural stocks)
butanol	Noun	butanol m (plural butanoles)
chinchilla	Noun	chinchilla f (plural chinchillas)
mentes	Noun	mentes f pl
linas	Noun	linas f pl
conductor	Noun	conductor m (plural conductores, feminine conductora)
lateral	Noun	lateral m, f (plural laterales)
basalto	Noun	basalto m (plural basaltos)
notera	Noun	notera f (plural noteras, masculine notero)
kappa	Noun	kappa f (plural kappas)
ortopeda	Noun	ortopeda m, f (plural ortopedas)
piercing	Noun	piercing m (plural piercings)
cilio	Noun	cilio m (plural cilios)
racista	Noun	racista m, f (plural racistas)
observatorio	Noun	observatorio m (plural observatorios)
thai	Noun	thai m (plural thais)
badana	Noun	badana f (plural badanas)
éter	Noun	éter m (plural éteres)
polka	Noun	polka f (uncountable)
carmen	Noun	carmen m (plural cármenes)
fa	Noun	fa m (plural fa)
lila	Noun	lila f (plural lilas)
lila	Noun	lila m (plural lilas)
pub	Noun	pub m (plural pubs)
armenia	Noun	armenia f (plural armenias)
terror	Noun	terror m (plural terrores)
salar	Noun	salar m (plural salares)
bongo	Noun	bongo m (plural bongos)
dedo	Noun	dedo m (plural dedos)
tv	Noun	tv f (uncountable)
tudel	Noun	tudel m (plural tudeles)
huma	Noun	huma f (plural humas)
malva	Noun	malva f (plural malvas)
lógico	Noun	lógico m (plural lógicos)
ira	Noun	ira f (plural iras)
alemán	Noun	alemán m (plural alemanes, feminine alemana)
alemán	Noun	alemán m (uncountable)
alpaca	Noun	alpaca f (plural alpacas)
persona	Noun	persona f (plural personas)
baby	Noun	baby m (plural babys)
amo	Noun	amo m (plural amos, feminine ama)
atrofia	Noun	atrofia f (plural atrofias)
catapulta	Noun	catapulta f (plural catapultas)
u	Noun	u f (plural úes)
aerosol	Noun	aerosol m (plural aerosoles)
humanista	Noun	humanista m, f (plural humanistas)
rusa	Noun	rusa f (plural rusas, masculine ruso)
out	Noun	out m (plural outs)
media	Noun	media f (plural medias)
poligamia	Noun	poligamia f (uncountable)
aro	Noun	aro m (plural aros)
aro	Noun	aro m (plural aros)
aborto	Noun	aborto m (plural abortos)
bretón	Noun	bretón m (plural bretones, feminine bretona)
proceder	Noun	proceder m (plural procederes)
greda	Noun	greda f (plural gredas)
plural	Noun	plural m (plural plurales)
klingon	Noun	klingon m (uncountable)
urna	Noun	urna f (plural urnas)
dux	Noun	dux m (plural dux)
rudo	Noun	rudo m (plural rudos, feminine ruda, feminine plural rudas)
chala	Noun	chala f (plural chalas)
filipino	Noun	filipino m (plural filipinos, feminine filipina)
filipino	Noun	filipino m (uncountable)
slogan	Noun	slogan m (plural slogans or slóganes)
tmesis	Noun	tmesis f (plural tmesis)
luna	Noun	luna f (plural lunas)
algebra	Noun	algebra
barista	Noun	barista m, f (plural baristas)
planeta	Noun	planeta m (plural planetas)
vezo	Noun	vezo m (plural vezos)
locus	Noun	locus m (plural loci)
funda	Noun	funda f (plural fundas)
borra	Noun	borra f (plural borras)
sida	Noun	sida m (uncountable)
astronauta	Noun	astronauta m, f (plural astronautas)
gifs	Noun	gifs
hall	Noun	hall m (plural halls)
maza	Noun	maza f (plural mazas)
kart	Noun	kart m (plural karts)
titán	Noun	titán m (plural titanes)
principal	Noun	principal m (plural principales)
mafioso	Noun	mafioso m (plural mafiosos, feminine mafiosa)
libido	Noun	libido f (plural libidos)
teca	Noun	teca f (plural tecas)
otalgia	Noun	otalgia f (plural otalgias)
damán	Noun	damán m (plural damanes)
frontal	Noun	frontal m (plural frontales)
muro	Noun	muro m (plural muros)
sorgo	Noun	sorgo m (plural sorgos)
pena	Noun	pena f (plural penas)
tuna	Noun	tuna f (plural tunas)
tuna	Noun	tuna f (plural tunas)
baraka	Noun	baraka f (plural barakas)
referencia	Noun	referencia f (plural referencias)
vale	Noun	vale m (plural vales)
lapso	Noun	lapso m (plural lapsos)
bisexual	Noun	bisexual m, f (plural bisexuales)
kvas	Noun	kvas m (plural kvases)
emoji	Noun	emoji m (plural emojis)
manjar	Noun	manjar m (plural manjares)
jura	Noun	jura f (uncountable)
ve	Noun	ve f (plural ves)
gripe	Noun	gripe f (plural gripes)
logos	Noun	logos
koala	Noun	koala m (plural koalas)
bidet	Noun	bidet m (plural bidets)
cuma	Noun	cuma m (plural cumas)
podcast	Noun	podcast m (plural podcasts)
series	Noun	series
talla	Noun	talla f (plural tallas)
cardo	Noun	cardo m (plural cardos)
risa	Noun	risa f (plural risas)
tisana	Noun	tisana f (plural tisanas)
parada	Noun	parada f (plural paradas)
tusa	Noun	tusa f (plural tusas)
reparo	Noun	reparo m (plural reparos)
quiz	Noun	quiz m (plural quiz)
cas	Noun	cas m (plural cases)
corona	Noun	corona f (plural coronas)
cunnilingus	Noun	cunnilingus m (uncountable)
mar	Noun	mar m, f (plural mares)
carota	Noun	carota f (plural carotas)
risotto	Noun	risotto m (plural risottos)
lupanar	Noun	lupanar m (plural lupanares)
balón	Noun	balón m (plural balones)
lepra	Noun	lepra f (uncountable)
mami	Noun	mami f (plural mamis)
idea	Noun	idea f (plural ideas)
orientalista	Noun	orientalista m, f (plural orientalistas)
nodos	Noun	nodos
agar-agar	Noun	agar-agar m (plural agar-agares)
espresso	Noun	espresso m (plural espressos)
melodrama	Noun	melodrama m (plural melodramas)
casta	Noun	casta f (plural castas)
catalán	Noun	catalán m (uncountable)
puzzle	Noun	puzzle m (plural puzzles)
costa	Noun	costa f (plural costas)
dilema	Noun	dilema m (plural dilemas)
nota	Noun	nota f (plural notas)
barbera	Noun	barbera f (plural barberas, masculine barbero)
delicia	Noun	delicia f (plural delicias)
slip	Noun	slip m (plural slip)
zumba	Noun	zumba f (plural zumbas)
pata	Noun	pata f (plural patas)
pata	Noun	pata f (plural patas)
surrealista	Noun	surrealista m, f (plural surrealistas)
alternativa	Noun	alternativa f (plural alternativas)
paparazzi	Noun	paparazzi m (plural paparazzis)
transversal	Noun	transversal f (plural transversales)
scout	Noun	scout m (plural scouts)
tipi	Noun	tipi m (plural tipis)
gangster	Noun	gangster m (plural gangsters)
cura	Noun	cura f (plural curas)
cura	Noun	cura m (plural curas)
cura	Noun	cura
golem	Noun	golem m (plural golems)
fundo	Noun	fundo m (plural fundos)
peli	Noun	peli f (plural pelis)
tortas	Noun	tortas
acta	Noun	acta f (plural actas)
festival	Noun	festival m (plural festivales)
bemol	Noun	bemol m (plural bemoles)
agrimensor	Noun	agrimensor m (plural agrimensores)
lavabo	Noun	lavabo m (plural lavabos)
labra	Noun	labra f (plural labras)
pagoda	Noun	pagoda f (plural pagodas)
pres	Noun	pres m (plural preses)
Dr.	Noun	Dr. m (plural Drs., feminine Dra.)
lamento	Noun	lamento m (plural lamentos)
ikastola	Noun	ikastola f (plural ikastolas)
baile	Noun	baile m (plural bailes)
afrikaans	Noun	afrikaans m (uncountable)
pi	Noun	pi f (plural píes)
linea	Noun	linea
rifa	Noun	rifa f (plural rifas)
brisa	Noun	brisa f (plural brisas)
jersey	Noun	jersey m (plural jerséis or jerseys)
sacro	Noun	sacro m (plural sacros)
ala	Noun	ala f (plural alas)
curare	Noun	curare m (plural curares)
gamma	Noun	gamma f (plural gammas)
croissant	Noun	croissant m (plural croissants)
natura	Noun	natura f (plural naturas)
test	Noun	test m (plural tests)
reggae	Noun	reggae m (plural reggaes)
plata	Noun	plata f (plural platas)
salsa	Noun	salsa f (plural salsas)
brolis	Noun	brolis
ambo	Noun	ambo m (plural ambos)
venda	Noun	venda f (plural vendas)
venda	Noun	venda f (plural vendas, masculine vendo)
trasegar	Noun	trasegar m (uncountable)
chic	Noun	chic m (plural chics)
do	Noun	do m (plural dos)
zeugma	Noun	zeugma m (plural zeugmas)
skater	Noun	skater m (plural skaters)
viking	Noun	viking m (plural vikings)
puto	Noun	puto m (plural putos)
niqab	Noun	niqab m (plural niqabs)
baba	Noun	baba f (plural babas)
laika	Noun	laika m (plural laikas)
marga	Noun	marga f (plural margas)
bloc	Noun	bloc m (plural bloques)
spotter	Noun	spotter m (plural spotters)
body	Noun	body m (plural bodys or bodies)
humor	Noun	humor m (plural humores)
eider	Noun	eider m (plural eideres)
argón	Noun	argón m (uncountable)
mango	Noun	mango m (plural mangos)
mango	Noun	mango m (plural mangos)
peseta	Noun	peseta f (plural pesetas)
buga	Noun	buga m, f (plural bugas)
buga	Noun	buga m (plural bugas)
retina	Noun	retina f (plural retinas)
copyright	Noun	copyright m (plural copyrights)
traductor	Noun	traductor m (plural traductores, feminine traductora)
ser	Noun	ser m (plural seres)
ictus	Noun	ictus m (plural ictus)
macla	Noun	macla f (plural maclas)
celo	Noun	celo m (uncountable)
mica	Noun	mica f (plural micas)
fuga	Noun	fuga f (plural fugas)
parole	Noun	parole m (plural paroles)
bebido	Noun	bebido m (plural bebidos)
trilla	Noun	trilla f (plural trillas)
trilla	Noun	trilla f (plural trillas)
censura	Noun	censura f (plural censuras)
hutu	Noun	hutu m, f (plural hutus)
lolo	Noun	lolo m (plural lolos, feminine lola)
pasas	Noun	pasas f pl
tranquillo	Noun	tranquillo m (plural tranquillos)
sisa	Noun	sisa f (plural sisas)
utopia	Noun	utopia f (plural utopias)
thia	Noun	thia f (plural thias)
dermatitis	Noun	dermatitis f (uncountable)
hurra	Noun	hurra f (plural hurras)
blogger	Noun	blogger m (plural bloggers)
bet	Noun	bet f (plural bet)
volumen	Noun	volumen m (plural volúmenes)
puro	Noun	puro m (plural puros)
gradual	Noun	gradual m (plural graduales)
samica	Noun	samica f (plural samicas)
mol	Noun	mol m (plural moles)
lindar	Noun	lindar m (plural lindares)
conflicto	Noun	conflicto m (plural conflictos)
amir	Noun	amir m (plural amires)
analgesia	Noun	analgesia f (plural analgesias)
house	Noun	house m (uncountable)
cara	Noun	cara f (plural caras)
resto	Noun	resto m (plural restos)
manicure	Noun	manicure f (plural manicures)
parasol	Noun	parasol m (plural parasoles)
demagogia	Noun	demagogia f (plural demagogias)
pluma	Noun	pluma f (plural plumas)
aspecto	Noun	aspecto m (plural aspectos)
succino	Noun	succino m (uncountable)
ananás	Noun	ananás m (plural ananás or ananases)
fan	Noun	fan m, f (plural fans)
sed	Noun	sed f (plural sedes)
baptista	Noun	baptista m, f (plural baptistas)
petarda	Noun	petarda f (plural petardas, masculine petardo)
postis	Noun	postis
problema	Noun	problema m (plural problemas)
ganglio	Noun	ganglio m (plural ganglios)
cannabis	Noun	cannabis m (uncountable)
vendo	Noun	vendo m (plural vendos)
cabo	Noun	cabo m (plural cabos)
bomba	Noun	bomba f (plural bombas)
narval	Noun	narval m (plural narvales)
minimalista	Noun	minimalista m, f (plural minimalistas)
fragor	Noun	fragor m (plural fragores)
uso	Noun	uso m (plural usos)
show	Noun	show m (plural shows)
toga	Noun	toga f (plural togas)
sota	Noun	sota f (plural sotas)
tía	Noun	tía f (plural tías, masculine tío)
dramaturgia	Noun	dramaturgia f (uncountable)
a	Noun	a f (plural aes)
tortilla	Noun	tortilla f (plural tortillas)
proles	Noun	proles
pista	Noun	pista f (plural pistas)
karaoke	Noun	karaoke m (uncountable)
alas	Noun	alas f pl
plot	Noun	plot m (plural plots)
marxista	Noun	marxista m, f (plural marxistas)
medicina	Noun	medicina f (plural medicinas)
anatema	Noun	anatema f (plural anatemas)
hobbit	Noun	hobbit m (plural hobbits)
balsa	Noun	balsa f (plural balsas)
molde	Noun	molde m (plural moldes)
rapista	Noun	rapista m, f (plural rapistas)
plaga	Noun	plaga f (plural plagas)
verde	Noun	verde m (plural verdes)
predio	Noun	predio m (plural predios)
poro	Noun	poro m (plural poros)
tip	Noun	tip m (plural tips)
concubina	Noun	concubina f (plural concubinas)
mamut	Noun	mamut m (plural mamuts)
aborigen	Noun	aborigen m, f (plural aborígenes)
panel	Noun	panel m (plural paneles)
resta	Noun	resta f (plural restas)
mambo	Noun	mambo m (plural mambos)
patata	Noun	patata f (plural patatas)
av	Noun	av
morfina	Noun	morfina f (plural morfinas)
fatwa	Noun	fatwa f (plural fatwas)
voz	Noun	voz f (plural voces)
karateka	Noun	karateka m, f (plural karatekas)
rodeo	Noun	rodeo m (plural rodeos)
castigo	Noun	castigo m (plural castigos)
bar	Noun	bar m (plural bares)
bar	Noun	bar m (plural bares)
lector	Noun	lector m (plural lectores, feminine lectora)
line	Noun	line m (plural lines)
bolis	Noun	bolis m pl
anhelo	Noun	anhelo m (plural anhelos)
film	Noun	film m (plural films or filmes)
susurro	Noun	susurro m (plural susurros)
flote	Noun	flote m (plural flotes)
cultor	Noun	cultor m (plural cultores, feminine cultora)
boom	Noun	boom m (plural booms)
domo	Noun	domo m (plural domos)
ceros	Noun	ceros m pl
acervo	Noun	acervo m (plural acervos)
mayor	Noun	mayor m (plural mayores)
velamen	Noun	velamen m (plural velámenes)
granadilla	Noun	granadilla f (plural granadillas)
tartar	Noun	tartar m (plural tartares)
tano	Noun	tano m (plural tanos)
bob	Noun	bob m (plural bobs)
soul	Noun	soul m (uncountable)
mies	Noun	mies f (plural mieses)
caca	Noun	caca f (plural cacas)
tequila	Noun	tequila m (plural tequilas)
viticultor	Noun	viticultor m (plural viticultores, feminine viticultora)
tempo	Noun	tempo m (plural tempos)
top	Noun	top m (plural tops)
dandy	Noun	dandy m (plural dandys)
tundra	Noun	tundra f (plural tundras)
ave	Noun	ave f (plural aves)
ave	Noun	ave f (plural aves)
vivir	Noun	vivir m (plural vivires)
gol	Noun	gol m (plural goles)
boga	Noun	boga f (plural bogas)
tul	Noun	tul m (uncountable)
censor	Noun	censor m (plural censores, feminine censora)
anochecer	Noun	anochecer m (plural anocheceres)
dolor	Noun	dolor m (plural dolores)
spam	Noun	spam m (plural spams)
hecatombe	Noun	hecatombe f (plural hecatombes)
troposfera	Noun	troposfera f (plural troposferas)
teas	Noun	teas f
red	Noun	red f (plural redes)
daimio	Noun	daimio m (plural daimios)
sake	Noun	sake m (plural sakes)
oca	Noun	oca f (plural ocas)
curro	Noun	curro m (plural curros)
vela	Noun	vela f (plural velas)
vela	Noun	vela f (plural velas)
astenosfera	Noun	astenosfera f (plural astenosferas)
mirra	Noun	mirra f (uncountable)
dupla	Noun	dupla f (plural duplas)
halibut	Noun	halibut m (plural halibuts)
gavial	Noun	gavial m (plural gaviales)
still	Noun	still m (plural stills)
vaina	Noun	vaina f (plural vainas)
tobogán	Noun	tobogán m (plural toboganes)
virtuoso	Noun	virtuoso m (plural virtuosos, feminine virtuosa)
virtuoso	Noun	virtuoso m (plural virtuosos, feminine virtuosa)
bazar	Noun	bazar m (plural bazares)
languor	Noun	languor m (plural languors)
cataplasma	Noun	cataplasma f (plural cataplasmas)
quarterback	Noun	quarterback m (plural quarterbacks)
examen	Noun	examen m (plural exámenes)
mano	Noun	mano f (plural manos)
mano	Noun	mano m (plural manos, feminine mana)
ge	Noun	ge f (plural ges)
penuria	Noun	penuria f (plural penurias)
dama	Noun	dama f (plural damas)
rob	Noun	rob m (plural robes)
zanca	Noun	zanca m (plural zancas)
velo	Noun	velo m (plural velos)
flegma	Noun	flegma f (plural flegmas)
ava	Noun	ava m, f (plural ava)
musaka	Noun	musaka f (plural musakas)
póker	Noun	póker m (uncountable)
centuria	Noun	centuria f (plural centurias)
pompa	Noun	pompa f (plural pompas)
pompa	Noun	pompa f (plural pompas)
terna	Noun	terna f (plural ternas)
pito	Noun	pito m (plural pitos)
lima	Noun	lima f (plural limas)
lima	Noun	lima f (plural limas)
patera	Noun	patera f (plural pateras)
balde	Noun	balde m (plural baldes)
triumpho	Noun	triumpho m (plural triumphos)
torno	Noun	torno m (plural tornos)
lugar	Noun	lugar m (plural lugares)
pianista	Noun	pianista m, f (plural pianistas)
mingo	Noun	mingo m (plural mingos)
grama	Noun	grama f (uncountable)
calor	Noun	calor m (plural calores)
retracto	Noun	retracto m (plural retractos)
ministro	Noun	ministro m (plural ministros, feminine ministra)
darwinista	Noun	darwinista m, f (plural darwinistas)
neologismo	Noun	neologismo m (plural neologismos)
ambages	Noun	ambages m pl (plurale tantum)
he	Noun	he f (plural hes)
lictor	Noun	lictor m (plural lictores)
usura	Noun	usura f (plural usuras)
aula	Noun	aula f (plural aulas)
bumerang	Noun	bumerang m (plural bumerangs)
folk	Noun	folk m (uncountable)
meses	Noun	meses m pl
saga	Noun	saga f (plural sagas)
gabro	Noun	gabro m (plural gabros)
pera	Noun	pera f (plural peras)
caries	Noun	caries f (plural caries)
jugo	Noun	jugo m (plural jugos)
banda	Noun	banda f (plural bandas)
caras	Noun	caras f pl
diadema	Noun	diadema f (plural diademas)
flan	Noun	flan m (plural flanes)
locha	Noun	locha f (plural lochas)
mod	Noun	mod m (plural mods)
fobia	Noun	fobia f (plural fobias)
cala	Noun	cala f (plural calas)
bacon	Noun	bacon m (plural bacons)
calumnia	Noun	calumnia f (plural calumnias)
textura	Noun	textura f (plural texturas)
accidental	Noun	accidental m (plural accidentales)
copta	Noun	copta f (plural coptas, masculine copto)
iletrado	Noun	iletrado m (plural iletrados, feminine iletrada)
alba	Noun	alba f (plural albas)
flúor	Noun	flúor m (uncountable)
medio	Noun	medio m (plural medios)
copia	Noun	copia f (plural copias)
teorema	Noun	teorema m (plural teoremas)
magia	Noun	magia f (plural magias)
clips	Noun	clips
paro	Noun	paro m (plural paros)
temperatura	Noun	temperatura f (plural temperaturas)
feria	Noun	feria f (plural ferias)
jeep	Noun	jeep f (plural jeeps)
color	Noun	color m (plural colores)
boda	Noun	boda f (plural bodas)
castro	Noun	castro m (plural castros)
sepultura	Noun	sepultura f (plural sepulturas)
realista	Noun	realista m, f (plural realistas)
wasabi	Noun	wasabi m (uncountable)
falafel	Noun	falafel m (plural falafels)
buldog	Noun	buldog m (plural buldogs)
like	Noun	like m (plural likes)
roti	Noun	roti m (plural rotis)
popa	Noun	popa f (plural popas)
buffer	Noun	buffer m (plural buffers)
vinos	Noun	vinos m pl
sigma	Noun	sigma f (plural sigmas)
tinte	Noun	tinte m (plural tintes)
partitura	Noun	partitura f (plural partituras)
faraón	Noun	faraón m (plural faraones, feminine faraona)
prostituta	Noun	prostituta f (plural prostitutas)
culpa	Noun	culpa f (plural culpas)
novena	Noun	novena f (plural novenas)
dalit	Noun	dalit m, f (plural dalits)
iguana	Noun	iguana f (plural iguanas)
happening	Noun	happening m (plural happenings)
burla	Noun	burla f (plural burlas)
etapa	Noun	etapa f (plural etapas)
pijama	Noun	pijama m (plural pijamas)
combate	Noun	combate m (plural combates)
fogata	Noun	fogata f (plural fogatas)
metanol	Noun	metanol m (plural metanoles)
mula	Noun	mula f (plural mulas)
perfidia	Noun	perfidia f (plural perfidias)
vida	Noun	vida f (plural vidas)
intolerancia	Noun	intolerancia f (plural intolerancias)
epopeya	Noun	epopeya f (plural epopeyas)
radón	Noun	radón m (uncountable)
pisto	Noun	pisto m (plural pistos)
ascas	Noun	ascas m pl
libra	Noun	libra f (plural libras)
inka	Noun	inka m, f (plural inkas)
poeta	Noun	poeta m, f (plural poetas)
dese	Noun	dese m (plural deses)
sardina	Noun	sardina f (plural sardinas)
fallo	Noun	fallo m (plural fallos)
revisor	Noun	revisor m (plural revisores)
lupa	Noun	lupa f (plural lupas)
rupia	Noun	rupia f (plural rupias)
colla	Noun	colla m, f (plural collas)
radar	Noun	radar m (plural radares)
stress	Noun	stress m (plural stresses)
trader	Noun	trader m (plural traders)
spas	Noun	spas f pl
curso	Noun	curso m (plural cursos)
loco	Noun	loco m (plural locos, feminine loca)
loco	Noun	loco m (plural locos)
boj	Noun	boj m (plural bojes)
haiku	Noun	haiku m (plural haikus)
caviar	Noun	caviar m (plural caviares)
magma	Noun	magma m (plural magmas)
oferta	Noun	oferta f (plural ofertas)
medley	Noun	medley m (plural medleys)
súper	Noun	súper m (plural superes)
defensa	Noun	defensa f (plural defensas)
defensa	Noun	defensa m (plural defensas)
tweet	Noun	tweet m (plural tweets)
arpa	Noun	arpa f (plural arpas)
traversa	Noun	traversa f (plural traversas)
angina	Noun	angina f (plural anginas)
odio	Noun	odio m (plural odios)
stevia	Noun	stevia f (plural stevias)
dolar	Noun	dolar
open	Noun	open m (plural opens)
GPS	Noun	GPS m (plural GPS)
arar	Noun	arar m (plural arares)
bilis	Noun	bilis f (plural bilis)
metro	Noun	metro m (plural metros)
metro	Noun	metro m (plural metros)
latitud	Noun	latitud f (plural latitudes)
harpa	Noun	harpa f (plural harpas)
sitio	Noun	sitio m (plural sitios)
compus	Noun	compus
stand	Noun	stand m (plural stands)
feijoa	Noun	feijoa f (plural feijoas)
posta	Noun	posta f (plural postas)
posta	Noun	posta m, f (plural postas)
son	Noun	son m (plural sones)
lata	Noun	lata f (plural latas)
arca	Noun	arca f (plural arcas)
placer	Noun	placer m (plural placeres)
placer	Noun	placer m (plural placeres)
laudo	Noun	laudo m (plural laudos)
tupla	Noun	tupla f (plural tuplas)
robots	Noun	robots m pl
karate	Noun	karate m (plural uncountable)
bridge	Noun	bridge m (uncountable)
moral	Noun	moral f (plural morales)
moral	Noun	moral m (plural morales)
nacionalista	Noun	nacionalista m, f (plural nacionalistas)
cana	Noun	cana f (plural canas)
colonia	Noun	colonia f (plural colonias)
gama	Noun	gama f (plural gamas)
aedes	Noun	aedes m (plural aedes)
rea	Noun	rea f (plural reas, masculine reo)
dia	Noun	dia m (plural dias)
epidemia	Noun	epidemia f (plural epidemias)
cepa	Noun	cepa f (plural cepas)
multi	Noun	multi f (plural multis)
amor	Noun	amor m (plural amores)
promo	Noun	promo f (plural promos)
exorcista	Noun	exorcista m, f (plural exorcistas)
locker	Noun	locker m (plural lockers)
salmo	Noun	salmo m (plural salmos)
coca	Noun	coca f (plural cocas)
coca	Noun	coca f (uncountable)
coca	Noun	coca f (plural cocas)
muga	Noun	muga f (plural mugas)
veda	Noun	veda f (plural vedas)
samba	Noun	samba f m (plural sambas)
terrorista	Noun	terrorista m, f (plural terroristas)
amarilis	Noun	amarilis f (plural amarilis)
bufet	Noun	bufet m (plural bufetes)
blues	Noun	blues m, m pl
irlandés	Noun	irlandés m (plural irlandeses, feminine irlandesa)
pella	Noun	pella f (plural pellas)
gamer	Noun	gamer m, f (plural gamers)
rider	Noun	rider m (plural riders)
snack	Noun	snack m (plural snacks)
mes	Noun	mes m (plural meses)
oficiante	Noun	oficiante m, f (plural oficiantes)
dogo	Noun	dogo m (plural dogos)
freestyle	Noun	freestyle m (uncountable)
pausa	Noun	pausa f (plural pausas)
arsenal	Noun	arsenal m (plural arsenales)
nazis	Noun	nazis m pl, f pl
cal	Noun	cal f (uncountable)
rumen	Noun	rumen m (plural rúmenes)
nailon	Noun	nailon m (plural nailon)
sol	Noun	sol m (plural soles)
sol	Noun	sol m (uncountable)
sol	Noun	sol m (plural soles)
mito	Noun	mito m (plural mitos)
co	Noun	co m (plural cos)
fauna	Noun	fauna f (plural faunas)
amical	Noun	amical m (plural amicales)
anticipo	Noun	anticipo m (plural anticipos)
champagne	Noun	champagne m (plural champagnes)
pole	Noun	pole m (plural poles)
axioma	Noun	axioma m (plural axiomas)
transistor	Noun	transistor m (plural transistores)
antonomasia	Noun	antonomasia f (plural antonomasias)
mamba	Noun	mamba f (plural mambas)
vegan	Noun	vegan m (plural vegans)
día	Noun	día m (plural días)
neuralgia	Noun	neuralgia f (plural neuralgias)
galaxias	Noun	galaxias
anoa	Noun	anoa m (plural anoas)
costas	Noun	costas f pl
rubeola	Noun	rubeola f (plural rubeolas)
zombie	Noun	zombie m (plural zombies)
delírium	Noun	delírium m
semen	Noun	semen m (uncountable)
jermu	Noun	jermu f (plural jermus)
zunga	Noun	zunga f (plural zungas)
pala	Noun	pala f (plural palas)
pasaporte	Noun	pasaporte m (plural pasaportes)
pan	Noun	pan m (plural panes)
golf	Noun	golf m (uncountable)
rock	Noun	rock m (plural rocks)
bamba	Noun	bamba f (plural bambas)
bamba	Noun	bamba f (plural bambas)
lis	Noun	lis f (plural lises)
dealer	Noun	dealer m (plural dealers)
underground	Noun	underground m (plural undergrounds)
hockey	Noun	hockey m (plural hockey)
bardas	Noun	bardas f pl
absurdo	Noun	absurdo m (plural absurdos)
sari	Noun	sari m (plural saris)
peludo	Noun	peludo m (plural peludos)
abrir	Noun	abrir m (plural abrires)
razzia	Noun	razzia f (plural razzias)
taberna	Noun	taberna f (plural tabernas)
manita	Noun	manita f (plural manitas)
iras	Noun	iras
vagina	Noun	vagina f (plural vaginas)
souvenir	Noun	souvenir m (plural souvenires)
mata	Noun	mata f (plural matas)
general	Noun	general m (plural generales, feminine generala)
limonada	Noun	limonada f (plural limonadas)
jara	Noun	jara f (plural jaras)
gospel	Noun	gospel m (uncountable)
tenor	Noun	tenor m (plural tenores)
quinde	Noun	quinde m (plural quindes)
morsa	Noun	morsa f (plural morsas)
villa	Noun	villa f (plural villas)
imam	Noun	imam m (plural imames)
federal	Noun	federal m (plural federales)
col	Noun	col f (plural coles)
princesa	Noun	princesa f (plural princesas)
liana	Noun	liana f (plural lianas)
hard rock	Noun	hard rock m (uncountable)
incuria	Noun	incuria f (plural incurias)
arena	Noun	arena f (plural arenas)
corpus	Noun	corpus m (plural corpus)
mongo	Noun	mongo m (plural mongos, feminine monga)
melón	Noun	melón m (plural melones)
meme	Noun	meme m (plural memes)
slump	Noun	slump m (plural slumps)
oglala	Noun	oglala m, f (plural oglalas)
lei	Noun	lei m pl
apertura	Noun	apertura f (plural aperturas)
veza	Noun	veza f (plural vezas)
oro	Noun	oro m (plural oros)
seno	Noun	seno m (plural senos)
res	Noun	res f (plural reses)
res	Noun	res m pl
taza	Noun	taza f (plural tazas)
tas	Noun	tas m (plural tas)
populista	Noun	populista m, f (plural populistas)
salmonella	Noun	salmonella f (plural salmonellas)
piti	Noun	piti m (plural pitis)
paca	Noun	paca f (plural pacas, masculine paco)
islam	Noun	islam m (uncountable)
svastika	Noun	svastika f (plural svastikas)
ignominia	Noun	ignominia f (plural ignominias)
touchdown	Noun	touchdown m (plural touchdowns)
fortuna	Noun	fortuna f (plural fortunas)
hernia	Noun	hernia f (plural hernias)
minigolf	Noun	minigolf m (plural minigolfs)
hemoglobina	Noun	hemoglobina f (plural hemoglobinas)
rubor	Noun	rubor m (plural rubores)
duda	Noun	duda f (plural dudas)
vigilia	Noun	vigilia f (plural vigilias)
hemofilia	Noun	hemofilia f (plural hemofilias)
tragedia	Noun	tragedia f (plural tragedias)
tribus	Noun	tribus f pl
soros	Noun	soros m pl
juju	Noun	juju f (plural jujus)
parias	Noun	parias
esperanto	Noun	esperanto m (uncountable)
video	Noun	video m (plural videos)
clima	Noun	clima m (plural climas)
corruptor	Noun	corruptor m (plural corruptores)
tau	Noun	tau f (plural taus)
higo	Noun	higo m (plural higos)
palada	Noun	palada f (plural paladas)
inopia	Noun	inopia f (plural inopias)
celta	Noun	celta m (plural celtas, feminine celta)
tero	Noun	tero m (plural teros)
hashtag	Noun	hashtag m (plural hashtags)
español	Noun	español m (plural españoles, feminine española)
derbi	Noun	derbi m (plural derbis)
desidia	Noun	desidia f (plural desidias)
membrana	Noun	membrana f (plural membranas)
fé	Noun	fé
nobel	Noun	nobel m (plural nobel)
analfabeta	Noun	analfabeta f (plural analfabetas)
antropofagia	Noun	antropofagia f (plural antropofagias)
we	Noun	we m, f (plural wees)
canasta	Noun	canasta f (plural canastas)
oliva	Noun	oliva f (plural olivas)
ajo	Noun	ajo m (plural ajos)
ajo	Noun	ajo m (plural ajos)
cedula	Noun	cedula f (plural cedulas)
finalista	Noun	finalista m, f (plural finalistas)
metropolis	Noun	metropolis
workshop	Noun	workshop m (plural workshops)
laya	Noun	laya f (plural layas)
abertzale	Noun	abertzale m, f (plural abertzales)
cerca	Noun	cerca f (plural cercas)
chupa	Noun	chupa f (plural chupas)
plasma	Noun	plasma m (plural plasmas)
jade	Noun	jade m (plural jades)
pomo	Noun	pomo m (plural pomos)
pajas	Noun	pajas f pl
verja	Noun	verja f (plural verjas)
audio	Noun	audio m (plural audios)
embargo	Noun	embargo m (plural embargos)
cero	Noun	cero m (plural ceros)
plus	Noun	plus m (plural plus)
lupus	Noun	lupus m (uncountable)
pelvis	Noun	pelvis f (plural pelvis)
sinagoga	Noun	sinagoga f (plural sinagogas)
salto	Noun	salto m (plural saltos)
eremita	Noun	eremita m, f (plural eremitas)
album	Noun	album m (plural albums)
valva	Noun	valva f (plural valvas)
andar	Noun	andar m (plural andares)
clown	Noun	clown m (plural clownes)
pesar	Noun	pesar m (plural pesares)
cappa	Noun	cappa f (plural cappas)
cesto	Noun	cesto m (plural cestos)
lambda	Noun	lambda f (plural lambdas)
arteria	Noun	arteria f (plural arterias)
pesado	Noun	pesado m (plural pesados, feminine pesada)
carabina	Noun	carabina m (plural carabinas)
poza	Noun	poza f (plural pozas)
agar	Noun	agar m (plural agares)
sintagma	Noun	sintagma m (plural sintagmas)
smoking	Noun	smoking m (plural smoking)
neutrino	Noun	neutrino m (plural neutrinos)
Danbo	Noun	Danbo m (plural Danbos)
tea	Noun	tea f (plural teas)
aloe	Noun	aloe m (plural aloes)
kimono	Noun	kimono m (plural kimonos)
slap	Noun	slap m (plural slaps)
sor	Noun	sor f (plural sores)
mantel	Noun	mantel m (plural manteles)
comer	Noun	comer m (plural comeres)
trap	Noun	trap m (uncountable)
autista	Noun	autista m, f (plural autistas)
gata	Noun	gata f (plural gatas, masculine gato)
habanera	Noun	habanera f (plural habaneras, masculine habanero)
zika	Noun	zika m (plural zikas)
hidrosfera	Noun	hidrosfera f (plural hidrosferas)
sonda	Noun	sonda f (plural sondas)
progenitor	Noun	progenitor m (plural progenitores, feminine progenitora)
clausura	Noun	clausura f (plural clausuras)
madrigal	Noun	madrigal m (plural madrigales)
burkini	Noun	burkini m (plural burkinis)
pódium	Noun	pódium m (plural pódiums)
titi	Noun	titi f (plural titis)
abrasivo	Noun	abrasivo m (plural abrasivos)
biblia	Noun	biblia f (plural biblias)
homicida	Noun	homicida m, f (plural homicidas)
shorts	Noun	shorts m pl (plurale tantum)
modem	Noun	modem m (plural modems)
benzol	Noun	benzol m (uncountable)
zar	Noun	zar m (plural zares)
piso	Noun	piso m (plural pisos)
cantor	Noun	cantor m (plural cantores, feminine cantora)
faja	Noun	faja f (plural fajas)
balsas	Noun	balsas f pl
misal	Noun	misal m (plural misales)
leva	Noun	leva f (plural levas)
islamofobia	Noun	islamofobia f (plural islamofobias)
danta	Noun	danta f (plural dantas)
tumba	Noun	tumba f (plural tumbas)
rocker	Noun	rocker m (plural rockers)
afganas	Noun	afganas f pl
patrona	Noun	patrona f (plural patronas)
carpo	Noun	carpo m (plural carpos)
agricultura	Noun	agricultura f (plural agriculturas)
concha	Noun	concha f (plural conchas)
rap	Noun	rap m (plural raps)
torta	Noun	torta f (plural tortas)
horda	Noun	horda f (plural hordas)
avellanar	Noun	avellanar m (plural avellanares)
selfie	Noun	selfie m (plural selfies)
osa	Noun	osa f (plural osas, masculine oso)
laguna	Noun	laguna f (plural lagunas)
placenta	Noun	placenta f (plural placentas)
blao	Noun	blao m (plural blaos)
hacker	Noun	hacker m, f (plural hackers)
nylon	Noun	nylon m (plural nylons)
ñaña	Noun	ñaña f (uncountable)
ainu	Noun	ainu m, f (plural ainus)
sustento	Noun	sustento m (plural sustentos)
pederastia	Noun	pederastia f (plural pederastias)
gallos	Noun	gallos m pl
aspa	Noun	aspa f (plural aspas)
piratas	Noun	piratas pl
laude	Noun	laude f (plural laudes)
laude	Noun	laude f (plural laudes)
party	Noun	party m (plural partys or parties)
bonito	Noun	bonito m (plural bonitos)
hot dog	Noun	hot dog m (plural hot dog)
consultor	Noun	consultor m (plural consultores, feminine consultora)
pulpos	Noun	pulpos m pl
dosis	Noun	dosis f (plural dosis)
lao	Noun	lao m, f (plural laos)
yupi	Noun	yupi m (plural yupis)
humus	Noun	humus m (plural humus)
striptease	Noun	striptease m (plural stripteases)
respecto	Noun	respecto m (plural respectos)
caterva	Noun	caterva f (plural catervas)
siluetas	Noun	siluetas f pl
criminal	Noun	criminal m, f (plural criminales)
jota	Noun	jota f (plural jotas)
jota	Noun	jota f (plural jotas)
jota	Noun	jota f (plural jotas)
tutela	Noun	tutela f (plural tutelas)
paz	Noun	paz f (plural paces)
marioneta	Noun	marioneta f (plural marionetas)
bruma	Noun	bruma f (plural brumas)
anime	Noun	anime m (plural animes)
muger	Noun	muger f (plural mugeres)
fi	Noun	fi f (plural fíes)
as	Noun	as m (plural ases)
giba	Noun	giba f (plural gibas)
poli	Noun	poli m, f (plural polis)
poli	Noun	poli f (uncountable)
gustos	Noun	gustos m pl
tapa	Noun	tapa f (plural tapas)
crack	Noun	crack m (plural cracks)
abdominal	Noun	abdominal m (plural abdominales)
esca	Noun	esca f (plural escas)
semis	Noun	semis m (plural semises)
pargo	Noun	pargo m (plural pargos)
veta	Noun	veta f (plural vetas)
gleba	Noun	gleba f (plural glebas)
primogenitura	Noun	primogenitura f (uncountable)
termos	Noun	termos
biopsia	Noun	biopsia f (plural biopsias)
yaya	Noun	yaya f (plural yayas)
flor	Noun	flor f (plural flores)
falos	Noun	falos m pl
curia	Noun	curia f (plural curias)
blog	Noun	blog m (plural blogs)
senda	Noun	senda f (plural sendas)
bicha	Noun	bicha f (plural bichas)
bula	Noun	bula f (plural bulas)
sms	Noun	sms m (plural sms)
mulo	Noun	mulo m (plural mulos, feminine mula)
circular	Noun	circular f (plural circulares)
bou	Noun	bou m (uncountable)
bou	Noun	bou m (plural boues)
webmaster	Noun	webmaster m (plural webmasters)
sima	Noun	sima f (plural simas)
digital	Noun	digital f (plural digitales)
pavor	Noun	pavor m (plural pavores)
collie	Noun	collie m (plural collies)
diodo	Noun	diodo m (plural diodos)
calar	Noun	calar m (plural calares)
loza	Noun	loza f (plural lozas)
tornado	Noun	tornado m (plural tornados)
poni	Noun	poni m (plural ponis)
seductor	Noun	seductor m (plural seductores, feminine seductora)
moto	Noun	moto f (plural motos)
moto	Noun	moto m (plural motos)
tiara	Noun	tiara f (plural tiaras)
cambium	Noun	cambium m (plural cambiums)
pack	Noun	pack m (plural packs)
pasmo	Noun	pasmo m (plural pasmos)
internet	Noun	internet m, f (uncountable)
alfa	Noun	alfa f (plural alfas)
collar	Noun	collar m (plural collares)
te	Noun	te f (plural tes)
vodka	Noun	vodka m (plural vodkas)
anda	Noun	anda f (plural andas)
sello	Noun	sello m (plural sellos)
pando	Noun	pando m (plural pandos)
firma	Noun	firma f (plural firmas)
spammer	Noun	spammer m (plural spammers)
glutamina	Noun	glutamina f (plural glutaminas)
rosa	Noun	rosa f (plural rosas)
banjo	Noun	banjo m (plural banjos or banjoes)
bits	Noun	bits
ny	Noun	ny f (plural nys)
posti	Noun	posti m (plural postis)
gelada	Noun	gelada m (plural geladas)
animal	Noun	animal m (plural animales)
bodi	Noun	bodi m (plural bodis or bodies)
guacamole	Noun	guacamole m (plural guacamoles)
mam	Noun	mam m (uncountable)
password	Noun	password m (plural passwords)
tazo	Noun	tazo m (plural tazos)
tono	Noun	tono m (plural tonos)
loca	Noun	loca f (plural locas)
dinamo	Noun	dinamo m (plural dinamos)
misericordia	Noun	misericordia f (plural misericordias)
lista	Noun	lista f (plural listas)
polis	Noun	polis f (plural polis)
polis	Noun	polis m pl, f pl
mantra	Noun	mantra m (plural mantras)
fobofobia	Noun	fobofobia f (uncountable)
error	Noun	error m (plural errores)
euribor	Noun	euribor m (uncountable)
brasa	Noun	brasa f (plural brasas)
albor	Noun	albor m (plural albores)
alveolar	Noun	alveolar f (plural alveolares)
mallas	Noun	mallas
familia	Noun	familia f (plural familias)
cauterio	Noun	cauterio m (plural cauterios)
neurastenia	Noun	neurastenia f (plural neurastenias)
weber	Noun	weber m (plural weber)
suahili	Noun	suahili m (uncountable)
pulla	Noun	pulla f (plural pullas)
musical	Noun	musical m (plural musicales)
gordo	Noun	gordo m (plural gordos)
patriota	Noun	patriota m, f (plural patriotas)
renta	Noun	renta f (plural rentas)
baht	Noun	baht m (plural bahts)
subscriptor	Noun	subscriptor m (plural subscriptores)
ascensor	Noun	ascensor m (plural ascensores)
heterosexual	Noun	heterosexual m, f (plural heterosexuales)
drama	Noun	drama m (plural dramas)
elegancia	Noun	elegancia f (plural elegancias)
disco	Noun	disco f (plural discos)
disco	Noun	disco m (plural discos)
idioma	Noun	idioma m (plural idiomas)
metodista	Noun	metodista m, f (plural metodistas)
aurora	Noun	aurora f (plural auroras)
dumping	Noun	dumping m (plural dumpings)
aura	Noun	aura f (plural auras)
aura	Noun	aura f (plural auras)
campus	Noun	campus m (plural campus)
tango	Noun	tango m (plural tangos)
hoz	Noun	hoz f (plural hoces)
jeremiada	Noun	jeremiada f (plural jeremiadas)
hangar	Noun	hangar m (plural hangares)
roza	Noun	roza f (plural rozas)
multa	Noun	multa f (plural multas)
remake	Noun	remake m (plural remakes)
sepia	Noun	sepia f (plural sepias)
ruda	Noun	ruda f (plural rudas)
resistor	Noun	resistor m (plural resistores)
ruta	Noun	ruta f (plural rutas)
iro	Noun	iro m (plural iros)
nafta	Noun	nafta f (plural naftas)
protoplasma	Noun	protoplasma m (plural protoplasmas)
papi	Noun	papi m (plural papis)
mi	Noun	mi f (plural míes)
ronda	Noun	ronda f (plural rondas)
modo	Noun	modo m (plural modos)
vado	Noun	vado m (plural vados)
dictum	Noun	dictum m (plural dictums)
tramontana	Noun	tramontana f (plural tramontanas)
andante	Noun	andante m, f (plural andantes)
andante	Noun	andante m (plural andantes)
pandeiro	Noun	pandeiro m (plural pandeiros)
presi	Noun	presi m, f (plural presis)
cortina	Noun	cortina f (plural cortinas)
boa	Noun	boa m (plural boas)
venera	Noun	venera f (plural veneras)
complacer	Noun	complacer m (plural complaceres)
porno	Noun	porno m (uncountable)
iPhone	Noun	iPhone m (plural iPhones)
disparo	Noun	disparo m (plural disparos)
mina	Noun	mina f (plural minas)
mina	Noun	mina f (plural minas, masculine mino)
boles	Noun	boles
pederasta	Noun	pederasta m (plural pederastas)
cavo	Noun	cavo m (plural cavos)
anilina	Noun	anilina f (plural anilinas)
lapa	Noun	lapa f (plural lapas)
emblema	Noun	emblema m (plural emblemas)
croupier	Noun	croupier m (plural croupiers)
artritis	Noun	artritis f (uncountable)
lampa	Noun	lampa f (plural lampas)
candor	Noun	candor m (plural candores)
tíos	Noun	tíos m pl
pira	Noun	pira f (plural piras)
pira	Noun	pira f (plural piras)
tito	Noun	tito m (plural titos, feminine tita)
bacán	Noun	bacán m (plural bacanes)
profano	Noun	profano m (plural profanos, feminine profana)
nana	Noun	nana f (plural nanas)
veneno	Noun	veneno m (plural venenos)
cesta	Noun	cesta f (plural cestas)
tigre	Noun	tigre m (plural tigres, feminine tigresa)
hedonista	Noun	hedonista m, f (plural hedonistas)
animista	Noun	animista m, f (plural animistas)
no	Noun	no m (plural noes)
eructo	Noun	eructo m (plural eructos)
amina	Noun	amina m (plural aminas)
saliva	Noun	saliva f (plural salivas)
patos	Noun	patos
ermita	Noun	ermita f (plural ermitas)
uro	Noun	uro m (plural uros)
almas	Noun	almas f pl
olio	Noun	olio m (plural olios)
ex	Noun	ex m, f (plural ex)
coach	Noun	coach m (plural coaches)
pool	Noun	pool m (plural pools)
hiena	Noun	hiena f (plural hienas)
contagios	Noun	contagios
jaguar	Noun	jaguar m (plural jaguares)
carst	Noun	carst m (plural carstes)
foramen	Noun	foramen m (plural forámenes)
opereta	Noun	opereta f (plural operetas)
pasta	Noun	pasta f (plural pastas)
brasserie	Noun	brasserie f (plural brasseries)
cultura	Noun	cultura f (plural culturas)
rusas	Noun	rusas f pl
valor	Noun	valor m (plural valores)
trol	Noun	trol m (plural troles)
trol	Noun	trol m (plural troles)
masa	Noun	masa f (plural masas)
infanticida	Noun	infanticida m, f (plural infanticidas)
correr	Noun	correr m (plural correres)
mus	Noun	mus m (uncountable)
safari	Noun	safari m (plural safaris)
rada	Noun	rada f (plural radas)
pastoral	Noun	pastoral f (plural pastorales)
interno	Noun	interno m (plural internos, feminine interna)
joda	Noun	joda f (plural jodas)
sur	Noun	sur m (plural sures)
homofobia	Noun	homofobia f (plural homofobias)
DVD	Noun	DVD m (plural DVDs)
matador	Noun	matador m (plural matadores, feminine matadora)
lanugo	Noun	lanugo m (uncountable)
disciplina	Noun	disciplina f (plural disciplinas)
capo	Noun	capo m (plural capos)
polera	Noun	polera f (plural poleras)
epilepsia	Noun	epilepsia f (plural epilepsias)
curry	Noun	curry m (uncountable)
avatar	Noun	avatar m (plural avatares)
victoria	Noun	victoria f (plural victorias)
doping	Noun	doping m (plural dopings)
cautela	Noun	cautela f (plural cautelas)
naira	Noun	naira f (plural nairas)
aerobic	Noun	aerobic m (plural aerobics)
acabado	Noun	acabado m (plural acabados)
orangután	Noun	orangután m (plural orangutanes)
recreo	Noun	recreo m (plural recreos)
aroma	Noun	aroma m (plural aromas)
arma	Noun	arma f (plural armas)
altar	Noun	altar m (plural altares)
furia	Noun	furia f (plural furias)
armas	Noun	armas f pl
fervor	Noun	fervor m (plural fervores)
amanecer	Noun	amanecer m (plural amaneceres)
custodio	Noun	custodio m (plural custodios)
ping-pong	Noun	ping-pong m (uncountable)
hobby	Noun	hobby m (plural hobbys)
catán	Noun	catán m (plural catanes)
dalia	Noun	dalia f (plural dalias)
dodo	Noun	dodo m (plural dodos)
tejar	Noun	tejar m (plural tejares)
academia	Noun	academia f (plural academias)
impala	Noun	impala m, f (plural impalas)
valles	Noun	valles m pl
raja	Noun	raja f (plural rajas)
potasio	Noun	potasio m (plural potasios)
blockera	Noun	blockera f (plural blockeras)
soda	Noun	soda f (plural sodas)
liceo	Noun	liceo m (plural liceos)
landa	Noun	landa f (plural landas)
shampoo	Noun	shampoo m (plural shampoos)
minuta	Noun	minuta f (plural minutas)
freno	Noun	freno m (plural frenos)
basta	Noun	basta f (plural bastas)
cresta	Noun	cresta f (plural crestas)
archimandrita	Noun	archimandrita m (plural archimandritas)
bata	Noun	bata f (plural batas)
juro	Noun	juro m (plural juros)
cisterna	Noun	cisterna f (plural cisternas)
tribunal	Noun	tribunal m (plural tribunales)
epidermis	Noun	epidermis f (plural epidermis)
mariscos	Noun	mariscos m pl
faenero	Noun	faenero m (plural faeneros)
destructor	Noun	destructor m (plural destructores, feminine destructora)
email	Noun	email m (plural emails)
diktat	Noun	diktat m (plural diktats)
zoofilia	Noun	zoofilia f (plural zoofilias)
palo	Noun	palo m (plural palos)
inicio	Noun	inicio m (plural inicios)
pibe	Noun	pibe m, f (plural pibes)
vulva	Noun	vulva f (plural vulvas)
vez	Noun	vez f (plural veces)
malaria	Noun	malaria f (plural malarias)
tutor	Noun	tutor m, f (plural tutores, feminine tutora)
laboratorio	Noun	laboratorio m (plural laboratorios)
vid	Noun	vid f (plural vides)
temporal	Noun	temporal m (plural temporales)
raptor	Noun	raptor m (plural raptores)
pizza	Noun	pizza f (plural pizzas)
madame	Noun	madame f (plural madames)
impulsor	Noun	impulsor m (plural impulsores)
cometa	Noun	cometa m (plural cometas)
interlingua	Noun	interlingua f (uncountable)
ajos	Noun	ajos pl
cappuccino	Noun	cappuccino m (plural cappuccinos)
alanina	Noun	alanina f (plural alaninas)
coco	Noun	coco m (plural cocos)
master	Noun	master m (plural masters)
gin	Noun	gin m (plural gins)
marketing	Noun	marketing m (plural marketings)
instructor	Noun	instructor m (plural instructores, feminine instructora)
honor	Noun	honor m (plural honores)
postilla	Noun	postilla f (plural postillas)
postilla	Noun	postilla f (plural postillas)
kebab	Noun	kebab m (plural kebabs)
halo	Noun	halo m (plural halos)
martes	Noun	martes m (plural martes)
newton	Noun	newton m (plural newton)
barón	Noun	barón m (plural barones, feminine baronesa)
fila	Noun	fila f (plural filas)
pina	Noun	pina f (plural pinas)
sushi	Noun	sushi m (plural sushis)
cubito	Noun	cubito m (plural cubitos)
horror	Noun	horror m (plural horrores)
convenio	Noun	convenio m (plural convenios)
doma	Noun	doma f (plural domas)
orla	Noun	orla f (plural orlas)
salvia	Noun	salvia f (plural salvias)
ductor	Noun	ductor m (plural ductores)
lino	Noun	lino m (plural linos)
alga	Noun	alga f (plural algas)
peana	Noun	peana f (plural peanas)
atropina	Noun	atropina f (plural atropinas)
burka	Noun	burka m (plural burkas)
gesto	Noun	gesto m (plural gestos)
publicista	Noun	publicista m, f (plural publicistas)
ropa	Noun	ropa f (plural ropas)
ultimátum	Noun	ultimátum m (plural ultimátum or ultimátums)
tina	Noun	tina f (plural tinas)
bola	Noun	bola f (plural bolas)
adagio	Noun	adagio m (plural adagios)
adagio	Noun	adagio m (plural adagios)
bromas	Noun	bromas f pl
trance	Noun	trance m (plural trances)
pinar	Noun	pinar m (plural pinares)
palinodia	Noun	palinodia f (plural palinodias)
tracto	Noun	tracto m (plural tractos)
man	Noun	man m (plural men)
losa	Noun	losa f (plural losas)
malla	Noun	malla f (plural mallas)
mur	Noun	mur m (plural mures)
molla	Noun	molla f (plural mollas)
anhedonia	Noun	anhedonia f (plural anhedonias)
acera	Noun	acera f (plural aceras)
karma	Noun	karma m (plural karmas)
vals	Noun	vals m (uncountable)
eutanasia	Noun	eutanasia f (plural eutanasias)
dorsal	Noun	dorsal m (plural dorsales)
tableta	Noun	tableta f (plural tabletas)
androide	Noun	androide m (plural androides)
celsius	Noun	celsius m (uncountable)
sarna	Noun	sarna f (uncountable)
kuzu	Noun	kuzu m (plural kuzus)
chola	Noun	chola f (plural cholas)
miss	Noun	miss f (plural misses)
mandarina	Noun	mandarina f (plural mandarinas)
ocras	Noun	ocras m pl
bable	Noun	bable m (uncountable)
influenza	Noun	influenza f (plural influenzas)
azul	Noun	azul m (plural azules)
misterios	Noun	misterios
loft	Noun	loft m (plural lofts)
duro	Noun	duro m (plural duros)
avance	Noun	avance m (plural avances)
mitra	Noun	mitra f (plural mitras)
diagonal	Noun	diagonal f (plural diagonales)
herpes	Noun	herpes m, f (plural herpes)
literatura	Noun	literatura f (plural literaturas)
casting	Noun	casting m (plural castings)
profesor	Noun	profesor m (plural profesores, feminine profesora)
sedes	Noun	sedes f pl
sedes	Noun	sedes f pl
sabor	Noun	sabor m (plural sabores)
final	Noun	final m (plural finales)
avena	Noun	avena f (plural avenas)
inuit	Noun	inuit m, f (plural inuites)
gardenia	Noun	gardenia f (plural gardenias)
bate	Noun	bate m (plural bates)
bate	Noun	bate m (plural bates)
numen	Noun	numen m (plural numina)
matula	Noun	matula f (plural matulas)
aizkolari	Noun	aizkolari m (plural aizkolaris)
tilos	Noun	tilos
jet	Noun	jet m (plural jets)
handicap	Noun	handicap m (plural handicaps)
lira	Noun	lira f (plural liras)
lira	Noun	lira f (plural liras)
chili	Noun	chili m (plural chilis)
cheerleader	Noun	cheerleader m, f (plural cheerleaders)
web	Noun	web f (uncountable)
barba	Noun	barba f (plural barbas)
industria	Noun	industria f (plural industrias)
nodo	Noun	nodo m (plural nodos)
carbonaria	Noun	carbonaria f (plural carbonarias, masculine carbonario)
ameba	Noun	ameba f (plural amebas)
paje	Noun	paje m (plural pajes)
singular	Noun	singular m (plural singulares)
optimistas	Noun	optimistas pl
terminal	Noun	terminal m (plural terminales)
formalista	Noun	formalista m, f (plural formalistas)
feroés	Noun	feroés m (plural feroeses)
bunker	Noun	bunker m (plural bunkers)
panca	Noun	panca f (plural pancas)
civilista	Noun	civilista m, f (plural civilistas)
mani	Noun	mani f (plural manis)
hospital	Noun	hospital m (plural hospitales)
loma	Noun	loma f (plural lomas)
era	Noun	era f (plural eras)
era	Noun	era f (plural eras)
uve	Noun	uve f (plural uves)
bungaló	Noun	bungaló m (plural bungalós)
ampere	Noun	ampere m (plural amperes)
dulcamara	Noun	dulcamara f (plural dulcamaras)
mapa	Noun	mapa m (plural mapas)
lid	Noun	lid f (plural lides)
saeta	Noun	saeta f (plural saetas)
tatami	Noun	tatami m (plural tatamis)
marca	Noun	marca f (plural marcas)
paja	Noun	paja f (plural pajas)
miseria	Noun	miseria f (plural miserias)
conclave	Noun	conclave m (plural conclaves)
bedel	Noun	bedel m, f (plural bedeles)
caverna	Noun	caverna f (plural cavernas)
lobo	Noun	lobo m (plural lobos, feminine loba)
doctrina	Noun	doctrina f (plural doctrinas)
palmar	Noun	palmar m (plural palmares)
bambara	Noun	bambara f (uncountable)
hotel	Noun	hotel m (plural hoteles)
pis	Noun	pis m (plural pis)
ratio	Noun	ratio f (plural ratios)
ska	Noun	ska m (plural skas)
motor	Noun	motor m (plural motores)
zona	Noun	zona f (plural zonas)
hulla	Noun	hulla f (plural hullas)
captura	Noun	captura f (plural capturas)
be	Noun	be f (plural bes)
be	Noun	be m (plural bes)
sampi	Noun	sampi f (plural sampis)
pasa	Noun	pasa f (plural pasas)
clamor	Noun	clamor m (plural clamores)
rana	Noun	rana f (plural ranas)
pastor	Noun	pastor m (plural pastores, feminine pastora)
diatriba	Noun	diatriba f (plural diatribas)
signo	Noun	signo m (plural signos)
tenista	Noun	tenista m, f (plural tenistas)
verbal	Noun	verbal m, f (plural verbales)
ale	Noun	ale f (plural ales)
libro	Noun	libro m (plural libros)
zombi	Noun	zombi m, f (plural zombis or zombies)
ratas	Noun	ratas f pl
parodia	Noun	parodia f (plural parodias)
orgía	Noun	orgía f (plural orgías)
deber	Noun	deber m (plural deberes)
mercedes	Noun	mercedes f pl
adenovirus	Noun	adenovirus m (plural adenovirus)
despertar	Noun	despertar m (plural despertares)
fitness	Noun	fitness m (uncountable)
ador	Noun	ador m (plural adores)
agricultor	Noun	agricultor m (plural agricultores, feminine agricultora)
gola	Noun	gola f (plural golas)
puna	Noun	puna f (plural punas)
baja	Noun	baja f (plural bajas)
contumacia	Noun	contumacia f (plural contumacias)
A	Noun	A m
grey	Noun	grey f (plural greyes)
insulto	Noun	insulto m (plural insultos)
agresor	Noun	agresor m (plural agresores, feminine agresora)
jato	Noun	jato m (plural jatos)
cera	Noun	cera f (plural ceras)
torero	Noun	torero m (plural toreros, feminine torera)
suspiro	Noun	suspiro m (plural suspiros)
liga	Noun	liga f (plural ligas)
crescendo	Noun	crescendo m (plural crescendos)
nanos	Noun	nanos
nevera	Noun	nevera f (plural neveras)
sensual	Noun	sensual m, f (plural sensuales)
galaxia	Noun	galaxia f (plural galaxias)
tolva	Noun	tolva f (plural tolvas)
franco	Noun	franco m (plural francos)
macho	Noun	macho m (plural machos)
macho	Noun	macho m (plural machos)
tela	Noun	tela f (plural telas)
alma	Noun	alma f (plural almas)
mundial	Noun	mundial m, f (plural mundiales)
ortopedia	Noun	ortopedia f (uncountable)
apartheid	Noun	apartheid m (plural apartheids)
tortura	Noun	tortura f (plural torturas)
stupa	Noun	stupa f (plural stupas)
lente	Noun	lente m (plural lentes)
burdel	Noun	burdel m (plural burdeles)
conseller	Noun	conseller m (plural conselleres)
trauma	Noun	trauma m (plural traumas)
center	Noun	center m (plural centers)
agonista	Noun	agonista m (plural agonistas)
leu	Noun	leu m (plural lei)
sala	Noun	sala f (plural salas)
nauta	Noun	nauta m, f (plural nautas)
limo	Noun	limo m (plural limos)
hit	Noun	hit m (plural hits)
olas	Noun	olas f pl
la	Noun	la m (plural las)
ganga	Noun	ganga f (plural gangas)
ganga	Noun	ganga f (plural gangas)
ganga	Noun	ganga f (plural gangas)
audacia	Noun	audacia f (plural audacias)
turista	Noun	turista m, f (plural turistas)
rotavirus	Noun	rotavirus m (plural rotavirus)
puta	Noun	puta f (plural putas)
analfabeto	Noun	analfabeto m (plural analfabetos, feminine analfabeta)
peta	Noun	peta f (plural petas)
melisa	Noun	melisa f (plural melisas)
supernova	Noun	supernova m (plural supernovas)
eta	Noun	eta f (plural etas)
avara	Noun	avara f (plural avaras, masculine avaro)
papila	Noun	papila f (plural papilas)
ulna	Noun	ulna f (plural ulnas)
auriga	Noun	auriga m (plural aurigas)
geo	Noun	geo m, f (plural geos)
mudar	Noun	mudar m (plural mudares)
parra	Noun	parra f (plural parras)
propino	Noun	propino m (plural propinos)
sien	Noun	sien f (plural sienes)
albumen	Noun	albumen m (plural albúmenes)
superfamilia	Noun	superfamilia f (plural superfamilias)
factor	Noun	factor m (plural factores)
bode	Noun	bode m (plural bodes)
calcio	Noun	calcio m (uncountable)
uni	Noun	uni f (plural unis)
humo	Noun	humo m (plural humos)
mole	Noun	mole f (plural moles)
mole	Noun	mole m (plural moles)
trampa	Noun	trampa f (plural trampas)
hatos	Noun	hatos
carbón	Noun	carbón m (uncountable)
funky	Noun	funky m (uncountable)
boya	Noun	boya f (plural boyas)
kit	Noun	kit m (plural kits)
taba	Noun	taba f (plural tabas)
brie	Noun	brie m (plural bries)
tricot	Noun	tricot m (plural tricots)
polla	Noun	polla f (plural pollas)
tribuna	Noun	tribuna f (plural tribunas)
reclamo	Noun	reclamo m (plural reclamos)
benefactor	Noun	benefactor m (plural benefactores, feminine benefactora)
inca	Noun	inca m, f (plural incas)
maga	Noun	maga f (plural magas)
gonorrea	Noun	gonorrea f (plural gonorreas)
link	Noun	link m (plural links)
cloch	Noun	cloch m (plural cloches)
fratricida	Noun	fratricida m, f (plural fratricidas)
menda	Noun	menda m (plural mendas)
atol	Noun	atol m (plural atoles)
panacea	Noun	panacea f (plural panaceas)
balada	Noun	balada f (plural baladas)
ekranoplano	Noun	ekranoplano m (plural ekranoplanos)
portal	Noun	portal m (plural portales)
reo	Noun	reo m (plural reos, feminine rea)
reo	Noun	reo m (plural reos)
reo	Noun	reo m (plural reos)
enigma	Noun	enigma m (plural enigmas)
gazpacho	Noun	gazpacho m (plural gazpachos)
arbusto	Noun	arbusto m (plural arbustos)
sobrina	Noun	sobrina f (plural sobrinas)
balista	Noun	balista f (plural balistas)
gen	Noun	gen m (plural genes)
resina	Noun	resina f (plural resinas)
hostia	Noun	hostia f (plural hostias)
boca	Noun	boca f (plural bocas)
mal	Noun	mal m (plural males)
jab	Noun	jab m (plural jabs)
monasterio	Noun	monasterio m (plural monasterios)
café	Noun	café m (plural cafés)
las	Noun	las m pl
venia	Noun	venia f (plural venias)
vago	Noun	vago m (plural vagos, feminine vaga)
monogamia	Noun	monogamia f (uncountable)
logar	Noun	logar m (plural logares)
concordia	Noun	concordia f (plural concordias)
pizzeria	Noun	pizzeria f (plural pizzerias)
punsch	Noun	punsch m (plural punschs)
negro	Noun	negro m (plural negros)
lutos	Noun	lutos m pl
asexual	Noun	asexual m, f (plural asexuales)
enterovirus	Noun	enterovirus m (plural enterovirus)
custodia	Noun	custodia f (plural custodias)
leasing	Noun	leasing m (plural leasings)
patio	Noun	patio m (plural patios)
sarrio	Noun	sarrio m (plural sarrios)
premier	Noun	premier m, f (plural premieres)
albino	Noun	albino m (plural albinos, feminine albina)
sexos	Noun	sexos m pl
ultra	Noun	ultra m, f (plural ultras)
establishment	Noun	establishment m (plural establishments)
corruptela	Noun	corruptela f (plural corruptelas)
kimchi	Noun	kimchi m (plural kimchis)
tila	Noun	tila f (plural tilas)
aragonés	Noun	aragonés m (uncountable)
prisma	Noun	prisma m (plural prismas)
brik	Noun	brik m (plural briks)
haba	Noun	haba f (plural habas)
delta	Noun	delta f (plural deltas)
delta	Noun	delta m (plural deltas)
credo	Noun	credo m (plural credos)
borda	Noun	borda f (plural bordas)
puma	Noun	puma m (plural pumas)
procesor	Noun	procesor m (plural procesores)
estafeta	Noun	estafeta m f (plural estafetas)
aimara	Noun	aimara m, f (plural aimaras)
aimara	Noun	aimara m (uncountable)
calma	Noun	calma f (plural calmas)
lado	Noun	lado m (plural lados)
block	Noun	block m (plural blocks)
futbol	Noun	futbol m (uncountable)
musa	Noun	musa f (plural musas)
cactus	Noun	cactus m (plural cactus)
vespa	Noun	vespa f (plural vespas)
maraca	Noun	maraca f (plural maracas)
harakiri	Noun	harakiri m (uncountable)
tuit	Noun	tuit m (plural tuits)
pato	Noun	pato m (plural patos, feminine pata)
feudo	Noun	feudo m (plural feudos)
alfalfar	Noun	alfalfar m (plural alfalfares)
barra	Noun	barra f (plural barras)
hybris	Noun	hybris f (plural hybris)
plasta	Noun	plasta f (plural plastas)
peso	Noun	peso m (plural pesos)
zeta	Noun	zeta f (plural zetas)
zeta	Noun	zeta f (plural zetas)
bistro	Noun	bistro m (plural bistros)
terapeuta	Noun	terapeuta m, f (plural terapeutas)
campana	Noun	campana f (plural campanas)
solar	Noun	solar m (plural solares)
sal	Noun	sal f (plural sales)
pulpo	Noun	pulpo m (plural pulpos)
polen	Noun	polen m (plural pólenes)
belga	Noun	belga m, f (plural belgas)
nudo	Noun	nudo m (plural nudos)
aya	Noun	aya f (plural ayas)
fastidio	Noun	fastidio m (plural fastidios)
concreto	Noun	concreto m (plural concretos)
aire	Noun	aire m (plural aires)
aire	Noun	aire m (plural aires)
monada	Noun	monada f (plural monadas)
respiro	Noun	respiro m (plural respiros)
manga	Noun	manga f (plural mangas)
manga	Noun	manga m (plural mangas)
viso	Noun	viso m (plural visos)
chiripa	Noun	chiripa f (plural chiripas)
poema	Noun	poema m (plural poemas)
ministras	Noun	ministras f pl
mongol	Noun	mongol m (plural mongoles, feminine mongola)
tory	Noun	tory m (plural torys)
fusta	Noun	fusta f (plural fustas)
machete	Noun	machete m (plural machetes)
spin	Noun	spin m (plural spins)
bota	Noun	bota f (plural botas)
play	Noun	play m (plural plays)
mediana	Noun	mediana f (plural medianas)
semita	Noun	semita m, f (plural semitas)
orca	Noun	orca f (plural orcas, masculine orco)
crista	Noun	crista f (plural cristas)
gula	Noun	gula f (plural gulas)
mono	Noun	mono m (plural monos, feminine mona)
afasia	Noun	afasia f (plural afasias)
loden	Noun	loden m (plural lódenes)
auditorio	Noun	auditorio m (plural auditorios)
tsunami	Noun	tsunami m (plural tsunamis)
faro	Noun	faro m (plural faros)
nabo	Noun	nabo m (plural nabos)
dinar	Noun	dinar m (plural dinares)
material	Noun	material m (plural materiales)
intranet	Noun	intranet f (plural intranets)
barca	Noun	barca f (plural barcas)
drupa	Noun	drupa f (plural drupas)
retardo	Noun	retardo m (plural retardos)
frisón	Noun	frisón m (plural frisones, feminine frisona)
tolerancia	Noun	tolerancia f (plural tolerancias)
bife	Noun	bife m (plural bifes)
pipa	Noun	pipa f (plural pipas)
pipa	Noun	pipa m (plural pipas)
mafia	Noun	mafia f (plural mafias)
falla	Noun	falla f (plural fallas)
Don	Noun	Don m (plural Dones, feminine Doña)
chanson	Noun	chanson m (plural chánsones)
murta	Noun	murta f (plural murtas)
oda	Noun	oda f (plural odas)
panda	Noun	panda f (plural pandas)
panda	Noun	panda m (plural pandas)
incesto	Noun	incesto m (plural incestos)
árabe	Noun	árabe m, f (plural árabes)
vip	Noun	vip m, f (plural vip)
creta	Noun	creta f (uncountable)
vino	Noun	vino m (plural vinos)
naba	Noun	naba f (plural nabas)
twist	Noun	twist m (plural twists)
cyberpunk	Noun	cyberpunk m (plural cyberpunks)
country	Noun	country m (uncountable)
viga	Noun	viga f (plural vigas)
droga	Noun	droga f (plural drogas)
visita	Noun	visita f (plural visitas)
garage	Noun	garage m (uncountable)
jaro	Noun	jaro m (plural jaros)
antimateria	Noun	antimateria f (uncountable)
aleta	Noun	aleta f (plural aletas)
uva	Noun	uva f (plural uvas)
links	Noun	links
hapax legomenon	Noun	hapax legomenon m (uncountable)
CD	Noun	CD m (plural CDs)
sudor	Noun	sudor m (plural sudores)
solista	Noun	solista m, f (plural solistas)
poto	Noun	poto m (plural potos)
rastas	Noun	rastas f pl (plurale tantum)
pedal	Noun	pedal m (plural pedales)
oboe	Noun	oboe m (plural oboes)
sepelio	Noun	sepelio m (plural sepelios)
beta	Noun	beta f (plural betas)
insania	Noun	insania f (plural insanias)
cobra	Noun	cobra f (plural cobras)
patria	Noun	patria f (plural patrias)
doctor	Noun	doctor m (plural doctores, feminine doctora)
sumo	Noun	sumo m (uncountable)
canto	Noun	canto m (plural cantos)
canto	Noun	canto m (plural cantos)
samurai	Noun	samurai
homosexual	Noun	homosexual m, f (plural homosexuales)
himen	Noun	himen m (plural hímenes)
fallos	Noun	fallos m pl
sensor	Noun	sensor m (plural sensores)
peto	Noun	peto m (plural petos)
vista	Noun	vista f (plural vistas)
lunch	Noun	lunch m (plural lunches)
turba	Noun	turba f (plural turbas)
turba	Noun	turba f (plural turbas)
cine	Noun	cine m (plural cines)
tanga	Noun	tanga f (plural tangas)
tun	Noun	tun m (plural tunes)
bombarda	Noun	bombarda f (plural bombardas)
detritus	Noun	detritus m (plural detritus)
cutis	Noun	cutis m (plural cutis)
whisky	Noun	whisky m (uncountable)
ji	Noun	ji f (plural jíes)
base	Noun	base f (plural bases)
selva	Noun	selva f (plural selvas)
split	Noun	split m (uncountable)
lego	Noun	lego m (plural legos, feminine lega)
lutier	Noun	lutier m (plural lutieres)
lona	Noun	lona f (plural lonas)
dogma	Noun	dogma m (plural dogmas)
tele	Noun	tele f (plural teles)
hortensia	Noun	hortensia f (plural hortensias)
tabú	Noun	tabú m (plural tabús or tabúes)
ere	Noun	ere f (plural eres)
clava	Noun	clava f (plural clavas)
chihuahua	Noun	chihuahua f (plural chihuahuas)
provincia	Noun	provincia f (plural provincias)
bit	Noun	bit m (plural bits)
jazz	Noun	jazz m (uncountable)
lana	Noun	lana f (plural lanas)
flirt	Noun	flirt m (plural flirts)
fiesta	Noun	fiesta f (plural fiestas)
finlandés	Noun	finlandés m (plural finlandeses, feminine finlandesa)
narina	Noun	narina f (plural narinas)
suvenir	Noun	suvenir m (plural suvenires)
calva	Noun	calva f (plural calvas)
break	Noun	break m (plural breaks)
neón	Noun	neón m (plural neones)
mousse	Noun	mousse f (plural mousses)
tala	Noun	tala f (uncountable)
tala	Noun	tala m (plural talas)
papiros	Noun	papiros m pl
shamisen	Noun	shamisen m (plural shamisens)
lola	Noun	lola f (plural lolas, masculine lolo)
de	Noun	de f (plural des)
bubones	Noun	bubones m pl
mira	Noun	mira f (plural miras)
reintegro	Noun	reintegro m (plural reintegros)
val	Noun	val m (plural valles)
taxi	Noun	taxi m (plural taxis)
firmware	Noun	firmware m (uncountable)
glamour	Noun	glamour m (uncountable)
caco	Noun	caco m (plural cacos)
asunto	Noun	asunto m (plural asuntos)
inquilino	Noun	inquilino m (plural inquilinos, feminine inquilina)
subfamilia	Noun	subfamilia f (plural subfamilias)
paranoia	Noun	paranoia f (plural paranoias)
jockey	Noun	jockey m (plural jockeys)
minera	Noun	minera f (plural mineras)
fauces	Noun	fauces
urea	Noun	urea f (plural ureas)
regla	Noun	regla f (plural reglas)
regla	Noun	regla m (plural reglas)
zoofobia	Noun	zoofobia f (plural zoofobias)
pesa	Noun	pesa f (plural pesas)
fin	Noun	fin m (plural fines)
wawa	Noun	wawa
papa	Noun	papa m (plural papas)
papa	Noun	papa f (plural papas)
té	Noun	té m (plural tés)
pavo	Noun	pavo m (plural pavos)
compás	Noun	compás m (plural compases)
anemia	Noun	anemia f (plural anemias)
fans	Noun	fans
pila	Noun	pila f (plural pilas)
rey	Noun	rey m (plural reyes)
pop	Noun	pop m (plural pops)
fama	Noun	fama f (plural famas)
kayak	Noun	kayak m (plural kayaks)
talio	Noun	talio m (uncountable)
tulipán	Noun	tulipán m (plural tulipanes)
plato	Noun	plato m (plural platos)
monitora	Noun	monitora f (plural monitoras)
gripa	Noun	gripa f (plural gripas)
fatalista	Noun	fatalista m, f (plural fatalistas)
crin	Noun	crin f (plural crines)
bloguer	Noun	bloguer m (plural bloguers or blogueres)
cifra	Noun	cifra f (plural cifras)
pampa	Noun	pampa f (plural pampas)
tema	Noun	tema m (plural temas)
arginina	Noun	arginina f (plural argininas)
chavo	Noun	chavo m (plural chavos)
rima	Noun	rima f (plural rimas)
doula	Noun	doula f (plural doulas)
miel	Noun	miel f (plural mieles)
telar	Noun	telar m (plural telares)
draft	Noun	draft m (plural drafts)
cicuta	Noun	cicuta f (plural cicutas)
albanés	Noun	albanés m (plural albaneses, feminine albanesa)
albanés	Noun	albanés m (uncountable)
tap	Noun	tap m (uncountable)
bestseller	Noun	bestseller m (plural bestsellers)
mamis	Noun	mamis f pl
sanatorio	Noun	sanatorio m (plural sanatorios)
tamil	Noun	tamil m, f (plural tamiles)
lehendakari	Noun	lehendakari m, f (plural lehendakaris)
o	Noun	o f (plural oes)
ritual	Noun	ritual m (plural rituales)
integral	Noun	integral f (plural integrales)
selfi	Noun	selfi m (plural selfis)
calamar	Noun	calamar m (plural calamares)
boza	Noun	boza f (plural bozas)
voucher	Noun	voucher m (plural vouchers)
gusto	Noun	gusto m (plural gustos)
paleta	Noun	paleta f (plural paletas)
holandés	Noun	holandés m (plural holandeses, feminine holandesa)
holandés	Noun	holandés m (uncountable)
tinta	Noun	tinta f (plural tintas)
mozo	Noun	mozo m (plural mozos, feminine moza)
navajo	Noun	navajo m (plural navajos, feminine navaja)
nazista	Noun	nazista m, f (plural nazistas)
xenón	Noun	xenón m (uncountable)
sud	Noun	sud m (uncountable)
rajón	Noun	rajón m (plural rajones, feminine rajona)
anisar	Noun	anisar m (plural anisares)
habar	Noun	habar m (plural habares)
sopor	Noun	sopor m (plural sopores)
aria	Noun	aria f (plural arias)
led	Noun	led m (plural leds)
anular	Noun	anular m (plural anulares)
beso	Noun	beso m (plural besos)
montera	Noun	montera f (plural monteras)
graffiti	Noun	graffiti m (plural graffitis)
pretor	Noun	pretor m (plural pretores)
fagot	Noun	fagot m (plural fagots)
spray	Noun	spray m (plural sprays)
parecer	Noun	parecer m (plural pareceres)
hostel	Noun	hostel m (plural hostels)
poetas	Noun	poetas pl
colon	Noun	colon m (plural cólones)
morena	Noun	morena f (plural morenas, masculine moreno)
morena	Noun	morena f (plural morenas)
camping	Noun	camping m (plural campings)
orden	Noun	orden f (plural órdenes)
tuareg	Noun	tuareg m, f (plural tuaregs)
polio	Noun	polio f (plural polios)
ele	Noun	ele f (plural eles)
pentanol	Noun	pentanol m (plural pentanoles)
quisque	Noun	quisque m (uncountable)
vesania	Noun	vesania f (plural vesanias)
concurso	Noun	concurso m (plural concursos)
cu	Noun	cu f (plural cúes)
manivela	Noun	manivela f (plural manivelas)
mella	Noun	mella f (plural mellas)
farsa	Noun	farsa f (plural farsas)
Big Mac	Noun	Big Mac m, f (plural Big Macs)
aromaterapia	Noun	aromaterapia f (plural aromaterapias)
geodesia	Noun	geodesia f (uncountable)
rama	Noun	rama f (plural ramas)
match	Noun	match m (plural matches)
veto	Noun	veto m (plural vetos)
gazeta	Noun	gazeta f (plural gazetas)
flauta	Noun	flauta f (plural flautas)
pantera	Noun	pantera f (plural panteras)
afar	Noun	afar m (uncountable)
mallo	Noun	mallo m (plural mallos)
sauna	Noun	sauna f (plural saunas)
tips	Noun	tips
e	Noun	e f (plural es)
alta	Noun	alta f (plural altas)
intento	Noun	intento m (plural intentos)
pies	Noun	pies m pl
larva	Noun	larva f (plural larvas)
meta	Noun	meta f (plural metas)
antena	Noun	antena f (plural antenas)
rival	Noun	rival m, f (plural rivales)
router	Noun	router m (plural routers)
privilegio	Noun	privilegio m (plural privilegios)
reuma	Noun	reuma m (uncountable)
territorio	Noun	territorio m (plural territorios)
galleta	Noun	galleta f (plural galletas)
menta	Noun	menta f (plural mentas)
toreador	Noun	toreador m (plural toreadores)
colona	Noun	colona f (plural colonas, masculine colono)
cora	Noun	cora f (plural coras)
sino	Noun	sino m (plural sinos)
sino	Noun	sino m (plural sinos)
alisar	Noun	alisar m (plural alisares)
ene	Noun	ene f (plural enes)
filatelia	Noun	filatelia f (uncountable)
alfalfa	Noun	alfalfa f (plural alfalfas)
hebrea	Noun	hebrea f (plural hebreas, masculine hebreo)
zelo	Noun	zelo m (uncountable)
foto	Noun	foto f (plural fotos)
playboy	Noun	playboy m (plural playboys)
emmental	Noun	emmental m (plural emmentals)
nivel	Noun	nivel m (plural niveles)
ese	Noun	ese f (plural eses)
paco	Noun	paco m (plural pacos, feminine paca)
sirena	Noun	sirena f (plural sirenas)
bestia	Noun	bestia f (plural bestias)
mineral	Noun	mineral m (plural minerales)
socialistas	Noun	socialistas pl
mail	Noun	mail m (plural mails)
ballet	Noun	ballet m (uncountable)
skinhead	Noun	skinhead m, f (plural skinheads)
renuncio	Noun	renuncio m (plural renuncios)
sigla	Noun	sigla f (plural siglas)
rubia	Noun	rubia f (plural rubias, masculine rubio)
anagrama	Noun	anagrama m (plural anagramas)
forma	Noun	forma f (plural formas)
hiel	Noun	hiel f (uncountable)
punta	Noun	punta f (plural puntas)
pinta	Noun	pinta f (plural pintas)
bluetooth	Noun	bluetooth m (uncountable)
zarina	Noun	zarina f (plural zarinas)
fraile	Noun	fraile m (plural frailes)
et	Noun	et m (plural ets)
nena	Noun	nena f (plural nenas)
visas	Noun	visas
vara	Noun	vara f (plural varas)
page	Noun	page m (plural pages)
swahili	Noun	swahili m (uncountable)
premisa	Noun	premisa f (plural premisas)
cachi	Noun	cachi m (plural cachis)
portugués	Noun	portugués m (uncountable)
jean	Noun	jean m (plural jeans)
ida	Noun	ida f (plural idas)
bosnia	Noun	bosnia f (plural bosnias)
ro	Noun	ro f (plural ros)
lumi	Noun	lumi f (plural lumis)
audiencia	Noun	audiencia f (plural audiencias)
fado	Noun	fado m (plural fados)
lapsus	Noun	lapsus m (plural lapsus)
pin	Noun	pin m (plural pins)
kilo	Noun	kilo m (plural kilos)
tapir	Noun	tapir m (plural tapires)
yoga	Noun	yoga m (plural yogas)
bidé	Noun	bidé m (plural bidés)
errata	Noun	errata f (plural erratas)
golfas	Noun	golfas f pl
orbital	Noun	orbital m (plural orbitales)
pete	Noun	pete m (plural petes)
emir	Noun	emir m (plural emires)
enchilada	Noun	enchilada f (plural enchiladas)
organista	Noun	organista m, f (plural organistas)
fenestra	Noun	fenestra f (plural fenestras)
mojito	Noun	mojito m (plural mojitos)
torres	Noun	torres f pl
barda	Noun	barda f (plural bardas)
sapa	Noun	sapa f (plural sapas, masculine sapo)
sapa	Noun	sapa f (plural sapas)
tara	Noun	tara f (plural taras)
biosfera	Noun	biosfera f (plural biosferas)
ring	Noun	ring m (plural rings)
elefante	Noun	elefante m (plural elefantes)
fara	Noun	fara f (plural faras)
mora	Noun	mora f (plural moras)
mora	Noun	mora f (plural moras, masculine moro)
mora	Noun	mora f (plural moras)
polenta	Noun	polenta f (plural polentas)
idempotencia	Noun	idempotencia f (uncountable)
marihuana	Noun	marihuana f (uncountable)
acacia	Noun	acacia f (plural acacias)
plagio	Noun	plagio m (plural plagios)
bot	Noun	bot m (plural bots)
exilio	Noun	exilio m (plural exilios)
gluten	Noun	gluten m (plural glutenes)
paradigma	Noun	paradigma m (plural paradigmas)
vermut	Noun	vermut m (plural vermuts)
baza	Noun	baza f (plural bazas)
parsimonia	Noun	parsimonia f (plural parsimonias)
grapa	Noun	grapa f (plural grapas)
radio	Noun	radio m, f (plural radios)
radio	Noun	radio f (plural radios)
radio	Noun	radio m (plural radios)
dron	Noun	dron m (plural drones)
normal	Noun	normal f (plural normales)
yugular	Noun	yugular f (plural yugulares)
pulpa	Noun	pulpa m (plural pulpas)
pallar	Noun	pallar m (plural pallares)
abdomen	Noun	abdomen m (plural abdómenes)
contagio	Noun	contagio m (plural contagios)
suaheli	Noun	suaheli m (uncountable)
copo	Noun	copo m (plural copos)
aligátor	Noun	aligátor m (plural aligátores)
laptop	Noun	laptop m (plural laptops)
prosa	Noun	prosa f (plural prosas)
estima	Noun	estima f (plural estimas)
interferencia	Noun	interferencia f (plural interferencias)
fulgor	Noun	fulgor m (plural fulgores)
haya	Noun	haya f (plural hayas)
cambio	Noun	cambio m (plural cambios)
pudor	Noun	pudor m (plural pudores)
subterfugio	Noun	subterfugio m (plural subterfugios)
simpatizante	Noun	simpatizante m, f (plural simpatizantes)
vía	Noun	vía f (plural vías)
galena	Noun	galena f (plural galenas)
gas	Noun	gas m (plural gases)
ops	Noun	ops m (uncountable)
tapete	Noun	tapete m (plural tapetes)
gene	Noun	gene m (plural genes)
beagle	Noun	beagle m (plural beagles)
alces	Noun	alces
rutilo	Noun	rutilo m (plural rutilos)
psi	Noun	psi f (plural psíes)
plaza	Noun	plaza f (plural plazas)
siitake	Noun	siitake m (plural siitakes)
bibliofilia	Noun	bibliofilia f (uncountable)
barbas	Noun	barbas f pl
anta	Noun	anta f (plural antas, masculine ante, masculine plural ante)
fondant	Noun	fondant m (plural fondants)
perspicacia	Noun	perspicacia f (uncountable)
fermento	Noun	fermento m (plural fermentos)
detractor	Noun	detractor m (plural detractores, feminine detractora)
mm	Noun	mm m (plural mms)
rotu	Noun	rotu m (plural rotus)
catcher	Noun	catcher m (plural catchers)
reno	Noun	reno m (plural renos)
asparagina	Noun	asparagina f (plural asparaginas)
tests	Noun	tests m, pl
pulso	Noun	pulso m (plural pulsos)
jibia	Noun	jibia f (plural jibias)
euro	Noun	euro m (plural euros)
lenga	Noun	lenga f (plural lengas)
gira	Noun	gira f (plural giras)
brandy	Noun	brandy m (plural brandys or brandies)
museo	Noun	museo m (plural museos)
misa	Noun	misa f (plural misas)
treonina	Noun	treonina f (plural treoninas)
fibra	Noun	fibra f (plural fibras)
ohm	Noun	ohm m (plural ohms)
ego	Noun	ego m (plural egos)
avocado	Noun	avocado m (plural avocados)
actor	Noun	actor m (plural actores, feminine actriz)
tendencia	Noun	tendencia f (plural tendencias)
alergia	Noun	alergia f (plural alergias)
dandys	Noun	dandys
rumor	Noun	rumor m (plural rumores)
demo	Noun	demo m (plural demos)
ama	Noun	ama f (plural amas, masculine amo)
rastafari	Noun	rastafari m, f (plural rastafaris)
ibis	Noun	ibis m (plural ibis)
provisor	Noun	provisor m (plural provisores)
nidos	Noun	nidos m pl
ni	Noun	ni f (plural níes)
tricolor	Noun	tricolor m (plural tricolores)
paté	Noun	paté m (plural patés)
akan	Noun	akan m (uncountable)
abdominoplastia	Noun	abdominoplastia f (plural abdominoplastias)
saldo	Noun	saldo m (plural saldos)
nostalgia	Noun	nostalgia m (plural nostalgias)
teros	Noun	teros
blogosfera	Noun	blogosfera f (plural blogosferas)
senior	Noun	senior m (plural seniores)
geisha	Noun	geisha f (plural geishas)
albedo	Noun	albedo m (plural albedos)
ate	Noun	ate m (plural ates)
zenit	Noun	zenit m (plural zenit)
salina	Noun	salina f (plural salinas)
apicultor	Noun	apicultor m (plural apicultores)
can	Noun	can m (plural canes)
quebrado	Noun	quebrado m (plural quebrados)
tibia	Noun	tibia f (plural tibias)
galla	Noun	galla f (plural gallas, masculine gallo)
secreto	Noun	secreto m (plural secretos)
spot	Noun	spot m (plural spots)
gallina	Noun	gallina f (plural gallinas)
gato	Noun	gato m (plural gatos, feminine gata)
endorfina	Noun	endorfina f (plural endorfinas)
radial	Noun	radial m (plural radiales)
vistas	Noun	vistas f pl
petos	Noun	petos m pl
shooter	Noun	shooter m (plural shooters)
nirvana	Noun	nirvana m (plural nirvanas)
boli	Noun	boli m (plural bolis)
amenorrea	Noun	amenorrea f (plural amenorreas)
canon	Noun	canon m (plural cánones)
magra	Noun	magra f (plural magras)
vuvuzela	Noun	vuvuzela f (plural vuvuzelas)
lema	Noun	lema m (plural lemas)
vaginoplastia	Noun	vaginoplastia f (plural vaginoplastias)
fondue	Noun	fondue f (plural fondues)
tabla	Noun	tabla f (plural tablas)
lunar	Noun	lunar m (plural lunares)
asteroide	Noun	asteroide m (plural asteroides)
mona	Noun	mona f (plural monas)
mona	Noun	mona f (plural monas, masculine mono)
historia	Noun	historia f (plural historias)
santo	Noun	santo m (plural santos, feminine santa)
astronautas	Noun	astronautas pl
tarja	Noun	tarja f (plural tarjas)
tren	Noun	tren m (plural trenes)
foresta	Noun	foresta f (plural forestas)
dolo	Noun	dolo m (plural dolos)
praxis	Noun	praxis f (plural praxis)
termistor	Noun	termistor m (plural termistores)
antinomia	Noun	antinomia f (plural antinomias)
ros	Noun	ros m (plural roses)
pana	Noun	pana f (plural panas)
sapo	Noun	sapo m (plural sapos)
titular	Noun	titular m (plural titulares)
shot	Noun	shot m (plural shots)
funa	Noun	funa f (plural funas)
alto	Noun	alto m (plural altos)
rutina	Noun	rutina f (plural rutinas)
conciliar	Noun	conciliar m (plural conciliares)
erre	Noun	erre f (plural erres)
caritas	Noun	caritas
parola	Noun	parola f (plural parolas)
insulina	Noun	insulina f (plural insulinas)
pomada	Noun	pomada f (plural pomadas)
optimista	Noun	optimista m, f (plural optimistas)
crooner	Noun	crooner m (plural crooners)
indonesia	Noun	indonesia f (plural indonesias, masculine indonesio)
platina	Noun	platina f (uncountable)
platina	Noun	platina f (plural platinas)
olor	Noun	olor m (plural olores)
geta	Noun	geta f (plural getas)
geta	Noun	geta m, f (plural getas)
plan	Noun	plan m (plural planes)
rigor	Noun	rigor m (plural rigores)
bulgur	Noun	bulgur m (plural bulgures)
monitor	Noun	monitor m (plural monitores)
monitor	Noun	monitor m (plural monitores, feminine monitora)
infamia	Noun	infamia f (plural infamias)
hora	Noun	hora f (plural horas)
rumba	Noun	rumba f (plural rumbas)
famoso	Noun	famoso m (plural famosos, feminine famosa)
carta	Noun	carta f (plural cartas)
nutria	Noun	nutria f (plural nutrias)
cerdo	Noun	cerdo m (plural cerdos, feminine cerda)
apnea	Noun	apnea f (plural apneas)
teta	Noun	teta f (plural tetas)
contra	Noun	contra m (plural contras)
nietos	Noun	nietos m pl
lija	Noun	lija f (plural lijas)
morfema	Noun	morfema m (plural morfemas)
tonsor	Noun	tonsor m (plural tonsores)
longa	Noun	longa f (plural longas)
okupa	Noun	okupa m, f (plural okupas)
angustia	Noun	angustia f (plural angustias)
seta	Noun	seta f (plural setas)
mudo	Noun	mudo m (plural mudos, feminine muda)
autogiro	Noun	autogiro m (plural autogiros)
chips	Noun	chips m pl
flebitis	Noun	flebitis f (uncountable)
ibex	Noun	ibex m (plural ibex)
liberal	Noun	liberal m, f (plural liberales)
bulla	Noun	bulla f (plural bullas)
auditórium	Noun	auditórium m
post	Noun	post m (plural posts)
autor	Noun	autor m (plural autores, feminine autora)
tenis	Noun	tenis m (uncountable)
alcohol	Noun	alcohol m (plural alcoholes)
amusia	Noun	amusia f (uncountable)
onda	Noun	onda f (plural ondas)
afro	Noun	afro m (plural afros)
motel	Noun	motel m (plural moteles)
esteta	Noun	esteta m, f (plural estetas)
loops	Noun	loops
dulce	Noun	dulce m (plural dulces)
foxtrot	Noun	foxtrot m (plural foxtrots)
parricida	Noun	parricida m, f (plural parricidas)
vero	Noun	vero m (plural veros)
tilde	Noun	tilde m, f (plural tildes) (usually feminine)
certamen	Noun	certamen m (plural certámenes)
par	Noun	par m (plural pares)
cantar	Noun	cantar m (plural cantares)
rata	Noun	rata f (plural ratas, masculine rato)
turbina	Noun	turbina f (plural turbinas)
skate	Noun	skate m (plural skates)
mouse	Noun	mouse m (plural mouses)
karst	Noun	karst m (plural karstes)
central	Noun	central f (plural centrales)
rampa	Noun	rampa f (plural rampas)
hamam	Noun	hamam m (plural hamams)
troll	Noun	troll m (plural trolls)
rector	Noun	rector m (plural rectores, feminine rectora)
foro	Noun	foro m (plural foros)
dub	Noun	dub m (plural dubs)
mentor	Noun	mentor m (plural mentores)
inventor	Noun	inventor m (plural inventores)
pediatra	Noun	pediatra m, f (plural pediatras)
patrullera	Noun	patrullera f (plural patrulleras)
duna	Noun	duna f (plural dunas)
grill	Noun	grill m (plural grills)
crimen	Noun	crimen m (plural crímenes)
sioux	Noun	sioux m, f (plural sioux)
tron	Noun	tron m (plural trones)
blusa	Noun	blusa f (plural blusas)
henna	Noun	henna m (plural hennas)
grupa	Noun	grupa f (plural grupas)
iatrofobia	Noun	iatrofobia f (plural iatrofobias)
expolio	Noun	expolio m (plural expolios)
atlas	Noun	atlas m (plural atlas)
chip	Noun	chip m (plural chips)
reto	Noun	reto m (plural retos)
mico	Noun	mico m (plural micos)
mall	Noun	mall m (plural malls)
una	Noun	una f (plural unas)
fenol	Noun	fenol m (plural fenoles)
mama	Noun	mama f (plural mamas)
bol	Noun	bol m (plural boles)
polo	Noun	polo m (plural polos)
polo	Noun	polo m (uncountable)
polo	Noun	polo m (plural polos)
polo	Noun	polo m (plural polos)
baobab	Noun	baobab m (plural baobabs)
querella	Noun	querella f (plural querellas)
guano	Noun	guano m (plural guanos)
local	Noun	local m (plural locales)
destino	Noun	destino m (plural destinos)
etanol	Noun	etanol m (uncountable)
abulia	Noun	abulia f (plural abulias)
arista	Noun	arista f (plural aristas)
finta	Noun	finta f (plural fintas)
interior	Noun	interior m (plural interiores)
diploma	Noun	diploma m (plural diplomas)
culmen	Noun	culmen m (plural cúlmenes)
platea	Noun	platea f (plural plateas)
petunia	Noun	petunia f (plural petunias)
feedback	Noun	feedback m (plural feedbacks)
bagatela	Noun	bagatela f (plural bagatelas)
ensemble	Noun	ensemble m (plural ensembles)
vera	Noun	vera f (plural veras)
vera	Noun	vera f (plural veras)
cyborg	Noun	cyborg m (plural cyborgs)
afta	Noun	afta f (plural aftas)
hindi	Noun	hindi m (uncountable)
rangos	Noun	rangos
terapia	Noun	terapia f (plural terapias)
metalurgia	Noun	metalurgia f (plural metalurgias)
piara	Noun	piara f (plural piaras)
mara	Noun	mara f (plural maras)
coupé	Noun	coupé m (plural coupés)
mino	Noun	mino m (plural minos, feminine mina)
clearing	Noun	clearing m (plural clearings)
app	Noun	app f (plural apps)
gay	Noun	gay m, f (plural gais)
osos	Noun	osos m pl
nata	Noun	nata f (plural natas)
donaire	Noun	donaire m (plural donaires)
wiki	Noun	wiki m, f (plural wikis)
margarita	Noun	margarita f (plural margaritas)
sí	Noun	sí m (plural síes)
folio	Noun	folio m (plural folios)
ardor	Noun	ardor m (plural ardores)
ras	Noun	ras m (plural rases)
vena	Noun	vena f (plural venas)
piccolo	Noun	piccolo m (plural piccolos)
idiota	Noun	idiota m, f (plural idiotas)
verbena	Noun	verbena f (plural verbenas)
acrimonia	Noun	acrimonia f (plural acrimonias)
aspirinas	Noun	aspirinas f pl
ketchup	Noun	ketchup m (plural ketchups)
vice	Noun	vice m, f (plural vice)
kiwi	Noun	kiwi m (plural kiwis)
dromedario	Noun	dromedario m (plural dromedarios)
gaza	Noun	gaza f (plural gazas)
sombrero	Noun	sombrero m (plural sombreros)
mayo	Noun	mayo m (plural mayos)
moda	Noun	moda f (plural modas)
palto	Noun	palto m (plural paltos)
iris	Noun	iris m (plural iris or iríses)
glamur	Noun	glamur m (uncountable)
verso	Noun	verso m (plural versos)
anal	Noun	anal m (plural anales)
clientela	Noun	clientela f (plural clientelas)
pedo	Noun	pedo m (plural pedos)
molestia	Noun	molestia f (plural molestias)
efe	Noun	efe f (plural efes)
querer	Noun	querer m (plural quereres)
lava	Noun	lava f (plural lavas)
kamikaze	Noun	kamikaze m (plural kamikazes)
metras	Noun	metras
model	Noun	model m, f (plural models)
matas	Noun	matas f pl
flota	Noun	flota f (plural flotas)
amento	Noun	amento m (plural amentos)
kits	Noun	kits
trama	Noun	trama f (plural tramas)
baya	Noun	baya f (plural bayas)
manual	Noun	manual m (plural manuales)
planta	Noun	planta f (plural plantas)
real	Noun	real m (plural reales)
idus	Noun	idus m pl (plurale tantum)
canis	Noun	canis
yantar	Noun	yantar m (plural yantares)
basket	Noun	basket m (uncountable)
potencial	Noun	potencial m (plural potenciales)
inspector	Noun	inspector m (plural inspectores, feminine inspectora)
papel	Noun	papel m (plural papeles)
socio	Noun	socio m (plural socios, feminine socia)
pixel	Noun	pixel m (plural pixels)
trombón	Noun	trombón m (plural trombones)
superior	Noun	superior m (plural superiores, feminine superiora)
press	Noun	press m (plural press)
metal	Noun	metal m (plural metales)
contradictor	Noun	contradictor m (plural contradictores, feminine contradictora)
pupa	Noun	pupa f (plural pupas)
gingivitis	Noun	gingivitis f (uncountable)
oficial	Noun	oficial m, f (plural oficiales)
lama	Noun	lama f (plural lamas)
lama	Noun	lama m (plural lamas)
careo	Noun	careo m (plural careos)
vitrina	Noun	vitrina f (plural vitrinas)
prolina	Noun	prolina f (plural prolinas)
tomate	Noun	tomate m (plural tomates)
raclette	Noun	raclette f (plural raclettes)
interfaz	Noun	interfaz f (plural interfaces)
concilio	Noun	concilio m (plural concilios)
siesta	Noun	siesta f (plural siestas)
forja	Noun	forja f (plural forjas)
lar	Noun	lar m (plural lares)
logopedia	Noun	logopedia f (plural logopedias)
trata	Noun	trata f (plural tratas)
ionosfera	Noun	ionosfera f (plural ionosferas)
tuto	Noun	tuto m (plural tutos)
cena	Noun	cena f (plural cenas)
regata	Noun	regata f (plural regatas)
azimut	Noun	azimut f (plural azimutes)
mandril	Noun	mandril m (plural mandriles)
kuchen	Noun	kuchen m (plural kúchenes)
atmosfera	Noun	atmosfera f (plural atmosferas)
germen	Noun	germen m (plural gérmenes)
pino	Noun	pino m (plural pinos)
flato	Noun	flato m (plural flatos)
bowling	Noun	bowling m (plural bowlings)
reverbero	Noun	reverbero m (plural reverberos)
maula	Noun	maula f (plural maulas)
boxer	Noun	boxer m (plural boxers)
kinestesia	Noun	kinestesia f (plural kinestesias)
tarimas	Noun	tarimas f pl
tata	Noun	tata m (plural tatas)
tata	Noun	tata m (plural tatas)
piscina	Noun	piscina f (plural piscinas)
robot	Noun	robot m (plural robots)
cowboy	Noun	cowboy m (plural cowboys)
internista	Noun	internista m, f (plural internistas)
bus	Noun	bus m (plural buses)
spa	Noun	spa f (plural spas)
maya	Noun	maya m, f (plural mayas)
chef	Noun	chef m, f (plural chef)
sutura	Noun	sutura f (plural suturas)
debut	Noun	debut m (plural debutes)
arboricultor	Noun	arboricultor m (plural arboricultores, feminine arboricultora)
pistas	Noun	pistas f pl
yakuza	Noun	yakuza m (plural yakuzas)
batuta	Noun	batuta f (plural batutas)
agenda	Noun	agenda f (plural agendas)
telo	Noun	telo m (plural telos)
protector	Noun	protector m (plural protectores, feminine protectora)
or
protector (feminine singular protectriz, masculine plural protectores, feminine plural protectrices)
bandera	Noun	bandera f (plural banderas)
outsourcing	Noun	outsourcing m (uncountable)
terrier	Noun	terrier m (plural terriers)
data	Noun	data f (plural datas)
suma	Noun	suma f (plural sumas)
total	Noun	total m (plural totales)
tutsi	Noun	tutsi m, f (plural tutsis)
memorial	Noun	memorial m (plural memoriales)
san	Noun	san m (plural sanes)
san	Noun	san f (plural sanes)
nihilista	Noun	nihilista m, f (plural nihilistas)
blackjack	Noun	blackjack m (plural blackjacks)
malta	Noun	malta f (plural maltas)
runa	Noun	runa f (plural runas)
runa	Noun	runa m (plural runas)
pinda	Noun	pinda f (plural pindas)
vigor	Noun	vigor m (plural vigores)
cover	Noun	cover m (plural covers)
horticultor	Noun	horticultor m (plural horticultores, feminine horticultora)
pitbull	Noun	pitbull m (plural pitbulls)
manta	Noun	manta f (plural mantas)
paparazi	Noun	paparazi m (plural paparazis)
nene	Noun	nene m (plural nenes, feminine nena)
candela	Noun	candela f (plural candelas)
ión	Noun	ión m (plural iones)
vergas	Noun	vergas f pl
modestia	Noun	modestia f (plural modestias)
cubo	Noun	cubo m (plural cubos)
adorno	Noun	adorno m (plural adornos)
toto	Noun	toto m (plural totos)
maestro	Noun	maestro m (plural maestros, feminine maestra)
pun	Noun	pun m (uncountable)
antisemita	Noun	antisemita m, f (plural antisemitas)
cursor	Noun	cursor m (plural cursores)
lustro	Noun	lustro m (plural lustros)
standing	Noun	standing m (plural standings)
bonga	Noun	bonga f (plural bongas)
grammatica	Noun	grammatica f (plural grammaticas)
porras	Noun	porras f pl
sector	Noun	sector m (plural sectores)
magenta	Noun	magenta m (uncountable)
sopa	Noun	sopa f (plural sopas)
bungalow	Noun	bungalow m (plural bungalows)
este	Noun	este m (uncountable)
alma mater	Noun	alma mater f (plural alma mater)
setos	Noun	setos m pl
rapsodia	Noun	rapsodia f (plural rapsodias)
olla	Noun	olla f (plural ollas)
farol	Noun	farol m (plural faroles)
islandés	Noun	islandés m (plural islandeses, feminine islandesa)
santa	Noun	santa f (plural santas)
bananas	Noun	bananas
valla	Noun	valla f (plural vallas)
jirafa	Noun	jirafa f (plural jirafas)
citrón	Noun	citrón m (plural citrones)
consumo	Noun	consumo m (plural consumos)
bonus	Noun	bonus m (plural bonus)
fe	Noun	fe f (uncountable)
tiro	Noun	tiro m (plural tiros)
catering	Noun	catering m (uncountable)
sonata	Noun	sonata f (plural sonatas)
don	Noun	don m (plural dones, feminine doña)
don	Noun	don m (plural dones)
prosodia	Noun	prosodia f (uncountable)
holocaustos	Noun	holocaustos m pl
aureola	Noun	aureola f (plural aureolas)
piure	Noun	piure m (plural piures)
periferia	Noun	periferia f (plural periferias)
teka	Noun	teka f (plural tekas)
aulas	Noun	aulas f pl
cantautor	Noun	cantautor m (plural cantautores, feminine cantautora)
cruce	Noun	cruce m (plural cruces)
pita	Noun	pita f (plural pitas)
pantomima	Noun	pantomima f (plural pantomimas)
pega	Noun	pega f (plural pegas)
castor	Noun	castor m (plural castores)
kibutz	Noun	kibutz m (plural kibutzes)
ninja	Noun	ninja m, f (plural ninjas)
torpedo	Noun	torpedo m (plural torpedos)
haber	Noun	haber m (plural haberes)
mando	Noun	mando m (plural mandos)
testa	Noun	testa f (plural testas)
bingo	Noun	bingo m (plural bingos)
gym	Noun	gym m (plural gyms)
nada	Noun	nada f (uncountable)
metionina	Noun	metionina f (plural metioninas)
crítico	Noun	crítico m (plural críticos, feminine crítica)
farmaceuta	Noun	farmaceuta m, f (plural farmaceutas)
batutas	Noun	batutas f pl
marina	Noun	marina f (plural marinas)
polea	Noun	polea f (plural poleas)
serie	Noun	serie f (plural series)
blenda	Noun	blenda f (plural blendas)
bala	Noun	bala f (plural balas)
fosa	Noun	fosa f (plural fosas)
singulto	Noun	singulto m (plural singultos)
fresa	Noun	fresa f (plural fresas)
fresa	Noun	fresa f (plural fresas)
monas	Noun	monas
calco	Noun	calco m (plural calcos)
lodo	Noun	lodo m (plural lodos)
dominó	Noun	dominó m (plural dominós)
notebook	Noun	notebook m (plural notebooks)
prisa	Noun	prisa f (plural prisas)
lacha	Noun	lacha f (plural lachas, masculine lacho)
lacha	Noun	lacha f (plural lachas)
meigo	Noun	meigo m (plural meigos)
torso	Noun	torso m (plural torsos)
yen	Noun	yen m (plural yenes)
giro	Noun	giro m (plural giros)
livor	Noun	livor m (plural livores)
albinos	Noun	albinos m pl
diesel	Noun	diesel m (plural diesels)
saber	Noun	saber m (uncountable)
exprimer	Noun	exprimer m (plural exprimeres)
judo	Noun	judo m (uncountable)
novel	Noun	novel m, f (plural noveles)
aros	Noun	aros
controversia	Noun	controversia f (plural controversias)
grava	Noun	grava f (plural gravas)
sistema	Noun	sistema m (plural sistemas)
tensor	Noun	tensor m (plural tensores)
hucha	Noun	hucha f (plural huchas)
auxilio	Noun	auxilio m (plural auxilios)
set	Noun	set m (plural sets)
aspi	Noun	aspi m (plural aspis)
zebra	Noun	zebra f (plural zebras)
llama	Noun	llama f (plural llamas)
llama	Noun	llama f (plural llamas)
magistratura	Noun	magistratura f (plural magistraturas)
propaganda	Noun	propaganda f (plural propagandas)
talar	Noun	talar m (plural talares)
delfín	Noun	delfín m (plural delfines)
limen	Noun	limen m (plural límenes)
factura	Noun	factura f (plural facturas)
confessor	Noun	confessor m (plural confessores)
anestesia	Noun	anestesia f (plural anestesias)
perceptor	Noun	perceptor m (plural perceptores, feminine perceptora)
intriga	Noun	intriga f (plural intrigas)
visa	Noun	visa f (plural visas)
pirata	Noun	pirata m, f (plural piratas)
palma	Noun	palma f (plural palmas)
asa	Noun	asa f (plural asas)
iracundia	Noun	iracundia f (plural iracundias)
panorama	Noun	panorama m (plural panoramas)
molinar	Noun	molinar m (plural molinares)
info	Noun	info f (plural infos)
exterior	Noun	exterior m (plural exteriores)
chan	Noun	chan m (plural chanes)
liturgia	Noun	liturgia f (plural liturgias)
vector	Noun	vector m (plural vectores)
vagón	Noun	vagón m (plural vagones)
diabetes	Noun	diabetes f (plural diabetes)
serum	Noun	serum m (plural serums)
funk	Noun	funk m (uncountable)
i	Noun	i f (plural íes)
elle	Noun	elle f (plural elles)
evangelista	Noun	evangelista m (plural evangelistas)
gel	Noun	gel m (plural geles)
bulimia	Noun	bulimia f (plural bulimias)
tarjeta	Noun	tarjeta f (plural tarjetas)
wok	Noun	wok m (plural woks)
hule	Noun	hule m (plural hules)
brama	Noun	brama f (plural bramas)
sah	Noun	sah m (plural sah)
tandem	Noun	tandem m (plural tandems)
amnesia	Noun	amnesia f (plural amnesias)
columna	Noun	columna f (plural columnas)
memoria	Noun	memoria f (plural memorias)
aluminio	Noun	aluminio m (plural aluminios)
bentos	Noun	bentos m (uncountable)
adrenalina	Noun	adrenalina f (plural adrenalinas)
aorta	Noun	aorta f (plural aortas)
burra	Noun	burra f (plural burras, masculine burro)
materia	Noun	materia f (plural materias)
mena	Noun	mena f (plural menas)
albatros	Noun	albatros m (plural albátroses)
labor	Noun	labor f (plural labores)
taoiseach	Noun	taoiseach m (plural taoiseachs)
dieta	Noun	dieta f (plural dietas)
dieta	Noun	dieta f (plural dietas)
belgas	Noun	belgas pl
fractura	Noun	fractura f (plural fracturas)
decibel	Noun	decibel m (plural decibeles)
causa	Noun	causa f (plural causas)
caddie	Noun	caddie m, f (plural caddies)
seborrea	Noun	seborrea f (plural seborreas)
pacha	Noun	pacha f (plural pachas)
manto	Noun	manto m (plural mantos)
persecutor	Noun	persecutor m (plural persecutores)
pus	Noun	pus m (plural puses)
androfobia	Noun	androfobia f (plural androfobias)
chele	Noun	chele m (plural cheles)
chele	Noun	chele m f (plural cheles)
circo	Noun	circo m (plural circos)
olimpiada	Noun	olimpiada f (plural olimpiadas)
carpa	Noun	carpa f (plural carpas)
carpa	Noun	carpa f (plural carpas)
dominio	Noun	dominio m (plural dominios)
ideal	Noun	ideal m (plural ideales)
vito	Noun	vito m (plural vitos)
furor	Noun	furor f (plural furores)
ruina	Noun	ruina f (plural ruinas)
danés	Noun	danés m (plural daneses, feminine danesa)
mandolina	Noun	mandolina f (plural mandolinas)
posada	Noun	posada f (plural posadas)
chin	Noun	chin m (plural chines)
tumor	Noun	tumor m (plural tumores)
reverso	Noun	reverso m (plural reversos)
logopeda	Noun	logopeda m, f (plural logopedas)
figura	Noun	figura f (plural figuras)
salami	Noun	salami m (plural salamis)
rasta	Noun	rasta m, f (plural rastas)
auditor	Noun	auditor m (plural auditores, feminine auditora)
porcelana	Noun	porcelana f (plural porcelanas)
alar	Noun	alar m (plural alares)
edicto	Noun	edicto m (plural edictos)
biomasa	Noun	biomasa f (plural biomasas)
mongolas	Noun	mongolas f pl
piano	Noun	piano m (plural pianos)
artista	Noun	artista m, f (plural artistas)
reptil	Noun	reptil m (plural reptiles)
paella	Noun	paella f (plural paellas)
litera	Noun	litera f (plural literas)
baca	Noun	baca f (plural bacas)
atardecer	Noun	atardecer m (plural atardeceres)
arete	Noun	arete m (plural aretes)
begonia	Noun	begonia f (plural begonias)
banana	Noun	banana f (plural bananas)
claro	Noun	claro m (plural claros)
silla	Noun	silla f (plural sillas)
paralipsis	Noun	paralipsis f (plural paralipsis)
cloaca	Noun	cloaca f (plural cloacas)
euforia	Noun	euforia f (plural euforias)
mu	Noun	mu f (plural múes)
golfista	Noun	golfista m, f (plural golfistas)
sponsor	Noun	sponsor m (plural sponsores)
pe	Noun	pe f (plural pes)
pastel	Noun	pastel m (plural pasteles)
mala	Noun	mala f (plural malas)
vello	Noun	vello m (plural vellos)
motocross	Noun	motocross m (uncountable)
días	Noun	días m pl
coma	Noun	coma f (plural comas)
coma	Noun	coma f (plural comas)
coma	Noun	coma f (plural comas)
aligator	Noun	aligator m (plural aligatores)
euskera	Noun	euskera m (uncountable)
abra	Noun	abra f (plural abras)
altruista	Noun	altruista m, f (plural altruistas)
bislama	Noun	bislama m (uncountable)
guinea	Noun	guinea f (plural guineas)
guinea	Noun	guinea f (plural guineas)
lambada	Noun	lambada f (plural lambadas)
olingo	Noun	olingo m (plural olingos)
look	Noun	look m (plural looks)
pilar	Noun	pilar m (plural pilares)
poder	Noun	poder m (plural poderes)
casa	Noun	casa f (plural casas)
norma	Noun	norma f (plural normas)
impar	Noun	impar m (plural impares)
vapor	Noun	vapor m (plural vapores)
discordia	Noun	discordia f (plural discordias)
anorak	Noun	anorak m (plural anoraks)
bien	Noun	bien m (plural bienes)
cupo	Noun	cupo m (plural cupos)
líder	Noun	líder m f (plural líderes)
rai	Noun	rai m (uncountable)
president	Noun	president m (plural presidents)
flanera	Noun	flanera f (plural flaneras)
matrona	Noun	matrona f (plural matronas)
abadesa	Noun	abadesa f (plural abadesas)
western	Noun	western m (plural westerns)
superficies	Noun	superficies f pl
lucios	Noun	lucios m pl
milla	Noun	milla f (plural millas)
tapas	Noun	tapas f pl
virus	Noun	virus m (plural virus)
filial	Noun	filial f (plural filiales)
status	Noun	status m (plural status)
marimba	Noun	marimba f (plural marimbas)
perca	Noun	perca f (plural percas)
ceremonia	Noun	ceremonia f (plural ceremonias)
grande	Noun	grande m (plural grandes)
favor	Noun	favor m (plural favores)
tasa	Noun	tasa f (plural tasas)
loba	Noun	loba f (plural lobas)
monoides	Noun	monoides
carne	Noun	carne f (plural carnes)
lux	Noun	lux m (plural lux)
nubes	Noun	nubes f pl
defensor	Noun	defensor m (plural defensores, feminine defensora)
filamentos	Noun	filamentos m pl
pipi	Noun	pipi m (plural pipis)
pasma	Noun	pasma m, f (plural pasmas)
pasma	Noun	pasma f (plural pasmas)
soja	Noun	soja f (plural sojas)
gloria	Noun	gloria f (plural glorias)
mundo	Noun	mundo m (plural mundos)
papilla	Noun	papilla f (plural papillas)
presidente	Noun	presidente m, f (plural presidentes, feminine presidenta)
bikini	Noun	bikini m (plural bikinis)
francés	Noun	francés m (plural franceses, feminine francesa)
francés	Noun	francés m (uncountable)
francés	Noun	francés m (uncountable)
flora	Noun	flora f (plural floras)
dona	Noun	dona f (plural donas)
brunch	Noun	brunch m (plural brunchs)
focos	Noun	focos m pl
barman	Noun	barman m (plural barman)
cocktail	Noun	cocktail m (plural cocktails)
buffet	Noun	buffet m (plural buffets)
salamandra	Noun	salamandra f (plural salamandras)
relevo	Noun	relevo m (plural relevos)
borrachas	Noun	borrachas f pl
lord	Noun	lord m (plural lores)
sato	Noun	sato m (plural satos)
gorila	Noun	gorila m (plural gorilas)
rapto	Noun	rapto m (plural raptos)
neofobia	Noun	neofobia f (plural neofobias)
mesa	Noun	mesa f (plural mesas)
