berri	Noun	berri
ahate	Noun	ahate
karratu	Noun	karratu
hil	Noun	hil
setemere	Noun	setemere
aizkolari	Noun	aizkolari
otsail	Noun	otsail
astearte	Noun	astearte
fatxada	Noun	fatxada
eslovakiera	Noun	eslovakiera
toil	Noun	toil
arrakasta	Noun	arrakasta
katagorri	Noun	katagorri
garagardo	Noun	garagardo
osziloskopio	Noun	osziloskopio
ilen	Noun	ilen
akordeoi	Noun	akordeoi
senargai	Noun	senargai
ate	Noun	ate
bielorrusiera	Noun	bielorrusiera
udaltzaingo	Noun	udaltzaingo
salda	Noun	salda
amona	Noun	amona
alkate	Noun	alkate
arreba	Noun	arreba
galtzarbe	Noun	galtzarbe
txigorgailu	Noun	txigorgailu
enigma	Noun	enigma
zenbaki	Noun	zenbaki
irakurgela	Noun	irakurgela
kalkulagailu	Noun	kalkulagailu
abadegai	Noun	abadegai
lu	Noun	lu
txakurkume	Noun	txakurkume
belarri	Noun	belarri
sari	Noun	sari
errumaniar	Noun	errumaniar
mapa	Noun	mapa
ioi	Noun	ioi
belarritako	Noun	belarritako
apar	Noun	apar
alemanera	Noun	alemanera
gaupasa	Noun	gaupasa
sail	Noun	sail
itsu	Noun	itsu
koru	Noun	koru
madari	Noun	madari
basurde	Noun	basurde
okzitaniera	Noun	okzitaniera
untxi	Noun	untxi
agor	Noun	agor
xake	Noun	xake
udaberri	Noun	udaberri
sufre	Noun	sufre
mandar	Noun	mandar
larunbat	Noun	larunbat
andregai	Noun	andregai
lepo	Noun	lepo
taxi	Noun	taxi
vietnamera	Noun	vietnamera
animalia	Noun	animalia
teknologia	Noun	teknologia
adar	Noun	adar
arkatz	Noun	arkatz
heriotza	Noun	heriotza
borroka	Noun	borroka
buru	Noun	buru
uda	Noun	uda
austriar	Noun	austriar
georgiera	Noun	georgiera
mazedoniera	Noun	mazedoniera
politikari	Noun	politikari
sugar	Noun	sugar
ijito	Noun	ijito
aukera	Noun	aukera
puska	Noun	puska
gor	Noun	gor
bumerang	Noun	bumerang
ainarba	Noun	ainarba
armeniera	Noun	armeniera
antilope	Noun	antilope
sama	Noun	sama
amesgaizto	Noun	amesgaizto
hotz	Noun	hotz
dorretxe	Noun	dorretxe
tati	Noun	tati
ar	Noun	ar
berakatz	Noun	berakatz
zuhaixka	Noun	zuhaixka
txirula	Noun	txirula
portuges	Noun	portuges
laranja	Noun	laranja
argazki	Noun	argazki
euskara	Noun	euskara
italiera	Noun	italiera
hostaro	Noun	hostaro
motel	Noun	motel
apaizgai	Noun	apaizgai
azkonar	Noun	azkonar
uso	Noun	uso
sai	Noun	sai
mando	Noun	mando
xurgagailu	Noun	xurgagailu
estoniar	Noun	estoniar
diodo	Noun	diodo
txerriki	Noun	txerriki
kazakhera	Noun	kazakhera
bizikleta	Noun	bizikleta
amaginarrebakide	Noun	amaginarrebakide
italiar	Noun	italiar
sen	Noun	sen
edan	Noun	edan
asteburu	Noun	asteburu
erregina	Noun	erregina
euli	Noun	euli
atzelari	Noun	atzelari
monasterio	Noun	monasterio
diru	Noun	diru
zubi	Noun	zubi
futbol	Noun	futbol
japoniar	Noun	japoniar
gamelu	Noun	gamelu
udara	Noun	udara
kromosfera	Noun	kromosfera
sabel	Noun	sabel
pisu	Noun	pisu
erloju	Noun	erloju
glaziazio	Noun	glaziazio
aitaginarreba	Noun	aitaginarreba
enparantza	Noun	enparantza
abertzaletasun	Noun	abertzaletasun
japoniera	Noun	japoniera
izeko	Noun	izeko
eliza	Noun	eliza
kazetari	Noun	kazetari
domeka	Noun	domeka
suediera	Noun	suediera
zaldi	Noun	zaldi
basarto	Noun	basarto
txartel	Noun	txartel
haize	Noun	haize
abkhazera	Noun	abkhazera
biolin	Noun	biolin
astelehen	Noun	astelehen
andre	Noun	andre
uholde	Noun	uholde
basamortu	Noun	basamortu
aitaginarrebakide	Noun	aitaginarrebakide
kale	Noun	kale
isun	Noun	isun
futbolari	Noun	futbolari
elektroi	Noun	elektroi
hematokrito	Noun	hematokrito
iritzi	Noun	iritzi
anodo	Noun	anodo
armiarma-sare	Noun	armiarma-sare
hungariera	Noun	hungariera
udazken	Noun	udazken
prostituzio	Noun	prostituzio
sexualitate	Noun	sexualitate
teilatu	Noun	teilatu
hots	Noun	hots
likido	Noun	likido
hanka	Noun	hanka
gerra	Noun	gerra
armiarma	Noun	armiarma
abeslari	Noun	abeslari
telefono	Noun	telefono
katua	Noun	katua
logela	Noun	logela
bandera	Noun	bandera
izotz	Noun	izotz
har	Noun	har
toki	Noun	toki
lotazil	Noun	lotazil
uztail	Noun	uztail
pa	Noun	pa
ebiakoitz	Noun	ebiakoitz
bulego	Noun	bulego
mamu	Noun	mamu
iztai	Noun	iztai
ahizpa	Noun	ahizpa
liztor	Noun	liztor
etxe-txakur	Noun	etxe-txakur
ingeles	Noun	ingeles
partizipio	Noun	partizipio
hazil	Noun	hazil
eguraldi	Noun	eguraldi
beribil	Noun	beribil
zerbitzu	Noun	zerbitzu
ortzegun	Noun	ortzegun
egubakoitz	Noun	egubakoitz
frantziar	Noun	frantziar
arbeletxeko	Noun	arbeletxeko
hiena	Noun	hiena
arabiera	Noun	arabiera
altzairu	Noun	altzairu
izokin	Noun	izokin
litosfera	Noun	litosfera
dilista	Noun	dilista
suge	Noun	suge
era	Noun	era
zerri	Noun	zerri
karabela	Noun	karabela
neguil	Noun	neguil
aho	Noun	aho
galtzari	Noun	galtzari
lauburu	Noun	lauburu
hizkuntza	Noun	hizkuntza
abadesa	Noun	abadesa
amaginarreba	Noun	amaginarreba
ipar	Noun	ipar
urtarril	Noun	urtarril
tenislari	Noun	tenislari
kontsonante	Noun	kontsonante
parke	Noun	parke
soinu	Noun	soinu
erbi	Noun	erbi
ikurrin	Noun	ikurrin
pinpilinpauxa	Noun	pinpilinpauxa
lo	Noun	lo
geiser	Noun	geiser
amu	Noun	amu
gibel	Noun	gibel
transformadore	Noun	transformadore
azal	Noun	azal
aintzira	Noun	aintzira
lurrikara	Noun	lurrikara
egongela	Noun	egongela
fotoi	Noun	fotoi
molde	Noun	molde
ileorde	Noun	ileorde
tximeleta	Noun	tximeleta
tximino	Noun	tximino
komiki	Noun	komiki
gaztaina	Noun	gaztaina
pasaporte	Noun	pasaporte
ibilgailu	Noun	ibilgailu
somaliera	Noun	somaliera
eslovakiar	Noun	eslovakiar
habe	Noun	habe
sagardo	Noun	sagardo
kontrol-dorre	Noun	kontrol-dorre
nenufar	Noun	nenufar
arima	Noun	arima
hilerri	Noun	hilerri
ikasle	Noun	ikasle
lizar	Noun	lizar
abade	Noun	abade
espainiar	Noun	espainiar
arratoi	Noun	arratoi
krokodilo	Noun	krokodilo
zerbeza	Noun	zerbeza
atari	Noun	atari
sator	Noun	sator
altzari	Noun	altzari
elefante	Noun	elefante
basalto	Noun	basalto
astronomia	Noun	astronomia
izozki	Noun	izozki
museo	Noun	museo
umezurztegi	Noun	umezurztegi
inurritegi	Noun	inurritegi
eguen	Noun	eguen
ahuntz	Noun	ahuntz
heliportu	Noun	heliportu
alemaniar	Noun	alemaniar
lore-hauts	Noun	lore-hauts
eskularru	Noun	eskularru
hidrosfera	Noun	hidrosfera
ortzirale	Noun	ortzirale
lupa	Noun	lupa
irrati	Noun	irrati
zirkonio	Noun	zirkonio
pago	Noun	pago
epe	Noun	epe
etxe	Noun	etxe
barantaila	Noun	barantaila
aleman	Noun	aleman
aire	Noun	aire
kiribil	Noun	kiribil
jatetxe	Noun	jatetxe
ume	Noun	ume
izotzil	Noun	izotzil
marrubi	Noun	marrubi
panti	Noun	panti
aktore	Noun	aktore
dromedario	Noun	dromedario
sagarrondo	Noun	sagarrondo
maiatz	Noun	maiatz
ur	Noun	ur
ur	Noun	ur
landare	Noun	landare, landareak pl
haga	Noun	haga
esku	Noun	esku
minigona	Noun	minigona
serbiera	Noun	serbiera
xakelari	Noun	xakelari
buruil	Noun	buruil
etxe zuria	Noun	etxe zuria
tajikera	Noun	tajikera
aerolabaingailu	Noun	aerolabaingailu
ohe	Noun	ohe
sentsore	Noun	sentsore
kanguru	Noun	kanguru
hodei	Noun	hodei
muga	Noun	muga
alkohol	Noun	alkohol
izurde	Noun	izurde
kapar	Noun	kapar
andorratar	Noun	andorratar
dibidendu	Noun	dibidendu
bildil	Noun	bildil
mingrana	Noun	mingrana
lituaniera	Noun	lituaniera
geraleku	Noun	geraleku
alde	Noun	alde
ekaitz	Noun	ekaitz
ponpa	Noun	ponpa
tornulari	Noun	tornulari
potasio	Noun	potasio
pika	Noun	pika
meza	Noun	meza
musikari	Noun	musikari
arto	Noun	arto
mezu	Noun	mezu
muoi	Noun	muoi
abesbatza	Noun	abesbatza
leptoi	Noun	leptoi
aberastasun	Noun	aberastasun
jauregi	Noun	jauregi
sinkrotroi	Noun	sinkrotroi
ospitale	Noun	ospitale
polen	Noun	polen
esperanto	Noun	esperanto
uharte	Noun	uharte
espazio-ontzi	Noun	espazio-ontzi
erdi	Noun	erdi
apaiz	Noun	apaiz
leku	Noun	leku
asteroide	Noun	asteroide
igogailu	Noun	igogailu
sinkroziklotroi	Noun	sinkroziklotroi
deitura	Noun	deitura
paita	Noun	paita
elder	Noun	elder
bielorrusiar	Noun	bielorrusiar
tigre	Noun	tigre
txerri	Noun	txerri
behor	Noun	behor
anagrama	Noun	anagrama
balezta	Noun	balezta
neurri	Noun	neurri
abkhaziar	Noun	abkhaziar
inbasio	Noun	inbasio
elektrodo	Noun	elektrodo
xanpu	Noun	xanpu
ordenagailu	Noun	ordenagailu
orein	Noun	orein
zezen	Noun	zezen
lehoi	Noun	lehoi
hika	Noun	hika
agorril	Noun	agorril
igande	Noun	igande
arbola	Noun	arbola
artzain-txakur	Noun	artzain-txakur
galesera	Noun	galesera
mantar	Noun	mantar
bulgariera	Noun	bulgariera
abesti	Noun	abesti
liztortzar	Noun	liztortzar
poloniera	Noun	poloniera
amiamoko	Noun	amiamoko
aizkora	Noun	aizkora
taxilari	Noun	taxilari
sardexka	Noun	sardexka
hiriburu	Noun	hiriburu
baserri	Noun	baserri
bosoi	Noun	bosoi
danbor	Noun	danbor
aukeraketa	Noun	aukeraketa
pornografia	Noun	pornografia
protoi	Noun	protoi
urtxintxa	Noun	urtxintxa
islandiera	Noun	islandiera
mutur	Noun	mutur
ile	Noun	ile
sare	Noun	sare
indonesiera	Noun	indonesiera
gizon	Noun	gizon
islandiar	Noun	islandiar
apiril	Noun	apiril
ostegun	Noun	ostegun
udare	Noun	udare
siziliera	Noun	siziliera
bihotz	Noun	bihotz
azeri	Noun	azeri
andere	Noun	andere
gaztelera	Noun	gaztelera
are	Noun	are
behi	Noun	behi
letoniera	Noun	letoniera
oreka	Noun	oreka
kroaziera	Noun	kroaziera
urin	Noun	urin
bare	Noun	bare
euskalki	Noun	euskalki
lastail	Noun	lastail
aldizkari	Noun	aldizkari
laut	Noun	laut
ingeniari	Noun	ingeniari
epaile	Noun	epaile
belar	Noun	belar
errumaniera	Noun	errumaniera
kafe	Noun	kafe
negu	Noun	negu
geltoki	Noun	geltoki
euskera	Noun	euskera
aste	Noun	aste
udalerri	Noun	udalerri
abadia	Noun	abadia
izeba	Noun	izeba
izozmendi	Noun	izozmendi
txekiera	Noun	txekiera
aberri	Noun	aberri
teleskopio	Noun	teleskopio
zezenkari	Noun	zezenkari
osasun	Noun	osasun
mongoliera	Noun	mongoliera
lepoko	Noun	lepoko
kemen	Noun	kemen
ardo zuri	Noun	ardo zuri
autobus	Noun	autobus
daniera	Noun	daniera
musker	Noun	musker
hegazkin	Noun	hegazkin
plaza	Noun	plaza
hebreera	Noun	hebreera
greba	Noun	greba
sumendi	Noun	sumendi
egitasmo	Noun	egitasmo
daniar	Noun	daniar
narkotrafiko	Noun	narkotrafiko
indaba	Noun	indaba
mineralogia	Noun	mineralogia
tranbia	Noun	tranbia
aitona	Noun	aitona
altxoin	Noun	altxoin
ipotx	Noun	ipotx
ardo beltz	Noun	ardo beltz
hezur	Noun	hezur
gatz	Noun	gatz
alor	Noun	alor
besape	Noun	besape
ingelera	Noun	ingelera
turkiera	Noun	turkiera
amaraun	Noun	amaraun
orburu	Noun	orburu
adore	Noun	adore
homosexualitate	Noun	homosexualitate
opor	Noun	opor
aireportu	Noun	aireportu
neologismo	Noun	neologismo
asteazken	Noun	asteazken
aro	Noun	aro
giro	Noun	giro
eritasun	Noun	eritasun
unibertso	Noun	unibertso
gorotzil	Noun	gorotzil
bele	Noun	bele
bosniera	Noun	bosniera
zapatu	Noun	zapatu
urzo	Noun	urzo
elektronika	Noun	elektronika
ekranoplano	Noun	ekranoplano
igeltsero	Noun	igeltsero
artzain	Noun	artzain
elur	Noun	elur
gogo	Noun	gogo
gaixotasun	Noun	gaixotasun
ukrainera	Noun	ukrainera
lorail	Noun	lorail
senatu	Noun	senatu
gaztelu	Noun	gaztelu
zauri	Noun	zauri
lur	Noun	lur
dortoka	Noun	dortoka
zebra	Noun	zebra
lore	Noun	lore
eskusoinu	Noun	eskusoinu
neutroi	Noun	neutroi
pospolo	Noun	pospolo
ereiaro	Noun	ereiaro
zikoina	Noun	zikoina
albaniar	Noun	albaniar
estoniera	Noun	estoniera
abizen	Noun	abizen
anbulantzia	Noun	anbulantzia
zerbitzugune	Noun	zerbitzugune
landa	Noun	landa
azerbaijandar	Noun	azerbaijandar
janari	Noun	janari
galtzetin	Noun	galtzetin
gazta	Noun	gazta
immunoeskasia	Noun	immunoeskasia
pansexualitate	Noun	pansexualitate
alaba	Noun	alaba
uzbekera	Noun	uzbekera
baseliza	Noun	baseliza
onomatopeia	Noun	onomatopeia
afganistandar	Noun	afganistandar
gurin	Noun	gurin
apo	Noun	apo
elkarlan	Noun	elkarlan
bazilo	Noun	bazilo
koala	Noun	koala
albaniera	Noun	albaniera
azerbaijanera	Noun	azerbaijanera
uts	Noun	uts
eguazten	Noun	eguazten
abantaila	Noun	abantaila
errugbilari	Noun	errugbilari
etxe-katu	Noun	etxe-katu
kroaziar	Noun	kroaziar
irin	Noun	irin
bufalo	Noun	bufalo
unai	Noun	unai
zemendi	Noun	zemendi
zainzuri	Noun	zainzuri
marasma	Noun	marasma
tomate	Noun	tomate
armeniar	Noun	armeniar
unibertsitate	Noun	unibertsitate
maltera	Noun	maltera
men	Noun	men
kuantu	Noun	kuantu
oasi	Noun	oasi
eskola	Noun	eskola
hiri	Noun	hiri
menda	Noun	menda
gizongai	Noun	gizongai
ekain	Noun	ekain
so	Noun	so
txori	Noun	txori
senar	Noun	senar
udaletxe	Noun	udaletxe
tailandiera	Noun	tailandiera
beso	Noun	beso
idazle	Noun	idazle
ama	Noun	ama
emakume	Noun	emakume
herri	Noun	herri
etorri	Noun	etorri
mus	Noun	mus
adiskide	Noun	adiskide
abertzale	Noun	abertzale
otso	Noun	otso
gobernu	Noun	gobernu
zientzialari	Noun	zientzialari
martitzen	Noun	martitzen
abentura	Noun	abentura
gris	Noun	gris
jirafa	Noun	jirafa
ermita	Noun	ermita
zirku	Noun	zirku
zuhamuxka	Noun	zuhamuxka
azenario	Noun	azenario
noar	Noun	noar
lehendakari	Noun	lehendakari
ikastola	Noun	ikastola
dutxa	Noun	dutxa
esloveniera	Noun	esloveniera
tren	Noun	tren
errota	Noun	errota
troposfera	Noun	troposfera
errotore	Noun	errotore
hartz	Noun	hartz
sudur	Noun	sudur n
hauta	Noun	hauta
zopa	Noun	zopa
oka	Noun	oka
putetxe	Noun	putetxe
bagil	Noun	bagil
barri	Noun	barri
irail	Noun	irail
bidaia	Noun	bidaia
tipula	Noun	tipula
bide	Noun	bide
ekilore	Noun	ekilore
hiribide	Noun	hiribide
idazmakina	Noun	idazmakina
iman	Noun	iman
iman	Noun	iman
urde	Noun	urde
sineresi	Noun	sineresi
berba	Noun	berba
polizia	Noun	polizia
garagarril	Noun	garagarril
ira	Noun	ira
hor	Noun	hor
kaka	Noun	kaka
dagonil	Noun	dagonil
seme	Noun	seme
orri	Noun	orri
pilota	Noun	pilota
kultura	Noun	kultura
asun	Noun	asun
iduneko	Noun	iduneko
presidente	Noun	presidente
udal	Noun	udal
urtaro	Noun	urtaro
kimikari	Noun	kimikari
adibide	Noun	adibide
herra	Noun	herra
gas	Noun	gas
espazio	Noun	espazio
aranondo	Noun	aranondo
lan	Noun	lan
epail	Noun	epail
helburu	Noun	helburu
ogi	Noun	ogi
negar	Noun	negar
estatore	Noun	estatore
dantzari	Noun	dantzari
txakur	Noun	txakur
emaztegai	Noun	emaztegai
su	Noun	su
jorrail	Noun	jorrail
zirkulu	Noun	zirkulu
saldo	Noun	saldo
galtzerdi	Noun	galtzerdi
lehergailu	Noun	lehergailu
anana	Noun	anana
ugaztun	Noun	ugaztun
zeta	Noun	zeta
azaro	Noun	azaro
naba	Noun	naba
kotxe	Noun	kotxe
gune	Noun	gune
munstro	Noun	munstro
adreilu	Noun	adreilu
hirigintza	Noun	hirigintza
izerdi	Noun	izerdi
nederlandera	Noun	nederlandera
anafora	Noun	anafora
gluoi	Noun	gluoi
poker	Noun	poker
fisikari	Noun	fisikari
hezkuntza	Noun	hezkuntza
errege	Noun	errege
txolarre	Noun	txolarre
sabai	Noun	sabai
ostiral	Noun	ostiral
matematikari	Noun	matematikari
banku	Noun	banku
koilara	Noun	koilara
lapar	Noun	lapar
begi	Noun	begi
mutil	Noun	mutil
portugaldar	Noun	portugaldar
kirol	Noun	kirol
eskutitz	Noun	eskutitz
aluminio	Noun	aluminio
xaboi	Noun	xaboi
txerrikume	Noun	txerrikume
zilar	Noun	zilar
portugalera	Noun	portugalera
lagun	Noun	lagun
dei	Noun	dei
itxarongela	Noun	itxarongela
arpoi	Noun	arpoi
biga	Noun	biga
osaba	Noun	osaba
aburu	Noun	aburu
ardo gorri	Noun	ardo gorri
edari	Noun	edari
arma	Noun	arma
metafora	Noun	metafora
ziklotroi	Noun	ziklotroi
ilbeltz	Noun	ilbeltz
fotosfera	Noun	fotosfera
emazte	Noun	emazte
aterki	Noun	aterki
aterki	Noun	aterki
robotika	Noun	robotika
urril	Noun	urril
birika	Noun	birika
artseniko	Noun	artseniko
talkagailu	Noun	talkagailu
bonba	Noun	bonba
neskenegun	Noun	neskenegun
zuhaitz	Noun	zuhaitz
baso	Noun	baso
arrain	Noun	arrain
sagar	Noun	sagar
txanpon	Noun	txanpon
izenburu	Noun	izenburu
zi	Noun	zi
frantses	Noun	frantses
kloroformo	Noun	kloroformo
min	Noun	min
neba	Noun	neba
ke	Noun	ke
anaia	Noun	anaia
tenis	Noun	tenis
garbigailu	Noun	garbigailu
intsektu	Noun	intsektu
txinera	Noun	txinera
artalde	Noun	artalde
urrieta	Noun	urrieta
arrano	Noun	arrano
abendu	Noun	abendu
izar	Noun	izar
abako	Noun	abako
abuztu	Noun	abuztu
errusiera	Noun	errusiera
teklatu	Noun	teklatu
te	Noun	te
prostituta	Noun	prostituta
aingura	Noun	aingura
belgikar	Noun	belgikar
ibai	Noun	ibai
finlandiera	Noun	finlandiera
mikroskopio	Noun	mikroskopio
ale	Noun	ale
gaztetxe	Noun	gaztetxe
gauenara	Noun	gauenara
urri	Noun	urri
bularretako	Noun	bularretako
esloveniar	Noun	esloveniar
errusiar	Noun	errusiar
korsikera	Noun	korsikera
ardi	Noun	ardi
pirolisi	Noun	pirolisi
ahots	Noun	ahots
mikrofono	Noun	mikrofono
andereño	Noun	andereño
asturiera	Noun	asturiera
abenturazale	Noun	abenturazale
or	Noun	or
irakurle	Noun	irakurle
minutu	Noun	minutu
surflari	Noun	surflari
planta	Noun	planta
orkatila	Noun	orkatila
sagu	Noun	sagu
katuarrain	Noun	katuarrain
norvegiera	Noun	norvegiera
astebukaera	Noun	astebukaera
laku	Noun	laku
egutegi	Noun	egutegi
ama-hizkuntza	Noun	ama-hizkuntza
orpo	Noun	orpo
supermerkatu	Noun	supermerkatu
teorialari	Noun	teorialari
apez	Noun	apez
meta	Noun	meta
balea	Noun	balea
autobide	Noun	autobide
arratsalde	Noun	arratsalde
bake	Noun	bake
giltzurrun	Noun	giltzurrun
behar	Noun	behar
finlandiar	Noun	finlandiar
bretoiera	Noun	bretoiera
karramarro	Noun	karramarro
gar	Noun	gar
maionesa	Noun	maionesa
harri	Noun	harri
mertxika	Noun	mertxika
amets	Noun	amets
kafesne	Noun	kafesne
leiho	Noun	leiho
aita	Noun	aita
aramu	Noun	aramu
bulgariar	Noun	bulgariar
auto	Noun	auto
gona	Noun	gona
jan	Noun	jan
martxo	Noun	martxo
bariku	Noun	bariku
gurdi	Noun	gurdi
marti	Noun	marti
erle	Noun	erle
laser	Noun	laser
igel	Noun	igel
orril	Noun	orril
erietxe	Noun	erietxe
angelu	Noun	angelu
zezeil	Noun	zezeil
hizkuntzalaritza	Noun	hizkuntzalaritza
gida	Noun	gida
iturri	Noun	iturri
arranotegi	Noun	arranotegi
hari	Noun	hari
zerbütxügüne	Noun	zerbütxügüne
arku	Noun	arku
amama	Noun	amama
sein	Noun	sein
minbizi	Noun	minbizi
tortura	Noun	tortura
supernoba	Noun	supernoba
opari	Noun	opari
odol	Noun	odol
eper	Noun	eper
bizar	Noun	bizar
burdinbide	Noun	burdinbide
mendi	Noun	mendi
azukre	Noun	azukre
urre	Noun	urre
gaztelania	Noun	gaztelania
akrobata	Noun	akrobata
ardo	Noun	ardo
aran	Noun	aran
aditz	Noun	aditz
dorre	Noun	dorre
inurri	Noun	inurri
garil	Noun	garil
txingurri	Noun	txingurri
saguzar	Noun	saguzar
hipopotamo	Noun	hipopotamo
anker	Noun	anker
torloju	Noun	torloju
irla	Noun	irla
karrika	Noun	karrika
baserritar	Noun	baserritar
katu	Noun	katu
aker	Noun	aker
lorategi	Noun	lorategi
georgiar	Noun	georgiar
more	Noun	more
abagune	Noun	abagune
bokal	Noun	bokal
ertzain	Noun	ertzain
helikoptero	Noun	helikoptero
txita	Noun	txita
katodo	Noun	katodo
ionosfera	Noun	ionosfera
asto	Noun	asto
banketxe	Noun	banketxe
termosfera	Noun	termosfera
gosari	Noun	gosari
pot	Noun	pot
hungariar	Noun	hungariar
jostailu	Noun	jostailu
ikastetxe	Noun	ikastetxe
idi	Noun	idi
