berri	Adjective	berri
sor	Adjective	sor
errumaniar	Adjective	errumaniar
itsu	Adjective	itsu
agor	Adjective	agor
austriar	Adjective	austriar
hotz	Adjective	hotz
portuges	Adjective	portuges
laranja	Adjective	laranja
estoniar	Adjective	estoniar
italiar	Adjective	italiar
japoniar	Adjective	japoniar
ingeles	Adjective	ingeles
frantziar	Adjective	frantziar
homosexual	Adjective	homosexual
eslovakiar	Adjective	eslovakiar
espainiar	Adjective	espainiar
has	Adjective	has
alemaniar	Adjective	alemaniar
aleman	Adjective	aleman
andorratar	Adjective	andorratar
bielorrusiar	Adjective	bielorrusiar
oro	Adjective	oro
abkhaziar	Adjective	abkhaziar
on	Adjective	on
islandiar	Adjective	islandiar
azeri	Adjective	azeri
bare	Adjective	bare
daniar	Adjective	daniar
albaniar	Adjective	albaniar
azerbaijandar	Adjective	azerbaijandar
afganistandar	Adjective	afganistandar
kroaziar	Adjective	kroaziar
armeniar	Adjective	armeniar
barri	Adjective	barri
barna	Adjective	barna
portugaldar	Adjective	portugaldar
frantses	Adjective	frantses
ezkerra	Adjective	ezkerra
belgikar	Adjective	belgikar
esloveniar	Adjective	esloveniar
zuri	Adjective	zuri
errusiar	Adjective	errusiar
mutu	Adjective	mutu
abenturazale	Adjective	abenturazale
finlandiar	Adjective	finlandiar
bulgariar	Adjective	bulgariar
anker	Adjective	anker
georgiar	Adjective	georgiar
hungariar	Adjective	hungariar
