belejlig	Adjective	belejlig
pædofil	Adjective	pædofil
norrøn	Adjective	norrøn
økonomisk	Adjective	økonomisk
alveolær	Adjective	alveolær
tynd	Adjective	tynd
norrønt	Adjective	norrønt
monetær	Adjective	monetær
carnivor	Adjective	carnivor
nordisk	Adjective	nordisk
adoptiv	Adjective	adoptiv
rørig	Adjective	rørig
ubrugelig	Adjective	ubrugelig
firbenet	Adjective	firbenet
leveringsdygtig	Adjective	leveringsdygtig
snakkesalig	Adjective	snakkesalig
tunge	Adjective	tunge
nyfigen	Adjective	nyfigen
nedsættende	Adjective	nedsættende
middel	Adjective	middel (neuter middel, plural and definite singular attributive middel)
høj	Adjective	høj
egen	Adjective	egen (neuter eget, plural and definite singular attributive egne)
egen	Adjective	egen (neuter egent or eget, definite and plural egne)
arvelig	Adjective	arvelig
reel	Adjective	reel
rødhåret	Adjective	rødhåret
stilig	Adjective	stilig
strid	Adjective	strid
fast	Adjective	fast
ablativ	Adjective	ablativ
beruset	Adjective	beruset
spinkel	Adjective	spinkel
venlig	Adjective	venlig
historisk	Adjective	historisk
ægte	Adjective	ægte
idyllisk	Adjective	idyllisk
hvid	Adjective	hvid
højtysk	Adjective	højtysk
grundig	Adjective	grundig
splitternøgen	Adjective	splitternøgen
balsamisk	Adjective	balsamisk
beslutsom	Adjective	beslutsom
behændig	Adjective	behændig
smidig	Adjective	smidig
utryg	Adjective	utryg
lokale	Adjective	lokale
nervøs	Adjective	nervøs
fed	Adjective	fed
vant	Adjective	vant
primitiv	Adjective	primitiv
babylyserød	Adjective	babylyserød
stokastisk	Adjective	stokastisk
få	Adjective	få (comparative færre, superlative (predicative) færrest, superlative (attributive) {{{5}}})
upopulær	Adjective	upopulær
besk	Adjective	besk (neuter beskt, plural and definite singular attributive beske, comparative beskere, superlative (predicative) beskest, superlative (attributive) beskeste)
giftig	Adjective	giftig
sjofel	Adjective	sjofel
streng	Adjective	streng
perfid	Adjective	perfid
oldgræsk	Adjective	oldgræsk
belgisk	Adjective	belgisk
recessiv	Adjective	recessiv
jordisk	Adjective	jordisk
bæredygtig	Adjective	bæredygtig
juridisk	Adjective	juridisk
koreansk	Adjective	koreansk
unik	Adjective	unik
fri	Adjective	fri (neuter frit, plural and definite singular attributive frie, comparative friere, superlative (predicative) friest, superlative (attributive) {{{5}}})
gul	Adjective	gul
nuttet	Adjective	nuttet
oldpolsk	Adjective	oldpolsk
mønstret	Adjective	mønstret
solid	Adjective	solid
løs	Adjective	løs (neuter løst, plural and definite singular attributive løse, comparative løsere, superlative (predicative) løsest, superlative (attributive) løseste)
glad	Adjective	glad (neuter glad, plural and definite singular attributive glade, comparative gladere, superlative (predicative) gladest, superlative (attributive) {{{5}}})
kæk	Adjective	kæk
nynedertysk	Adjective	nynedertysk
præcis	Adjective	præcis
proaktiv	Adjective	proaktiv
vist	Adjective	vist
vist	Adjective	vist
defekt	Adjective	defekt
sudanesisk	Adjective	sudanesisk
plattysk	Adjective	plattysk
ustemt	Adjective	ustemt
uhensigtsmæssig	Adjective	uhensigtsmæssig
søvnig	Adjective	søvnig
indlysende	Adjective	indlysende
pornografisk	Adjective	pornografisk
tekstil	Adjective	tekstil
lutter	Adjective	lutter (neuter lutter, plural and definite singular attributive lutter)
samtidig	Adjective	samtidig
ortodoks	Adjective	ortodoks
fantastisk	Adjective	fantastisk
promiskuøs	Adjective	promiskuøs
delikat	Adjective	delikat
sådan	Adjective	sådan
hjemløs	Adjective	hjemløs
videnskabelig	Adjective	videnskabelig
middelmådig	Adjective	middelmådig
velkendt	Adjective	velkendt
fransk	Adjective	fransk
onomatopoietisk	Adjective	onomatopoietisk
grå	Adjective	grå (neuter gråt, plural and definite singular attributive grå)
nem	Adjective	nem
svensk	Adjective	svensk
bulgarsk	Adjective	bulgarsk
grøn	Adjective	grøn
eksplicit	Adjective	eksplicit
åndssvag	Adjective	åndssvag
uhøjtidelig	Adjective	uhøjtidelig
falsk	Adjective	falsk (neuter falsk or falskt, plural and definite singular attributive falske)
kruset	Adjective	kruset
grønlandsk	Adjective	grønlandsk
transparent	Adjective	transparent
grundliggende	Adjective	grundliggende
gevaldig	Adjective	gevaldig
caribisk	Adjective	caribisk
værre	Adjective	værre
ledere	Adjective	ledere
erfaren	Adjective	erfaren
almen	Adjective	almen
grel	Adjective	grel
forloren	Adjective	forloren
viskøs	Adjective	viskøs
arm	Adjective	arm
georgisk	Adjective	georgisk
sky	Adjective	sky (neuter sky, plural and definite singular attributive sky)
diverse	Adjective	diverse
træt	Adjective	træt
koldblodet	Adjective	koldblodet
vanskabt	Adjective	vanskabt
lesbisk	Adjective	lesbisk
reaktionsdygtig	Adjective	reaktionsdygtig
bevidstløs	Adjective	bevidstløs
latent	Adjective	latent
superledende	Adjective	superledende
trodsig	Adjective	trodsig
lodden	Adjective	lodden
skandaløs	Adjective	skandaløs
hjernet	Adjective	hjernet
direkte	Adjective	direkte
stensikker	Adjective	stensikker
lind	Adjective	lind
lad	Adjective	lad
keynesiansk	Adjective	keynesiansk
pseudonym	Adjective	pseudonym
patetisk	Adjective	patetisk
sand	Adjective	sand
lam	Adjective	lam
labil	Adjective	labil
triste	Adjective	triste
kvadratisk	Adjective	kvadratisk
pludselig	Adjective	pludselig
udholdelig	Adjective	udholdelig
finsk	Adjective	finsk
åbenbar	Adjective	åbenbar
ør	Adjective	ør
ren	Adjective	ren
rasende	Adjective	rasende
hellig	Adjective	hellig
sær	Adjective	sær
århusiansk	Adjective	århusiansk
elitær	Adjective	elitær
lav	Adjective	lav
middelhøjtysk	Adjective	middelhøjtysk
palatal	Adjective	palatal
tibetansk	Adjective	tibetansk
fuldkommen	Adjective	fuldkommen
tosproget	Adjective	tosproget
forsigtig	Adjective	forsigtig
toksisk	Adjective	toksisk
serbisk	Adjective	serbisk
blågrøn	Adjective	blågrøn
asymmetrisk	Adjective	asymmetrisk
islandsk	Adjective	islandsk
alfabetisk	Adjective	alfabetisk
stadig	Adjective	stadig
intelligensmæssig	Adjective	intelligensmæssig
sort	Adjective	sort
respektive	Adjective	respektive
handledygtig	Adjective	handledygtig
grundet	Adjective	grundet
offensiv	Adjective	offensiv (neuter offensivt, plural and definite singular attributive offensive)
arrig	Adjective	arrig
lune	Adjective	lune
frygtsom	Adjective	frygtsom
sjov	Adjective	sjov
bare	Adjective	bare
oplagt	Adjective	oplagt
begavet	Adjective	begavet
dyster	Adjective	dyster
grim	Adjective	grim
verdslig	Adjective	verdslig
mangt	Adjective	mangt
persisk	Adjective	persisk
vammel	Adjective	vammel
sympatisk	Adjective	sympatisk (neuter sympatisk, plural and definite singular attributive sympatiske, comparative mere sympatisk, superlative (predicative) mest sympatisk, superlative (attributive) mest sympatiske)
yt	Adjective	yt (neuter yt, plural and definite singular attributive yt)
dygtig	Adjective	dygtig
germansk	Adjective	germansk
eklektisk	Adjective	eklektisk
spedalsk	Adjective	spedalsk
dunkel	Adjective	dunkel (neuter dunkelt, plural and definite singular attributive dunkle, comparative dunklere, superlative (predicative) dunklest, superlative (attributive) dunkleste)
oblik	Adjective	oblik
glat	Adjective	glat (neuter glat, plural and definite singular attributive glatte)
fedtet	Adjective	fedtet
radioaktiv	Adjective	radioaktiv
nudansk	Adjective	nudansk
kulørt	Adjective	kulørt
nylig	Adjective	nylig
fødedygtig	Adjective	fødedygtig
ved	Adjective	ved
huslig	Adjective	huslig
terminologisk	Adjective	terminologisk
vertikal	Adjective	vertikal
omsonst	Adjective	omsonst
lukrativ	Adjective	lukrativ
gylden	Adjective	gylden
præsent	Adjective	præsent
triviel	Adjective	triviel
produktiv	Adjective	produktiv
søvnløs	Adjective	søvnløs
grov	Adjective	grov
engelsk	Adjective	engelsk
god	Adjective	god (neuter godt, plural and definite singular attributive gode, comparative bedre, superlative (predicative) bedst, superlative (attributive) {{{5}}})
rød	Adjective	rød
afhængig	Adjective	afhængig (neuter afhængigt, plural and definite singular attributive afhængige)
luksuriøs	Adjective	luksuriøs
mexikansk	Adjective	mexikansk
spids	Adjective	spids (neuter spidst, plural and definite singular attributive spidse, comparative spidsere, superlative (predicative) spidsest, superlative (attributive) spidseste)
pure	Adjective	pure
pure	Adjective	pure
modig	Adjective	modig
geografisk	Adjective	geografisk
egentlig	Adjective	egentlig
topografisk	Adjective	topografisk
udtrykt	Adjective	udtrykt
firsproget	Adjective	firsproget
svær	Adjective	svær
rektangulær	Adjective	rektangulær
oldportugisisk	Adjective	oldportugisisk
siderisk	Adjective	siderisk
maskulin	Adjective	maskulin
flad	Adjective	flad
lys	Adjective	lys
tom	Adjective	tom
kroget	Adjective	kroget
grund	Adjective	grund
imponerende	Adjective	imponerende
sval	Adjective	sval
national	Adjective	national
rum	Adjective	rum
runedansk	Adjective	runedansk
arbejdsdygtig	Adjective	arbejdsdygtig
snavset	Adjective	snavset
ordentlig	Adjective	ordentlig
subtil	Adjective	subtil
tvær	Adjective	tvær
kejthåndet	Adjective	kejthåndet
dansk	Adjective	dansk
dyb	Adjective	dyb
bestialsk	Adjective	bestialsk
inuitisk	Adjective	inuitisk
gode	Adjective	gode
inderlig	Adjective	inderlig
hyppig	Adjective	hyppig
dus	Adjective	dus
nordafrikansk	Adjective	nordafrikansk
ranglet	Adjective	ranglet
maritim	Adjective	maritim
kommutativ	Adjective	kommutativ (neuter kommutativt, plural and definite singular attributive kommutative)
proper	Adjective	proper
snæversynet	Adjective	snæversynet
brændende	Adjective	brændende
esoterisk	Adjective	esoterisk
politisk	Adjective	politisk
koloenorm	Adjective	koloenorm
rumænsk	Adjective	rumænsk
sokratisk	Adjective	sokratisk
ansat	Adjective	ansat
metonymisk	Adjective	metonymisk
ungarsk	Adjective	ungarsk
syvsproget	Adjective	syvsproget
dum	Adjective	dum
fysisk	Adjective	fysisk
parvis	Adjective	parvis (neuter parvis or parvist, plural and definite singular attributive parvise)
grunde	Adjective	grunde
blufærdig	Adjective	blufærdig
fej	Adjective	fej
faktisk	Adjective	faktisk
anstændig	Adjective	anstændig
fræk	Adjective	fræk
fodkold	Adjective	fodkold
alenlang	Adjective	alenlang
målløs	Adjective	målløs
målløs	Adjective	målløs
skotskternet	Adjective	skotskternet
åndelig	Adjective	åndelig
første	Adjective	første
lynhurtig	Adjective	lynhurtig
portugisisk	Adjective	portugisisk
halv	Adjective	halv
lig	Adjective	lig (neuter ligt or lig, plural and definite singular attributive lig)
ubønhørlig	Adjective	ubønhørlig
søsyg	Adjective	søsyg
brødflov	Adjective	brødflov
slig	Adjective	slig
lemfældig	Adjective	lemfældig
sulten	Adjective	sulten
skinger	Adjective	skinger
stenrig	Adjective	stenrig
feminin	Adjective	feminin
platfodet	Adjective	platfodet
firkantet	Adjective	firkantet
åleglat	Adjective	åleglat
barnløs	Adjective	barnløs
vågne	Adjective	vågne
aktiv	Adjective	aktiv
vandskyende	Adjective	vandskyende
uintelligent	Adjective	uintelligent
hermafroditisk	Adjective	hermafroditisk
søgt	Adjective	søgt
kolonial	Adjective	kolonial
slut	Adjective	slut
enbenet	Adjective	enbenet
lettisk	Adjective	lettisk
givende	Adjective	givende
vrang	Adjective	vrang
kompetent	Adjective	kompetent
vietnamesisk	Adjective	vietnamesisk
evig	Adjective	evig
lunken	Adjective	lunken
tam	Adjective	tam
tveægget	Adjective	tveægget
tveægget	Adjective	tveægget
sur	Adjective	sur
tilbagevirkende	Adjective	tilbagevirkende
ful	Adjective	ful
fabelagtig	Adjective	fabelagtig
vulgær	Adjective	vulgær
lysten	Adjective	lysten
kvart	Adjective	kvart
nyhøjtysk	Adjective	nyhøjtysk
utilbøjelig	Adjective	utilbøjelig
kolossal	Adjective	kolossal
international	Adjective	international
bijektiv	Adjective	bijektiv
restriktiv	Adjective	restriktiv
negativ	Adjective	negativ
vanvittig	Adjective	vanvittig
ulden	Adjective	ulden
fremmed	Adjective	fremmed (neuter fremmed, plural and definite singular attributive fremmede)
faryngal	Adjective	faryngal
gratis	Adjective	gratis (neuter gratis, plural and definite singular attributive gratis)
sydafrikansk	Adjective	sydafrikansk
heroisk	Adjective	heroisk
syndig	Adjective	syndig
melodiøs	Adjective	melodiøs
viril	Adjective	viril
aktuel	Adjective	aktuel
konkret	Adjective	konkret
trænet	Adjective	trænet
thailandsk	Adjective	thailandsk
myg	Adjective	myg
ens	Adjective	ens
malisk	Adjective	malisk
total	Adjective	total
afgørende	Adjective	afgørende
abnorm	Adjective	abnorm
pæn	Adjective	pæn
fremragende	Adjective	fremragende
rigelig	Adjective	rigelig
frisk	Adjective	frisk (neuter frisk or friskt, plural and definite singular attributive friske)
vind	Adjective	vind
bekvem	Adjective	bekvem
bøvet	Adjective	bøvet
utålmodig	Adjective	utålmodig
anfaldsfri	Adjective	anfaldsfri
kold	Adjective	kold
nydansk	Adjective	nydansk
respektabel	Adjective	respektabel (neuter respektabelt, plural and definite singular attributive respektable, comparative mere respektabel, superlative (predicative) mest respektabel, superlative (attributive) mest respektable)
lun	Adjective	lun
prostitueret	Adjective	prostitueret
lilla	Adjective	lilla (neuter lilla, plural and definite singular attributive lilla)
sikker	Adjective	sikker
hvas	Adjective	hvas
fejl	Adjective	fejl (neuter fejl, plural and definite singular attributive fejle)
anonym	Adjective	anonym
øvrig	Adjective	øvrig
døv	Adjective	døv
associativ	Adjective	associativ (neuter associativt, plural and definite singular attributive associative)
russisk	Adjective	russisk
jødisk	Adjective	jødisk
ansvarlig	Adjective	ansvarlig
spekulativ	Adjective	spekulativ
kastanjebrun	Adjective	kastanjebrun
traditionel	Adjective	traditionel
tro	Adjective	tro (neuter tro, plural and definite singular attributive tro)
fad	Adjective	fad (neuter fad or fadt, plural and definite singular attributive fade)
sejrrig	Adjective	sejrrig
dødssyg	Adjective	dødssyg
grundlæggende	Adjective	grundlæggende
slovensk	Adjective	slovensk
vekselvarm	Adjective	vekselvarm
stendød	Adjective	stendød
tomme	Adjective	tomme
ret	Adjective	ret
brat	Adjective	brat
brat	Adjective	brat
mere	Adjective	mere
brunet	Adjective	brunet
syge	Adjective	syge
nitrogenfikserende	Adjective	nitrogenfikserende
konkurs	Adjective	konkurs
hedensk	Adjective	hedensk
oldfransk	Adjective	oldfransk
hemmelighedsfuld	Adjective	hemmelighedsfuld
mandig	Adjective	mandig
olddansk	Adjective	olddansk
afrikansk	Adjective	afrikansk
relativ	Adjective	relativ
saftig	Adjective	saftig
kedelig	Adjective	kedelig
græsk	Adjective	græsk
europæisk	Adjective	europæisk
japansk	Adjective	japansk
skummel	Adjective	skummel
ørkesløs	Adjective	ørkesløs
kolerisk	Adjective	kolerisk
finskåret	Adjective	finskåret
finskåret	Adjective	finskåret
horisontal	Adjective	horisontal
irsk	Adjective	irsk
modstandsdygtig	Adjective	modstandsdygtig
arme	Adjective	arme
skinhellig	Adjective	skinhellig
skotsk	Adjective	skotsk
stridere	Adjective	stridere
givet	Adjective	givet
pseudovidenskabelig	Adjective	pseudovidenskabelig
gæstvenlig	Adjective	gæstvenlig
fiskal	Adjective	fiskal
alkalisk	Adjective	alkalisk
ejerløs	Adjective	ejerløs
sent	Adjective	sent
rimelig	Adjective	rimelig
positiv	Adjective	positiv
løjerlig	Adjective	løjerlig
fin	Adjective	fin
genert	Adjective	genert
homoseksuel	Adjective	homoseksuel
enig	Adjective	enig
italiensk	Adjective	italiensk
guineansk	Adjective	guineansk
stupid	Adjective	stupid
mexicansk	Adjective	mexicansk
submarin	Adjective	submarin
gold	Adjective	gold
in	Adjective	in (neuter in, plural and definite singular attributive in)
etymologisk	Adjective	etymologisk
enorm	Adjective	enorm
lykkelig	Adjective	lykkelig
jyske	Adjective	jyske
reciprok	Adjective	reciprok
opmærksom	Adjective	opmærksom
befrugtningsdygtig	Adjective	befrugtningsdygtig
konkurrencedygtig	Adjective	konkurrencedygtig
arbitrær	Adjective	arbitrær
urgermansk	Adjective	urgermansk
algoritmisk	Adjective	algoritmisk
fedt	Adjective	fedt
aggressiv	Adjective	aggressiv
polyteistisk	Adjective	polyteistisk
prosaisk	Adjective	prosaisk
vigtig	Adjective	vigtig
livstruende	Adjective	livstruende
hævngerrig	Adjective	hævngerrig
hudløs	Adjective	hudløs
radikal	Adjective	radikal
suspekt	Adjective	suspekt
stofafhængig	Adjective	stofafhængig
almenkendt	Adjective	almenkendt
kristen	Adjective	kristen
gifte	Adjective	gifte
autodidakt	Adjective	autodidakt
ekstrem	Adjective	ekstrem
omfattende	Adjective	omfattende
blodig	Adjective	blodig
offentlig	Adjective	offentlig
allergisk	Adjective	allergisk
kasjubisk	Adjective	kasjubisk
hundekold	Adjective	hundekold
artig	Adjective	artig
oldspansk	Adjective	oldspansk
hebraisk	Adjective	hebraisk
romersk	Adjective	romersk
højtidelig	Adjective	højtidelig
absurd	Adjective	absurd (neuter absurd, plural and definite singular attributive absurde)
forrest	Adjective	forrest
upraktisk	Adjective	upraktisk
antonym	Adjective	antonym
bornholmsk	Adjective	bornholmsk
lysegrøn	Adjective	lysegrøn
heltemodig	Adjective	heltemodig
fossil	Adjective	fossil
gavnlig	Adjective	gavnlig
ekstra	Adjective	ekstra (neuter ekstra, plural and definite singular attributive ekstra)
køresyge	Adjective	køresyge
kierkegårdsk	Adjective	kierkegårdsk
marin	Adjective	marin
livegen	Adjective	livegen
raffineret	Adjective	raffineret
dødsdømt	Adjective	dødsdømt
onde	Adjective	onde
død	Adjective	død
vis	Adjective	vis
vis	Adjective	vis
heldig	Adjective	heldig
tjenstdygtig	Adjective	tjenstdygtig
stum	Adjective	stum (neuter stumt, plural and definite singular attributive stumme)
følelsesmæssig	Adjective	følelsesmæssig
patologisk	Adjective	patologisk
inkompetent	Adjective	inkompetent
urindoeuropæisk	Adjective	urindoeuropæisk
sadistisk	Adjective	sadistisk
aromatisk	Adjective	aromatisk
kirurgisk	Adjective	kirurgisk
mut	Adjective	mut
nedværdigende	Adjective	nedværdigende
pittoresk	Adjective	pittoresk
trigonometrisk	Adjective	trigonometrisk (neuter trigonometrisk, plural and definite singular attributive trigonometriske)
skadelig	Adjective	skadelig
indspist	Adjective	indspist
ene	Adjective	ene
hul	Adjective	hul
ærlig	Adjective	ærlig
kynisk	Adjective	kynisk
flink	Adjective	flink
antropomorf	Adjective	antropomorf
kantet	Adjective	kantet
støvet	Adjective	støvet
venneløs	Adjective	venneløs
velær	Adjective	velær
flydende	Adjective	flydende
pen	Adjective	pen (neuter pent, plural and definite singular attributive pene, comparative penere, superlative (predicative) penest, superlative (attributive) peneste)
trist	Adjective	trist (neuter trist, plural and definite singular attributive triste, comparative tristere, superlative (predicative) tristest, superlative (attributive) tristeste)
effektiv	Adjective	effektiv
populair	Adjective	populair (neuter populairt, plural and definite singular attributive populaire, comparative populairere, superlative (predicative) populairest, superlative (attributive) populaireste)
congolesisk	Adjective	congolesisk
kuriøs	Adjective	kuriøs
akademisk	Adjective	akademisk
dekadent	Adjective	dekadent
mørk	Adjective	mørk
abstrakt	Adjective	abstrakt
skør	Adjective	skør
indebrændt	Adjective	indebrændt
djævelsk	Adjective	djævelsk
store	Adjective	store
atonal	Adjective	atonal
ussel	Adjective	ussel
plat	Adjective	plat
urimelig	Adjective	urimelig
fintskåret	Adjective	fintskåret
fintskåret	Adjective	fintskåret
maldivisk	Adjective	maldivisk
utilgivelig	Adjective	utilgivelig
socioøkonomisk	Adjective	socioøkonomisk
rå	Adjective	rå (neuter råt, plural and definite singular attributive rå)
tæt	Adjective	tæt
funky	Adjective	funky
rede	Adjective	rede
åben	Adjective	åben
klokkeren	Adjective	klokkeren or klokkerén
arrogant	Adjective	arrogant
honorær	Adjective	honorær
civil	Adjective	civil
vag	Adjective	vag
lige	Adjective	lige
underlig	Adjective	underlig
smart	Adjective	smart (neuter smart, plural and definite singular attributive smarte, comparative smartere, superlative (predicative) smartest, superlative (attributive) smarteste)
tjekkisk	Adjective	tjekkisk
postalveolær	Adjective	postalveolær
intelligent	Adjective	intelligent
tyst	Adjective	tyst
interaktiv	Adjective	interaktiv (neuter interaktivt, plural and definite singular attributive interaktive)
nederlandsk	Adjective	nederlandsk
hydrofob	Adjective	hydrofob
salt	Adjective	salt
ekstravagant	Adjective	ekstravagant
injektiv	Adjective	injektiv
haitiansk	Adjective	haitiansk
mage	Adjective	mage
variabel	Adjective	variabel (neuter variabelt, plural and definite singular attributive variable)
hemmelig	Adjective	hemmelig
svar	Adjective	svar
kontraintuitiv	Adjective	kontraintuitiv
spændt	Adjective	spændt
vage	Adjective	vage
monogam	Adjective	monogam
beskidt	Adjective	beskidt
vrede	Adjective	vrede
sekssproget	Adjective	sekssproget
babylonisk	Adjective	babylonisk
uorganisk	Adjective	uorganisk
atypisk	Adjective	atypisk
konservativ	Adjective	konservativ
blæst	Adjective	blæst
leden	Adjective	leden (neuter ledet, plural and definite singular attributive ledne)
rørende	Adjective	rørende
åndet	Adjective	åndet
bizar	Adjective	bizar
sublim	Adjective	sublim
kierkegaardsk	Adjective	kierkegaardsk
upolitisk	Adjective	upolitisk
diger	Adjective	diger
tresproget	Adjective	tresproget
rap	Adjective	rap (neuter rapt, plural and definite singular attributive rappe, comparative rappere, superlative (predicative) rappest, superlative (attributive) rappeste)
illegal	Adjective	illegal
rætoromansk	Adjective	rætoromansk
desperat	Adjective	desperat
obligatorisk	Adjective	obligatorisk
arbejdsløs	Adjective	arbejdsløs
punktlig	Adjective	punktlig (neuter punktligt, plural and definite singular attributive punktlige, comparative punktligere or mere punktlig, superlative (predicative) punktligst or mest punktlig, superlative (attributive) {{{5}}} or mest punktlige)
seksuel	Adjective	seksuel
sexet	Adjective	sexet
etbenet	Adjective	etbenet
journalistisk	Adjective	journalistisk
konisk	Adjective	konisk
ejendommelig	Adjective	ejendommelig
usædvanlig	Adjective	usædvanlig
sen	Adjective	sen
blide	Adjective	blide
skægget	Adjective	skægget
arabisk	Adjective	arabisk
stridbar	Adjective	stridbar
øverst	Adjective	øverst
dejlig	Adjective	dejlig
knusende	Adjective	knusende
brillant	Adjective	brillant
blank	Adjective	blank
filippinsk	Adjective	filippinsk
mobil	Adjective	mobil
læg	Adjective	læg
sober	Adjective	sober
nederdrægtig	Adjective	nederdrægtig
revolutionær	Adjective	revolutionær
færdig	Adjective	færdig
lang	Adjective	lang (neuter langt, plural and definite singular attributive lange, comparative længere, superlative (predicative) længst, superlative (attributive) {{{5}}})
vid	Adjective	vid
topløs	Adjective	topløs
lovkyndig	Adjective	lovkyndig
ærværdig	Adjective	ærværdig
retslig	Adjective	retslig
smålig	Adjective	smålig
stor	Adjective	stor (neuter stort, plural and definite singular attributive store, comparative større, superlative (predicative) størst, superlative (attributive) {{{5}}})
bipolar	Adjective	bipolar
febril	Adjective	febril
idiotsikker	Adjective	idiotsikker
slangeagtig	Adjective	slangeagtig
almennyttig	Adjective	almennyttig
polsk	Adjective	polsk
berøringsangst	Adjective	berøringsangst
ulykkelig	Adjective	ulykkelig
trætte	Adjective	trætte
rar	Adjective	rar
kanadisk	Adjective	kanadisk
hurtig	Adjective	hurtig
mandlig	Adjective	mandlig
interessant	Adjective	interessant
hviderussisk	Adjective	hviderussisk
tvetydig	Adjective	tvetydig
partiel	Adjective	partiel
but	Adjective	but
manøvredygtig	Adjective	manøvredygtig
slap	Adjective	slap
klog	Adjective	klog
parallel	Adjective	parallel
smal	Adjective	smal
cerebral	Adjective	cerebral
synlig	Adjective	synlig
hyggelig	Adjective	hyggelig
svag	Adjective	svag (neuter svagt, plural and definite singular attributive svage, comparative svagere, superlative (predicative) svagest, superlative (attributive) svageste)
siamesisk	Adjective	siamesisk
pålidelig	Adjective	pålidelig
nicaraguansk	Adjective	nicaraguansk
trojansk	Adjective	trojansk
ugift	Adjective	ugift
mageløs	Adjective	mageløs
stump	Adjective	stump (neuter stumpt, plural and definite singular attributive stumpe, comparative stumpere, superlative (predicative) stumpest, superlative (attributive) stumpeste)
trolig	Adjective	trolig
eget	Adjective	eget
doven	Adjective	doven
hebræisk	Adjective	hebræisk
værdig	Adjective	værdig (neuter værdigt, plural and definite singular attributive værdige, comparative værdigere, superlative (predicative) værdigst, superlative (attributive) værdigste)
momentan	Adjective	momentan
årlig	Adjective	årlig
muskuløs	Adjective	muskuløs
sublimere	Adjective	sublimere
benet	Adjective	benet
los	Adjective	los
cylindrisk	Adjective	cylindrisk
visuel	Adjective	visuel
kontinental	Adjective	kontinental
fredelig	Adjective	fredelig
interessante	Adjective	interessante
kierkegaardiansk	Adjective	kierkegaardiansk
formel	Adjective	formel
sene	Adjective	sene
skændig	Adjective	skændig
skriftlig	Adjective	skriftlig (neuter skriftligt, plural and definite singular attributive skriftlige)
fatal	Adjective	fatal
voksen	Adjective	voksen
bleg	Adjective	bleg
retroaktiv	Adjective	retroaktiv
korrekt	Adjective	korrekt
oldnedertysk	Adjective	oldnedertysk
rolig	Adjective	rolig (neuter roligt, plural and definite singular attributive rolige, comparative roligere, superlative (predicative) roligst, superlative (attributive) roligste)
musikalsk	Adjective	musikalsk
vittig	Adjective	vittig
frikativ	Adjective	frikativ
munter	Adjective	munter
gammeldansk	Adjective	gammeldansk
passiv	Adjective	passiv (neuter passivt, plural and definite singular attributive passive)
kæreste	Adjective	kæreste
konstant	Adjective	konstant (neuter konstant, plural and definite singular attributive konstante)
obskur	Adjective	obskur
skæv	Adjective	skæv
nedertysk	Adjective	nedertysk
levedygtig	Adjective	levedygtig
ung	Adjective	ung (neuter ungt, plural and definite singular attributive unge, comparative yngre, superlative (predicative) yngst, superlative (attributive) {{{5}}})
skalerbar	Adjective	skalerbar
frugtbar	Adjective	frugtbar
snaksom	Adjective	snaksom
mulig	Adjective	mulig
metafysisk	Adjective	metafysisk
åndsvag	Adjective	åndsvag
evindelig	Adjective	evindelig
vesterbotnisk	Adjective	vesterbotnisk
religionshistorisk	Adjective	religionshistorisk
monoton	Adjective	monoton
krøllet	Adjective	krøllet
definitorisk	Adjective	definitorisk
magre	Adjective	magre
uafhængig	Adjective	uafhængig
ugæstmild	Adjective	ugæstmild
hvide	Adjective	hvide
diakritisk	Adjective	diakritisk
loyal	Adjective	loyal
synonym	Adjective	synonym
harme	Adjective	harme
prægnant	Adjective	prægnant
bibliofil	Adjective	bibliofil
kær	Adjective	kær
sædvanlig	Adjective	sædvanlig
retfærdig	Adjective	retfærdig
farlig	Adjective	farlig
veg	Adjective	veg
våd	Adjective	våd
irritabel	Adjective	irritabel
amerikansk	Adjective	amerikansk
natlig	Adjective	natlig
forårsagtig	Adjective	forårsagtig
tyk	Adjective	tyk
liden	Adjective	liden (neuter lidet, definite singular lille, definite plural små, plural små, comparative mindre, superlative mindst)
sakral	Adjective	sakral
løj	Adjective	løj
bunden	Adjective	bunden (neuter bundent or bundet, plural and definite singular attributive bundne)
falleret	Adjective	falleret
intim	Adjective	intim
uidiomatisk	Adjective	uidiomatisk
uskadt	Adjective	uskadt
blå	Adjective	blå (neuter blåt, plural and definite singular attributive blå)
indoeuropæisk	Adjective	indoeuropæisk
udadvendt	Adjective	udadvendt
lydig	Adjective	lydig
autonom	Adjective	autonom
beskeden	Adjective	beskeden
nidkær	Adjective	nidkær
grusom	Adjective	grusom
gammel	Adjective	gammel (neuter gammelt, plural and definite singular attributive gamle, comparative ældre, superlative (predicative) ældst, superlative (attributive) {{{5}}})
elegante	Adjective	elegante
gensidig	Adjective	gensidig
vred	Adjective	vred
favorit	Adjective	favorit
subversiv	Adjective	subversiv
invers	Adjective	invers
travl	Adjective	travl
øre	Adjective	øre
maniodepressiv	Adjective	maniodepressiv
virksom	Adjective	virksom
træg	Adjective	træg
enlig	Adjective	enlig
herbivor	Adjective	herbivor
hygiejnisk	Adjective	hygiejnisk
grotesk	Adjective	grotesk
dyrisk	Adjective	dyrisk
naturlig	Adjective	naturlig (neuter naturligt, plural and definite singular attributive naturlige)
rusten	Adjective	rusten
given	Adjective	given
ivrig	Adjective	ivrig
skidt	Adjective	skidt
elegant	Adjective	elegant
halal	Adjective	halal (neuter halal, plural and definite singular attributive halal)
hollandsk	Adjective	hollandsk
nytteløs	Adjective	nytteløs
økumenisk	Adjective	økumenisk
indadvendt	Adjective	indadvendt
kriminel	Adjective	kriminel
alternativ	Adjective	alternativ
rådden	Adjective	rådden
populær	Adjective	populær
malawisk	Adjective	malawisk
frisisk	Adjective	frisisk
vilkårlig	Adjective	vilkårlig
kromatografisk	Adjective	kromatografisk
idiomatisk	Adjective	idiomatisk
rebelsk	Adjective	rebelsk
stille	Adjective	stille
langsom	Adjective	langsom
trygt	Adjective	trygt
afskyelig	Adjective	afskyelig
imposant	Adjective	imposant
dyr	Adjective	dyr
almægtig	Adjective	almægtig
oldhøjtysk	Adjective	oldhøjtysk
fuldtallig	Adjective	fuldtallig
elementær	Adjective	elementær
monokrom	Adjective	monokrom
rige	Adjective	rige
intern	Adjective	intern (neuter internt, plural and definite singular attributive interne)
perfekt	Adjective	perfekt (neuter perfekt, plural and definite singular attributive perfekte)
skod	Adjective	skod (neuter skod, plural and definite singular attributive skod or skodde)
huld	Adjective	huld
fade	Adjective	fade
vandelskende	Adjective	vandelskende
kompakt	Adjective	kompakt
ond	Adjective	ond (neuter ondt, plural and definite singular attributive onde, comparative ondere or værre, superlative (predicative) ondest or værst, superlative (attributive) {{{5}}} or værste)
altruistisk	Adjective	altruistisk
vinde	Adjective	vinde
stabil	Adjective	stabil
tavs	Adjective	tavs
fejlagtig	Adjective	fejlagtig
definerlig	Adjective	definerlig
frigid	Adjective	frigid
sjælden	Adjective	sjælden
helt	Adjective	helt
regulær	Adjective	regulær
lummer	Adjective	lummer
religiøs	Adjective	religiøs
gæstmild	Adjective	gæstmild
citrongul	Adjective	citrongul
mest	Adjective	mest
livisk	Adjective	livisk
uddateret	Adjective	uddateret
tyrkisk	Adjective	tyrkisk
hjernedød	Adjective	hjernedød
dansk-norsk	Adjective	dansk-norsk
jævn	Adjective	jævn
hele	Adjective	hele
usynlig	Adjective	usynlig
fonetisk	Adjective	fonetisk
kommunal	Adjective	kommunal
kilden	Adjective	kilden
sød	Adjective	sød
blind	Adjective	blind
britisk	Adjective	britisk
uopdragen	Adjective	uopdragen
fine	Adjective	fine
neutral	Adjective	neutral
territorial	Adjective	territorial
effen	Adjective	effen
sortklædt	Adjective	sortklædt
rig	Adjective	rig
billig	Adjective	billig
materiel	Adjective	materiel
glædelig	Adjective	glædelig
fåret	Adjective	fåret
sidste	Adjective	sidste
skånsk	Adjective	skånsk
bar	Adjective	bar
kvik	Adjective	kvik
bly	Adjective	bly
yndig	Adjective	yndig
dualis	Adjective	dualis
sødygtig	Adjective	sødygtig
kvindagtig	Adjective	kvindagtig
guddommelig	Adjective	guddommelig
splejset	Adjective	splejset
sløv	Adjective	sløv
var	Adjective	var
kæmpe	Adjective	kæmpe
tørstig	Adjective	tørstig
hård	Adjective	hård
lave	Adjective	lave
utvivlsom	Adjective	utvivlsom
flamboyant	Adjective	flamboyant
ambitiøs	Adjective	ambitiøs
brun	Adjective	brun
uheldig	Adjective	uheldig
trættekær	Adjective	trættekær
idiotsikre	Adjective	idiotsikre
gotisk	Adjective	gotisk
øjensynlig	Adjective	øjensynlig
nøgen	Adjective	nøgen
diminutiv	Adjective	diminutiv
sejlrede	Adjective	sejlrede
genopladelig	Adjective	genopladelig
realistisk	Adjective	realistisk
spansk	Adjective	spansk
liderlig	Adjective	liderlig
belortet	Adjective	belortet
køn	Adjective	køn
obligat	Adjective	obligat
human	Adjective	human
numerisk	Adjective	numerisk (neuter numerisk, plural and definite singular attributive numeriske)
obskøn	Adjective	obskøn
primær	Adjective	primær
før	Adjective	før
probat	Adjective	probat
stoflig	Adjective	stoflig
qatarsk	Adjective	qatarsk
barfodet	Adjective	barfodet
rigtig	Adjective	rigtig
bipolær	Adjective	bipolær
fuld	Adjective	fuld
snæver	Adjective	snæver
samme	Adjective	samme
babylonsk	Adjective	babylonsk
uartig	Adjective	uartig
kort	Adjective	kort
fæl	Adjective	fæl
afdød	Adjective	afdød
ensproget	Adjective	ensproget
skyldig	Adjective	skyldig
salig	Adjective	salig
flov	Adjective	flov
nærig	Adjective	nærig
diagonal	Adjective	diagonal
troværdig	Adjective	troværdig
usikker	Adjective	usikker
mellemlang	Adjective	mellemlang
automatisk	Adjective	automatisk (neuter singular automatisk, definite singular and plural automatiske)
statelig	Adjective	statelig
gemytlig	Adjective	gemytlig
turkis	Adjective	turkis (neuter turkis or turkist, plural and definite singular attributive turkise)
bitter	Adjective	bitter
stærk	Adjective	stærk
vise	Adjective	vise
nærsynet	Adjective	nærsynet
balstyrig	Adjective	balstyrig
sygelig	Adjective	sygelig
mondæn	Adjective	mondæn
alvorlig	Adjective	alvorlig
dekorativ	Adjective	dekorativ
kunstig	Adjective	kunstig
javanesisk	Adjective	javanesisk
estisk	Adjective	estisk
ækel	Adjective	ækel
led	Adjective	led
psykosomatisk	Adjective	psykosomatisk
anglofil	Adjective	anglofil
mild	Adjective	mild
klar	Adjective	klar
vild	Adjective	vild
kastiliansk	Adjective	kastiliansk
acceptabel	Adjective	acceptabel
malerisk	Adjective	malerisk
livlig	Adjective	livlig
dobbelt	Adjective	dobbelt
despotisk	Adjective	despotisk
uerfaren	Adjective	uerfaren
etnisk	Adjective	etnisk
korte	Adjective	korte
kvælstoffikserende	Adjective	kvælstoffikserende
lette	Adjective	lette
forkert	Adjective	forkert
opportun	Adjective	opportun
heteroseksuel	Adjective	heteroseksuel
oldarabisk	Adjective	oldarabisk
tysk	Adjective	tysk
jiddisch	Adjective	jiddisch (neuter jiddisch, plural and definite singular attributive jiddische)
flertydig	Adjective	flertydig
kornet	Adjective	kornet
omnivor	Adjective	omnivor
sproglig	Adjective	sproglig
debil	Adjective	debil
skindød	Adjective	skindød
burmesisk	Adjective	burmesisk
fjern	Adjective	fjern
middelnedertysk	Adjective	middelnedertysk
gyldig	Adjective	gyldig
smuk	Adjective	smuk
tør	Adjective	tør
utallig	Adjective	utallig
tilbøjelig	Adjective	tilbøjelig
varm	Adjective	varm
avanceret	Adjective	avanceret
lyst	Adjective	lyst
mægtig	Adjective	mægtig
nyest	Adjective	nyest
fattig	Adjective	fattig
castiliansk	Adjective	castiliansk
voldsom	Adjective	voldsom
klam	Adjective	klam
maltesisk	Adjective	maltesisk
virtuel	Adjective	virtuel
flyvedygtig	Adjective	flyvedygtig
komplet	Adjective	komplet
newzealandsk	Adjective	newzealandsk
kirkegaardsk	Adjective	kirkegaardsk
østrigsk	Adjective	østrigsk
eskimologisk	Adjective	eskimologisk
almindelig	Adjective	almindelig (neuter almindeligt, plural and definite singular attributive almindelige, comparative almindeligere, superlative (predicative) almindeligst, superlative (attributive) almindeligste)
ordblind	Adjective	ordblind
grammatisk	Adjective	grammatisk
hule	Adjective	hule
darwinistisk	Adjective	darwinistisk
gift	Adjective	gift
irrelevant	Adjective	irrelevant
ledig	Adjective	ledig (neuter ledigt, plural and definite singular attributive ledige)
slovakisk	Adjective	slovakisk
oldnordisk	Adjective	oldnordisk
legal	Adjective	legal
egal	Adjective	egal (neuter egalt, plural and definite singular attributive egale)
uvulær	Adjective	uvulær
ordret	Adjective	ordret
brutal	Adjective	brutal
almengyldig	Adjective	almengyldig
sindssyg	Adjective	sindssyg
catalansk	Adjective	catalansk
skæg	Adjective	skæg
aarhusiansk	Adjective	aarhusiansk
begejstret	Adjective	begejstret
udseende	Adjective	udseende
palæstinensisk	Adjective	palæstinensisk
pauver	Adjective	pauver
bred	Adjective	bred
eddikesur	Adjective	eddikesur
hierarkisk	Adjective	hierarkisk
indisk	Adjective	indisk (neuter indisk, plural and definite singular attributive indiske)
filosofisk	Adjective	filosofisk
åbenhjertet	Adjective	åbenhjertet
røvsyg	Adjective	røvsyg
impulsiv	Adjective	impulsiv
trådløs	Adjective	trådløs
snusket	Adjective	snusket
sporadisk	Adjective	sporadisk
mør	Adjective	mør
skøn	Adjective	skøn
færøsk	Adjective	færøsk
basisk	Adjective	basisk
hel	Adjective	hel
uskyldig	Adjective	uskyldig
fint	Adjective	fint
elskværdig	Adjective	elskværdig
episk	Adjective	episk
arresteret	Adjective	arresteret
aragonisk	Adjective	aragonisk
køresyg	Adjective	køresyg
lækkersulten	Adjective	lækkersulten
næste	Adjective	næste
hydrofil	Adjective	hydrofil
gram	Adjective	gram
tålmodig	Adjective	tålmodig
gudløs	Adjective	gudløs
stemt	Adjective	stemt
knap	Adjective	knap
kroatisk	Adjective	kroatisk
norsk	Adjective	norsk
uudholdelig	Adjective	uudholdelig
eventuel	Adjective	eventuel
sure	Adjective	sure
periodisk	Adjective	periodisk
eskimoisk	Adjective	eskimoisk
gravid	Adjective	gravid
lokal	Adjective	lokal
let	Adjective	let
gregoriansk	Adjective	gregoriansk
astronomisk	Adjective	astronomisk
blød	Adjective	blød
griset	Adjective	griset
central	Adjective	central
usagt	Adjective	usagt
skælmsk	Adjective	skælmsk
unge	Adjective	unge
metodisk	Adjective	metodisk
ekstraordinær	Adjective	ekstraordinær
ligegyldig	Adjective	ligegyldig
lækker	Adjective	lækker
nye	Adjective	nye
sekulær	Adjective	sekulær
kinesisk	Adjective	kinesisk
bedste	Adjective	bedste
bedste	Adjective	bedste
tryg	Adjective	tryg
mager	Adjective	mager
fager	Adjective	fager
brunstig	Adjective	brunstig
funktionel	Adjective	funktionel
syg	Adjective	syg
innovativ	Adjective	innovativ
ny	Adjective	ny (neuter nyt, plural and definite singular attributive ny or nye, comparative nyere, superlative (predicative) nyest, superlative (attributive) {{{5}}})
ordbogsmæssig	Adjective	ordbogsmæssig
grammatikalsk	Adjective	grammatikalsk
astmatisk	Adjective	astmatisk
varsom	Adjective	varsom
ukendt	Adjective	ukendt
lyserød	Adjective	lyserød
fiktiv	Adjective	fiktiv
rund	Adjective	rund
naiv	Adjective	naiv
porøs	Adjective	porøs
symmetrisk	Adjective	symmetrisk
femsproget	Adjective	femsproget
from	Adjective	from
verdenskendt	Adjective	verdenskendt
immun	Adjective	immun
beslutningsdygtig	Adjective	beslutningsdygtig
tilpasningsdygtig	Adjective	tilpasningsdygtig
kaput	Adjective	kaput (neuter kaput, plural and definite singular attributive kaput)
stram	Adjective	stram
brasiliansk	Adjective	brasiliansk
stift	Adjective	stift
nydelig	Adjective	nydelig
lystig	Adjective	lystig
fritstående	Adjective	fritstående
dubiøs	Adjective	dubiøs
udmattet	Adjective	udmattet
civile	Adjective	civile
walisisk	Adjective	walisisk
svedig	Adjective	svedig
sambo	Adjective	sambo
krystalklar	Adjective	krystalklar
balstyrisk	Adjective	balstyrisk
tung	Adjective	tung
litauisk	Adjective	litauisk
fundamental	Adjective	fundamental
medium	Adjective	medium (neuter medium, plural and definite singular attributive medium)
stædig	Adjective	stædig
nonchalant	Adjective	nonchalant
trekantet	Adjective	trekantet
praktisk	Adjective	praktisk
diskret	Adjective	diskret
sanitær	Adjective	sanitær
billige	Adjective	billige
protoindoeuropæisk	Adjective	protoindoeuropæisk
monumental	Adjective	monumental
autentisk	Adjective	autentisk
