sod	Adjective	sod (comparative more sod, superlative most sod)
anatomic	Adjective	anatomic (not comparable)
peristaltic	Adjective	peristaltic (not comparable)
vulgar	Adjective	vulgar (comparative vulgarer or more vulgar, superlative vulgarest or most vulgar)
hersum	Adjective	hersum (comparative more hersum, superlative most hersum)
oscular	Adjective	oscular (comparative more oscular, superlative most oscular)
def	Adjective	def (comparative deffer, superlative deffest)
hit	Adjective	hit (comparative more hit, superlative most hit)
might	Adjective	might (comparative mighter, superlative mightest)
grim	Adjective	grim (comparative grimmer, superlative grimmest)
gastric	Adjective	gastric (comparative more gastric, superlative most gastric)
Chinese	Adjective	Chinese (not generally comparable, comparative more Chinese, superlative most Chinese)
periostal	Adjective	periostal
Mende	Adjective	Mende (not comparable)
binaural	Adjective	binaural (not comparable)
frolic	Adjective	frolic (comparative more frolic, superlative most frolic)
compact	Adjective	compact (comparative more compact, superlative most compact)
lobed	Adjective	lobed (not comparable)
utter	Adjective	utter (not comparable)
memorial	Adjective	memorial (comparative more memorial, superlative most memorial)
peng	Adjective	peng (comparative penger, superlative pengest)
præsent	Adjective	præsent (comparative more præsent, superlative most præsent)
mo	Adjective	mo (not comparable)
mo	Adjective	mo (not comparable)
baller	Adjective	baller (comparative more baller, superlative most baller)
banal	Adjective	banal (comparative more banal or banaler, superlative most banal or banalest)
country	Adjective	country (not comparable)
agreable	Adjective	agreable
m.	Adjective	m.
adult	Adjective	adult (comparative more adult, superlative most adult)
creo	Adjective	creo (not comparable)
unicolor	Adjective	unicolor (not comparable)
pure	Adjective	pure (comparative purer or more pure, superlative purest or most pure)
virotic	Adjective	virotic (not comparable)
blag	Adjective	blag (comparative more blag, superlative most blag)
bilingual	Adjective	bilingual (not comparable)
leal	Adjective	leal (comparative lealer, superlative lealest)
nef	Adjective	nef (not comparable)
skare	Adjective	skare (comparative more skare, superlative most skare)
liker	Adjective	liker
nett	Adjective	nett (not comparable)
perinatal	Adjective	perinatal (comparative more perinatal, superlative most perinatal)
correct	Adjective	correct (comparative more correct, superlative most correct)
tort	Adjective	tort (comparative more tort, superlative most tort)
tort	Adjective	tort (comparative torter, superlative tortest)
prior	Adjective	prior (not comparable)
vehicular	Adjective	vehicular (not comparable)
especial	Adjective	especial (comparative more especial, superlative most especial)
abbed	Adjective	abbed (not comparable)
typy	Adjective	typy (comparative typier, superlative typiest)
masc	Adjective	masc (comparative more masc, superlative most masc)
hind	Adjective	hind (comparative hinder, superlative hindmost)
aeger	Adjective	aeger (not comparable)
Czech	Adjective	Czech (not comparable)
slicht	Adjective	slicht
transatlantic	Adjective	transatlantic (not comparable)
Islamist	Adjective	Islamist (comparative more Islamist, superlative most Islamist)
compacter	Adjective	compacter
binding	Adjective	binding (comparative more binding, superlative most binding)
bilinear	Adjective	bilinear (not comparable)
interstellar	Adjective	interstellar (not comparable)
erke	Adjective	erke (comparative more erke, superlative most erke)
continental	Adjective	continental (comparative more continental, superlative most continental)
baltic	Adjective	baltic (comparative more baltic, superlative most baltic)
divergent	Adjective	divergent (comparative more divergent, superlative most divergent)
palatal	Adjective	palatal (comparative more palatal, superlative most palatal)
grave	Adjective	grave (comparative graver, superlative gravest)
budget	Adjective	budget (not comparable)
damper	Adjective	damper
smart	Adjective	smart (comparative smarter or more smart, superlative smartest or most smart)
eben	Adjective	eben (comparative more eben, superlative most eben)
relevant	Adjective	relevant (comparative more relevant, superlative most relevant)
by	Adjective	by (not comparable)
alt	Adjective	alt (not comparable)
spiccato	Adjective	spiccato (comparative more spiccato, superlative most spiccato)
fear	Adjective	fear (comparative more fear, superlative most fear)
salt	Adjective	salt (comparative more salt, superlative most salt)
ental	Adjective	ental (comparative more ental, superlative most ental)
bare	Adjective	bare (comparative barer, superlative barest)
dandy	Adjective	dandy (comparative dandier, superlative dandiest)
tricolor	Adjective	tricolor (not comparable)
hale	Adjective	hale (comparative haler, superlative halest)
ail	Adjective	ail (comparative ailer or more ail, superlative ailest or most ail)
cover	Adjective	cover (not comparable)
enorm	Adjective	enorm (comparative more enorm, superlative most enorm)
dum	Adjective	dum (not comparable)
chic	Adjective	chic (comparative chicer or more chic, superlative chicest or most chic)
bollen	Adjective	bollen (comparative more bollen, superlative most bollen)
loco	Adjective	loco (comparative more loco, superlative most loco)
octan	Adjective	octan (not comparable)
novel	Adjective	novel (comparative more novel, superlative most novel)
sentimental	Adjective	sentimental (comparative more sentimental, superlative most sentimental)
Damask	Adjective	Damask (comparative more Damask, superlative most Damask)
obedient	Adjective	obedient (comparative more obedient, superlative most obedient)
diastolic	Adjective	diastolic (comparative more diastolic, superlative most diastolic)
cactus	Adjective	cactus (not comparable)
like	Adjective	like (comparative more like or liker, superlative most like or likest)
essentialist	Adjective	essentialist (comparative more essentialist, superlative most essentialist)
moted	Adjective	moted (not comparable)
staid	Adjective	staid (comparative staider, superlative staidest)
melting	Adjective	melting (comparative more melting, superlative most melting)
gent	Adjective	gent (comparative more gent, superlative most gent)
Protestant	Adjective	Protestant (comparative more Protestant, superlative most Protestant)
redundant	Adjective	redundant (comparative more redundant, superlative most redundant)
Brit	Adjective	Brit (comparative more Brit, superlative most Brit)
salonfähig	Adjective	salonfähig (not comparable)
idem	Adjective	idem (not comparable)
tid	Adjective	tid (comparative more tid, superlative most tid)
brachial	Adjective	brachial (not comparable)
observant	Adjective	observant (comparative more observant, superlative most observant)
ith	Adjective	ith (not comparable)
aboral	Adjective	aboral (comparative more aboral, superlative most aboral)
plural	Adjective	plural (comparative more plural, superlative most plural)
tied	Adjective	tied (comparative more tied, superlative most tied)
leprous	Adjective	leprous (comparative more leprous, superlative most leprous)
aloud	Adjective	aloud (comparative more aloud, superlative most aloud)
strikt	Adjective	strikt (comparative strikter, superlative striktest)
gusty	Adjective	gusty (comparative gustier, superlative gustiest)
humoral	Adjective	humoral (comparative more humoral, superlative most humoral)
Marine	Adjective	Marine (not comparable)
per	Adjective	per (not comparable)
lenis	Adjective	lenis (not comparable)
ghetto	Adjective	ghetto (comparative more ghetto, superlative most ghetto)
sad	Adjective	sad (comparative sadder or more sad, superlative saddest or most sad)
genetic	Adjective	genetic (not comparable)
standard	Adjective	standard (comparative more standard, superlative most standard)
fly	Adjective	fly (comparative flier, superlative fliest)
mono	Adjective	mono (not comparable)
mono	Adjective	mono (not comparable)
bananas	Adjective	bananas (comparative more bananas, superlative most bananas)
ya	Adjective	ya
side	Adjective	side (comparative more side, superlative most side)
reseda	Adjective	reseda (not comparable)
slim	Adjective	slim (comparative slimmer, superlative slimmest)
inviso	Adjective	inviso
vanilla	Adjective	vanilla (comparative more vanilla, superlative most vanilla)
relational	Adjective	relational (not comparable)
untrew	Adjective	untrew (comparative more untrew, superlative most untrew)
focal	Adjective	focal (not comparable)
abgeschmackt	Adjective	abgeschmackt (comparative more abgeschmackt, superlative most abgeschmackt)
vital	Adjective	vital (comparative more vital, superlative most vital)
levo	Adjective	levo (not comparable)
designer	Adjective	designer (not comparable)
nemoral	Adjective	nemoral (comparative more nemoral, superlative most nemoral)
it	Adjective	it (not comparable)
original	Adjective	original (comparative more original, superlative most original)
flirt	Adjective	flirt (not comparable)
perineal	Adjective	perineal (not comparable)
bum	Adjective	bum (comparative bummer, superlative bummest)
bay	Adjective	bay (comparative more bay, superlative most bay)
small	Adjective	small (comparative smaller, superlative smallest)
aro	Adjective	aro (comparative more aro, superlative most aro)
rum	Adjective	rum (comparative rummer, superlative rummest)
national	Adjective	national (comparative more national, superlative most national)
antiparallel	Adjective	antiparallel (not comparable)
ultimo	Adjective	ultimo (not comparable)
shan	Adjective	shan (comparative more shan, superlative most shan)
glazen	Adjective	glazen (comparative more glazen, superlative most glazen)
Esperantist	Adjective	Esperantist (not comparable)
a	Adjective	a (not comparable)
able	Adjective	able (comparative abler, superlative ablest)
agape	Adjective	agape (comparative more agape, superlative most agape)
orra	Adjective	orra (comparative more orra, superlative most orra)
Hindu	Adjective	Hindu (not comparable)
Calvinist	Adjective	Calvinist (comparative more Calvinist, superlative most Calvinist)
lies	Adjective	lies
verbal	Adjective	verbal (not comparable)
subtil	Adjective	subtil (comparative more subtil, superlative most subtil)
German	Adjective	German (comparative more German, superlative most German or Germanest)
vert	Adjective	vert (comparative more vert, superlative most vert)
bronze	Adjective	bronze (comparative more bronze, superlative most bronze)
adjutant	Adjective	adjutant (not comparable)
toom	Adjective	toom (comparative more toom, superlative most toom)
federal	Adjective	federal (not comparable)
Zionist	Adjective	Zionist (comparative more Zionist, superlative most Zionist)
subtitular	Adjective	subtitular (not comparable)
beat	Adjective	beat (comparative more beat, superlative most beat)
petunia	Adjective	petunia (not comparable)
red	Adjective	red (comparative redder, superlative reddest)
talar	Adjective	talar (not comparable)
mad	Adjective	mad (comparative madder, superlative maddest)
narcotic	Adjective	narcotic (comparative more narcotic, superlative most narcotic)
Titanic	Adjective	Titanic (not comparable)
proxy	Adjective	proxy (not comparable)
Vietnamese	Adjective	Vietnamese (not comparable)
invalid	Adjective	invalid (comparative more invalid, superlative most invalid)
invalid	Adjective	invalid (not comparable)
embryonal	Adjective	embryonal (not comparable)
asexual	Adjective	asexual (not comparable)
teak	Adjective	teak (not comparable)
nuclear	Adjective	nuclear (not comparable)
oniric	Adjective	oniric (comparative more oniric, superlative most oniric)
leger	Adjective	leger (comparative more leger, superlative most leger)
personed	Adjective	personed (not comparable)
bivalent	Adjective	bivalent (comparative more bivalent, superlative most bivalent)
rude	Adjective	rude (comparative ruder, superlative rudest)
accidental	Adjective	accidental (comparative more accidental, superlative most accidental)
conciliar	Adjective	conciliar (comparative more conciliar, superlative most conciliar)
brunet	Adjective	brunet (not comparable)
roial	Adjective	roial (comparative more roial, superlative most roial)
rote	Adjective	rote (comparative more rote, superlative most rote)
tabular	Adjective	tabular (comparative more tabular, superlative most tabular)
matte	Adjective	matte (not comparable)
hir	Adjective	hir (not comparable)
electric	Adjective	electric (not comparable)
dim	Adjective	dim (comparative dimmer, superlative dimmest)
amical	Adjective	amical (comparative more amical, superlative most amical)
essential	Adjective	essential (comparative more essential, superlative most essential)
triangular	Adjective	triangular (comparative more triangular, superlative most triangular)
juster	Adjective	juster
templatic	Adjective	templatic (not comparable)
pied	Adjective	pied (comparative more pied, superlative most pied)
due	Adjective	due (comparative more due, superlative most due)
sellar	Adjective	sellar (not comparable)
fleischig	Adjective	fleischig (not comparable)
adverbial	Adjective	adverbial (comparative more adverbial, superlative most adverbial)
abstinent	Adjective	abstinent (comparative more abstinent, superlative most abstinent)
posterior	Adjective	posterior (comparative more posterior, superlative most posterior)
faster	Adjective	faster
literal	Adjective	literal (comparative more literal, superlative most literal)
austere	Adjective	austere (comparative austerer or more austere, superlative austerest or most austere)
apo	Adjective	apo (not comparable)
haler	Adjective	haler
sublimer	Adjective	sublimer
sav	Adjective	sav (comparative more sav, superlative most sav)
lax	Adjective	lax (comparative laxer, superlative laxest)
absolut	Adjective	absolut
beryl	Adjective	beryl (not comparable)
shot	Adjective	shot (comparative more shot, superlative most shot)
floral	Adjective	floral (comparative more floral, superlative most floral)
sinister	Adjective	sinister (comparative more sinister, superlative most sinister)
episcopal	Adjective	episcopal (comparative more episcopal, superlative most episcopal)
stick	Adjective	stick (comparative sticker, superlative stickest)
urban	Adjective	urban (comparative more urban, superlative most urban)
prog	Adjective	prog (not comparable)
militant	Adjective	militant (comparative more militant, superlative most militant)
sarcastic	Adjective	sarcastic (comparative more sarcastic, superlative most sarcastic)
suborbital	Adjective	suborbital (not comparable)
textile	Adjective	textile (comparative more textile, superlative most textile)
model	Adjective	model (not comparable)
calmer	Adjective	calmer
gradient	Adjective	gradient (not comparable)
polar	Adjective	polar (not comparable)
hurt	Adjective	hurt (comparative more hurt, superlative most hurt)
deaf	Adjective	deaf (comparative deafer, superlative deafest)
fire	Adjective	fire (not comparable)
formular	Adjective	formular (comparative more formular, superlative most formular)
plumb	Adjective	plumb (comparative more plumb, superlative most plumb)
nominal	Adjective	nominal (not comparable)
half	Adjective	half (not comparable)
redux	Adjective	redux (not comparable)
unheimlich	Adjective	unheimlich (comparative more unheimlich, superlative most unheimlich)
tolerant	Adjective	tolerant (comparative more tolerant, superlative most tolerant)
basal	Adjective	basal (comparative more basal, superlative most basal)
extrapolar	Adjective	extrapolar (not comparable)
topaz	Adjective	topaz
Bolgar	Adjective	Bolgar (comparative more Bolgar, superlative most Bolgar)
macular	Adjective	macular (not comparable)
stereo	Adjective	stereo (not comparable)
thin	Adjective	thin (comparative thinner, superlative thinnest)
sock	Adjective	sock (not comparable)
adagio	Adjective	adagio (not comparable)
wis	Adjective	wis (comparative more wis, superlative most wis)
bona	Adjective	bona (comparative more bona, superlative most bona)
diviner	Adjective	diviner
sapient	Adjective	sapient (comparative more sapient, superlative most sapient)
fast	Adjective	fast (comparative faster, superlative fastest)
judenrein	Adjective	judenrein (not comparable)
laminar	Adjective	laminar (not comparable)
gally	Adjective	gally (comparative more gally, superlative most gally)
patent	Adjective	patent (comparative more patent, superlative most patent)
warm	Adjective	warm (comparative warmer, superlative warmest)
ember	Adjective	ember (not comparable)
chantant	Adjective	chantant (comparative more chantant, superlative most chantant)
Abidjan	Adjective	Abidjan (not comparable)
fit	Adjective	fit (comparative fitter, superlative fittest)
median	Adjective	median (not comparable)
superessive	Adjective	superessive (not comparable)
adherent	Adjective	adherent (comparative more adherent, superlative most adherent)
puce	Adjective	puce (comparative more puce, superlative most puce)
clamant	Adjective	clamant (comparative more clamant, superlative most clamant)
prodromal	Adjective	prodromal (comparative more prodromal, superlative most prodromal)
onyx	Adjective	onyx (not comparable)
down	Adjective	down (comparative more down, superlative most down)
inocular	Adjective	inocular (not comparable)
intolerant	Adjective	intolerant (comparative more intolerant, superlative most intolerant)
diverse	Adjective	diverse (comparative more diverse, superlative most diverse)
pert	Adjective	pert (comparative perter, superlative pertest)
henna	Adjective	henna (not comparable)
seme	Adjective	seme
graven	Adjective	graven (not comparable)
arm	Adjective	arm (comparative armer or more arm, superlative armest or most arm)
driest	Adjective	driest
fere	Adjective	fere (comparative more fere, superlative most fere)
hare	Adjective	hare
coyer	Adjective	coyer
circular	Adjective	circular (comparative more circular, superlative most circular)
cardinal	Adjective	cardinal (comparative more cardinal, superlative most cardinal)
leer	Adjective	leer (comparative more leer, superlative most leer)
latent	Adjective	latent (not comparable)
zero	Adjective	zero (not comparable)
deist	Adjective	deist (comparative more deist, superlative most deist)
home	Adjective	home (not comparable)
triste	Adjective	triste
diametral	Adjective	diametral (not comparable)
sand	Adjective	sand (comparative more sand, superlative most sand)
dioicus	Adjective	dioicus (comparative more dioicus, superlative most dioicus)
surreal	Adjective	surreal (comparative more surreal, superlative most surreal)
husky	Adjective	husky (comparative huskier, superlative huskiest)
statistic	Adjective	statistic (comparative more statistic, superlative most statistic)
figural	Adjective	figural (comparative more figural, superlative most figural)
strut	Adjective	strut (comparative more strut, superlative most strut)
Balkan	Adjective	Balkan (not comparable)
multiplex	Adjective	multiplex (not comparable)
brant	Adjective	brant (comparative more brant, superlative most brant)
vile	Adjective	vile (comparative viler or more vile, superlative vilest or most vile)
pov	Adjective	pov (comparative more pov, superlative most pov)
cabre	Adjective	cabre
compatriot	Adjective	compatriot (comparative more compatriot, superlative most compatriot)
marginal	Adjective	marginal (not generally comparable, comparative more marginal, superlative most marginal)
erotic	Adjective	erotic (comparative more erotic, superlative most erotic)
reflexed	Adjective	reflexed (comparative more reflexed, superlative most reflexed)
stricken	Adjective	stricken (comparative more stricken, superlative most stricken)
baser	Adjective	baser
enigmatic	Adjective	enigmatic (comparative more enigmatic, superlative most enigmatic)
criminal	Adjective	criminal (comparative more criminal, superlative most criminal)
glad	Adjective	glad (comparative gladder or more glad, superlative gladdest or most glad)
solid	Adjective	solid (comparative more solid, superlative most solid)
great	Adjective	great (comparative greater, superlative greatest)
stout	Adjective	stout (comparative stouter, superlative stoutest)
important	Adjective	important (comparative more important, superlative most important)
a priori	Adjective	a priori (comparative more a priori, superlative most a priori)
pagan	Adjective	pagan (not comparable)
brath	Adjective	brath (comparative brather or more brath, superlative brathest or most brath)
fond	Adjective	fond (comparative fonder, superlative fondest)
bilabial	Adjective	bilabial (not comparable)
Nazi	Adjective	Nazi (comparative more Nazi, superlative most Nazi)
minuter	Adjective	minuter
normal	Adjective	normal (comparative normaler or more normal, superlative normalest or most normal)
instrumental	Adjective	instrumental (comparative more instrumental, superlative most instrumental)
paranoid	Adjective	paranoid (comparative more paranoid, superlative most paranoid)
acro	Adjective	acro
festival	Adjective	festival (comparative more festival, superlative most festival)
ven	Adjective	ven
accept	Adjective	accept (comparative more accept, superlative most accept)
Abram	Adjective	Abram
mod	Adjective	mod
transparent	Adjective	transparent (comparative more transparent, superlative most transparent)
new	Adjective	new (comparative newer, superlative newest)
epochal	Adjective	epochal (comparative more epochal, superlative most epochal)
inflective	Adjective	inflective (not comparable)
slit	Adjective	slit (not comparable)
homosexual	Adjective	homosexual (comparative more homosexual, superlative most homosexual)
omnipotent	Adjective	omnipotent (comparative more omnipotent, superlative most omnipotent)
charnel	Adjective	charnel (comparative more charnel, superlative most charnel)
paternal	Adjective	paternal (comparative more paternal, superlative most paternal)
jugular	Adjective	jugular (not comparable)
crap	Adjective	crap (comparative crapper, superlative crappest)
hold	Adjective	hold (comparative more hold, superlative most hold)
optimal	Adjective	optimal (comparative more optimal, superlative most optimal)
Cham	Adjective	Cham (comparative more Cham, superlative most Cham)
obliterans	Adjective	obliterans (not comparable)
secure	Adjective	secure (comparative securer or more secure, superlative securest or most secure)
populist	Adjective	populist (comparative more populist, superlative most populist)
extrasolar	Adjective	extrasolar (not comparable)
multicolor	Adjective	multicolor
gala	Adjective	gala (not comparable)
absurd	Adjective	absurd (comparative absurder or more absurd, superlative absurdest or most absurd)
pat	Adjective	pat (comparative more pat, superlative most pat)
baby	Adjective	baby (not comparable) (used only before the noun)
snugger	Adjective	snugger
equivalent	Adjective	equivalent (comparative more equivalent, superlative most equivalent)
materialist	Adjective	materialist (comparative more materialist, superlative most materialist)
grape	Adjective	grape (comparative more grape, superlative most grape)
aberrant	Adjective	aberrant (comparative more aberrant, superlative most aberrant)
rank	Adjective	rank (comparative ranker or more rank, superlative rankest or most rank)
ambulant	Adjective	ambulant (not comparable)
pale	Adjective	pale (comparative paler, superlative palest)
myriad	Adjective	myriad (not comparable)
optional	Adjective	optional (not comparable)
neoliberal	Adjective	neoliberal (comparative more neoliberal, superlative most neoliberal)
capsular	Adjective	capsular (comparative more capsular, superlative most capsular)
top	Adjective	top (not comparable)
moped	Adjective	moped (comparative more moped, superlative most moped)
obliquer	Adjective	obliquer
tharf	Adjective	tharf (comparative more tharf, superlative most tharf)
under	Adjective	under (comparative more under, superlative most under)
bisexual	Adjective	bisexual (comparative more bisexual, superlative most bisexual)
umber	Adjective	umber (not comparable)
jet	Adjective	jet (not comparable)
jet	Adjective	jet (not comparable)
keto	Adjective	keto (not comparable)
sullen	Adjective	sullen (comparative sullener, superlative sullenest)
ventral	Adjective	ventral (not comparable)
interior	Adjective	interior (not comparable)
homo	Adjective	homo (comparative more homo, superlative most homo)
velar	Adjective	velar
isosceles	Adjective	isosceles (not comparable)
a posteriori	Adjective	a posteriori (comparative more a posteriori, superlative most a posteriori)
boss	Adjective	boss (not comparable)
het	Adjective	het (comparative more het, superlative most het)
het	Adjective	het (comparative more het, superlative most het)
mair	Adjective	mair (not comparable)
forte	Adjective	forte (comparative fortissimo, superlative fortississimo)
expert	Adjective	expert (comparative more expert, superlative most expert)
tore	Adjective	tore (comparative more tore, superlative most tore)
Vandal	Adjective	Vandal (not comparable)
proper	Adjective	proper (comparative more proper, superlative most proper)
gray	Adjective	gray (comparative grayer, superlative grayest) (spelled "grey" in the UK and the Commonwealth)
New York	Adjective	New York (comparative more New York, superlative most New York)
divers	Adjective	divers (comparative more divers, superlative most divers)
here	Adjective	here (comparative more here, superlative most here)
solar	Adjective	solar (not comparable)
sitten	Adjective	sitten (comparative more sitten, superlative most sitten)
lucifugus	Adjective	lucifugus
letten	Adjective	letten (not comparable)
Nica	Adjective	Nica (not comparable)
lesbian	Adjective	lesbian (comparative more lesbian, superlative most lesbian)
Latin	Adjective	Latin (not comparable)
series	Adjective	series (not comparable)
minus	Adjective	minus (not comparable)
ad hoc	Adjective	ad hoc (comparative more ad hoc, superlative most ad hoc)
madding	Adjective	madding
grammatic	Adjective	grammatic (comparative more grammatic, superlative most grammatic)
lauter	Adjective	lauter (not comparable)
in	Adjective	in (comparative more in, superlative most in)
gold	Adjective	gold (not generally comparable, comparative golder, superlative goldest)
gold	Adjective	gold (not comparable)
viral	Adjective	viral (not comparable)
flaithiúlach	Adjective	flaithiúlach (not comparable)
emeritus	Adjective	emeritus (not comparable)
frequent	Adjective	frequent (comparative more frequent or frequenter, superlative most frequent or frequentest)
unfair	Adjective	unfair (comparative unfairer, superlative unfairest)
mug	Adjective	mug (comparative mugger, superlative muggest)
valid	Adjective	valid (comparative more valid, superlative most valid)
last	Adjective	last (not comparable)
temporal	Adjective	temporal (comparative more temporal, superlative most temporal)
temporal	Adjective	temporal (not comparable)
obsidian	Adjective	obsidian (comparative more obsidian, superlative most obsidian)
endian	Adjective	endian (not comparable)
away	Adjective	away (comparative further away, superlative furthest away)
away	Adjective	away (comparative more away, superlative most away)
bold	Adjective	bold (comparative bolder, superlative boldest)
azur	Adjective	azur (not comparable)
structural	Adjective	structural (not comparable)
draft	Adjective	draft (not comparable)
plus	Adjective	plus (not comparable)
Berber	Adjective	Berber (not comparable)
hilar	Adjective	hilar (comparative more hilar, superlative most hilar)
mech	Adjective	mech
Orange	Adjective	Orange (not comparable)
gas	Adjective	gas (comparative gasser, superlative gassest)
recess	Adjective	recess
specific	Adjective	specific (comparative more specific, superlative most specific)
musical	Adjective	musical (comparative more musical, superlative most musical)
cultural	Adjective	cultural (comparative more cultural, superlative most cultural)
versed	Adjective	versed (comparative more versed, superlative most versed)
modular	Adjective	modular (not comparable)
center	Adjective	center (not comparable) (American)
spectral	Adjective	spectral (comparative more spectral, superlative most spectral)
nee	Adjective	nee (not comparable)
back	Adjective	back (comparative more back, superlative most back)
calcular	Adjective	calcular (not comparable)
fallen	Adjective	fallen (not comparable)
jel	Adjective	jel (comparative more jel, superlative most jel)
dure	Adjective	dure (comparative more dure, superlative most dure)
milder	Adjective	milder
dermal	Adjective	dermal (not comparable)
stank	Adjective	stank (not comparable)
stank	Adjective	stank (comparative more stank, superlative most stank)
milchig	Adjective	milchig (not comparable)
uber	Adjective	uber (not comparable)
genial	Adjective	genial (comparative more genial, superlative most genial)
genial	Adjective	genial (not comparable)
pomo	Adjective	pomo
doper	Adjective	doper
conjugal	Adjective	conjugal (not comparable)
plat	Adjective	plat (comparative more plat, superlative most plat)
acid	Adjective	acid (comparative more acid, superlative most acid)
far	Adjective	far (comparative farther or further, superlative farthest or furthest or farthermost or furthermost)
eir	Adjective	eir (not comparable)
atonal	Adjective	atonal (comparative more atonal, superlative most atonal)
papal	Adjective	papal (comparative more papal, superlative most papal)
absent	Adjective	absent (comparative absenter, superlative absentest)[1]
dym	Adjective	dym (not comparable)
truck	Adjective	truck (not comparable)
minimal	Adjective	minimal (comparative more minimal, superlative most minimal)
civil	Adjective	civil (comparative more civil, superlative most civil)
graver	Adjective	graver
arrogant	Adjective	arrogant (comparative more arrogant, superlative most arrogant)
president	Adjective	president (not comparable)
somber	Adjective	somber (comparative somberer, superlative somberest)
dit	Adjective	dit (not comparable)
spare	Adjective	spare (comparative sparer, superlative sparest)
or	Adjective	or (not comparable)
funky	Adjective	funky (comparative funkier or more funky, superlative funkiest or most funky)
transborder	Adjective	transborder (not comparable)
brass	Adjective	brass (comparative more brass, superlative most brass)
brass	Adjective	brass
violenter	Adjective	violenter
alabaster	Adjective	alabaster (not comparable)
green	Adjective	green (comparative greener, superlative greenest)
glorious	Adjective	glorious (comparative gloriouser or more glorious, superlative gloriousest or most glorious)
azurn	Adjective	azurn (not comparable)
platinum	Adjective	platinum (comparative more platinum, superlative most platinum)
doner	Adjective	doner
noted	Adjective	noted (comparative more noted, superlative most noted)
brak	Adjective	brak (comparative more brak, superlative most brak)
tangent	Adjective	tangent (not comparable)
desert	Adjective	desert (not comparable)
ritual	Adjective	ritual (comparative more ritual, superlative most ritual)
nival	Adjective	nival (comparative more nival, superlative most nival)
endotracheal	Adjective	endotracheal
biting	Adjective	biting (comparative more biting, superlative most biting)
dialectal	Adjective	dialectal (comparative more dialectal, superlative most dialectal)
anterior	Adjective	anterior (not comparable)
orbitar	Adjective	orbitar (not comparable)
postmenopausal	Adjective	postmenopausal (not comparable)
dati	Adjective	dati (not comparable)
roman	Adjective	roman (not comparable)
morto	Adjective	morto (comparative more morto, superlative most morto)
articular	Adjective	articular (not comparable)
beige	Adjective	beige (comparative beiger or more beige, superlative beigest or most beige)
violaceus	Adjective	violaceus (comparative more violaceus, superlative most violaceus)
kit	Adjective	kit (not comparable)
extra	Adjective	extra (not comparable)
intelligent	Adjective	intelligent (comparative more intelligent or intelligenter, superlative most intelligent or intelligentest)
sepia	Adjective	sepia (comparative more sepia, superlative most sepia)
analog	Adjective	analog (not comparable)
moll	Adjective	moll (not comparable)
min	Adjective	min (comparative more min, superlative most min)
lean	Adjective	lean (comparative leaner, superlative leanest)
quick	Adjective	quick (comparative quicker, superlative quickest)
courant	Adjective	courant (not comparable)
still	Adjective	still (comparative stiller or more still, superlative stillest or most still)
hard	Adjective	hard (comparative harder, superlative hardest)
federalist	Adjective	federalist (not comparable)
vaster	Adjective	vaster
vehement	Adjective	vehement (comparative more vehement, superlative most vehement)
dramatic	Adjective	dramatic (comparative more dramatic, superlative most dramatic)
lime	Adjective	lime (not comparable)
grand	Adjective	grand (comparative grander or more grand, superlative grandest or most grand)
scairt	Adjective	scairt (comparative more scairt, superlative most scairt)
yar	Adjective	yar (comparative more yar, superlative most yar)
yar	Adjective	yar (comparative yarer, superlative yarest)
bone	Adjective	bone (not comparable)
tin	Adjective	tin (not comparable)
leet	Adjective	leet (comparative more leet, superlative most leet)
dur	Adjective	dur (not comparable)
dogmatic	Adjective	dogmatic (comparative more dogmatic, superlative most dogmatic)
orchestral	Adjective	orchestral (not comparable)
ripe	Adjective	ripe (comparative riper, superlative ripest)
felt	Adjective	felt (comparative more felt, superlative most felt)
old	Adjective	old (comparative older or elder, superlative oldest or eldest)
budding	Adjective	budding (not comparable)
ovarial	Adjective	ovarial (not comparable)
taken	Adjective	taken (not comparable)
trist	Adjective	trist (comparative more trist, superlative most trist)
alienans	Adjective	alienans (not comparable)
android	Adjective	android (comparative more android, superlative most android)
august	Adjective	august (comparative auguster or more august, superlative augustest or most august)
magnolia	Adjective	magnolia (not comparable)
pace	Adjective	pace (not comparable)
dear	Adjective	dear (comparative dearer, superlative dearest)
dear	Adjective	dear (comparative more dear, superlative most dear)
siker	Adjective	siker
vast	Adjective	vast (comparative vaster or more vast, superlative vastest or most vast)
bein	Adjective	bein (comparative more bein, superlative most bein)
vegan	Adjective	vegan (not comparable)
osm	Adjective	osm (comparative more osm, superlative most osm)
voide	Adjective	voide (not comparable)
total	Adjective	total (comparative more total, superlative most total)
mure	Adjective	mure (not comparable)
planer	Adjective	planer
damning	Adjective	damning (comparative more damning, superlative most damning)
later	Adjective	later
brief	Adjective	brief (comparative briefer, superlative briefest)
same	Adjective	same (not comparable)
batch	Adjective	batch (not comparable)
super	Adjective	super (not comparable)
flotant	Adjective	flotant (not comparable)
elate	Adjective	elate
tensor	Adjective	tensor (not comparable)
frac	Adjective	frac
go-go	Adjective	go-go (not comparable)
frisk	Adjective	frisk
flat	Adjective	flat (comparative flatter, superlative flattest)
kaputt	Adjective	kaputt (not comparable)
loft	Adjective	loft (comparative more loft, superlative most loft)
free	Adjective	free (comparative freer, superlative freest)
Norman	Adjective	Norman (not comparable)
spot	Adjective	spot (not comparable)
pocket	Adjective	pocket (not comparable)
anal	Adjective	anal (comparative more anal, superlative most anal)
beta	Adjective	beta (not comparable)
adept	Adjective	adept (comparative more adept or adepter, superlative most adept or adeptest)
vers	Adjective	vers (not comparable)
nobel	Adjective	nobel
tender	Adjective	tender (comparative tenderer, superlative tenderest)
inferior	Adjective	inferior (not comparable)
modern	Adjective	modern (comparative moderner or more modern, superlative modernest or most modern)
one	Adjective	one (not comparable)
inert	Adjective	inert (comparative more inert, superlative most inert)
standing	Adjective	standing (not comparable)
brusk	Adjective	brusk (comparative brusker or more brusk, superlative bruskest or most brusk)
potential	Adjective	potential (not comparable)
auto	Adjective	auto (not comparable)
superior	Adjective	superior (not comparable)
dank	Adjective	dank (comparative danker, superlative dankest)
Serb	Adjective	Serb (not comparable)
bastard	Adjective	bastard (comparative more bastard, superlative most bastard)
ABC	Adjective	ABC (not comparable)
proud	Adjective	proud (comparative prouder or more proud, superlative proudest or most proud)
plastic	Adjective	plastic (comparative more plastic, superlative most plastic)
ok	Adjective	ok
femmer	Adjective	femmer (comparative more femmer, superlative most femmer)
instant	Adjective	instant (not comparable)
minor	Adjective	minor (comparative more minor, superlative most minor)
regular	Adjective	regular (comparative more regular, superlative most regular)
medial	Adjective	medial (comparative more medial, superlative most medial)
transversal	Adjective	transversal (comparative more transversal, superlative most transversal)
uniform	Adjective	uniform (comparative more uniform, superlative most uniform)
sensual	Adjective	sensual (comparative more sensual, superlative most sensual)
patina	Adjective	patina (not comparable)
meta	Adjective	meta (comparative more meta, superlative most meta)
dependent	Adjective	dependent (comparative more dependent, superlative most dependent)
orthodox	Adjective	orthodox (comparative more orthodox, superlative most orthodox)
ago	Adjective	ago (comparative more ago, superlative most ago)
optimum	Adjective	optimum
mum	Adjective	mum (not comparable)
tetragonal	Adjective	tetragonal (not comparable)
abaxial	Adjective	abaxial (not comparable)
heterosexual	Adjective	heterosexual (comparative more heterosexual, superlative most heterosexual)
lively	Adjective	lively (comparative livelier, superlative liveliest)
liberal	Adjective	liberal (comparative more liberal, superlative most liberal)
lunar	Adjective	lunar (not comparable)
suboptimal	Adjective	suboptimal (not comparable)
eloquent	Adjective	eloquent (comparative more eloquent, superlative most eloquent)
charrier	Adjective	charrier
diffuser	Adjective	diffuser
la	Adjective	la (not comparable)
equidistant	Adjective	equidistant (not comparable)
international	Adjective	international (comparative more international, superlative most international)
maximum	Adjective	maximum (not comparable)
artist	Adjective	artist (comparative more artist, superlative most artist)
droll	Adjective	droll (comparative droller, superlative drollest)
faire	Adjective	faire
binocular	Adjective	binocular (not comparable)
ware	Adjective	ware (comparative more ware, superlative most ware)
ware	Adjective	ware (comparative more ware, superlative most ware)
sam	Adjective	sam (not comparable)
gaga	Adjective	gaga (comparative more gaga, superlative most gaga)
parol	Adjective	parol (not comparable)
rose	Adjective	rose (not comparable)
Delphin	Adjective	Delphin (comparative more Delphin, superlative most Delphin)
portal	Adjective	portal (not comparable)
oranger	Adjective	oranger
gratis	Adjective	gratis (not comparable)
Baptist	Adjective	Baptist (comparative more Baptist, superlative most Baptist)
belligerent	Adjective	belligerent (comparative more belligerent, superlative most belligerent)
kin	Adjective	kin (not comparable)
nostalgic	Adjective	nostalgic (comparative more nostalgic, superlative most nostalgic)
impune	Adjective	impune (comparative more impune, superlative most impune)
absolutist	Adjective	absolutist (comparative more absolutist, superlative most absolutist)
bomb	Adjective	bomb (comparative more bomb, superlative most bomb)
redivivus	Adjective	redivivus (not comparable)
postalveolar	Adjective	postalveolar (not comparable)
lusk	Adjective	lusk (comparative more lusk, superlative most lusk)
formal	Adjective	formal (comparative more formal, superlative most formal)
consequent	Adjective	consequent (not comparable)
sage	Adjective	sage (comparative sager, superlative sagest)
bald	Adjective	bald (comparative balder, superlative baldest)
bad	Adjective	bad (comparative worse, superlative worst)
bad	Adjective	bad (comparative badder, superlative baddest)
Jesuit	Adjective	Jesuit
differential	Adjective	differential (comparative more differential, superlative most differential)
boreal	Adjective	boreal (comparative more boreal, superlative most boreal)
pet	Adjective	pet (not comparable)
final	Adjective	final (comparative more final, superlative most final)
material	Adjective	material (comparative more material, superlative most material)
fired	Adjective	fired
postnatal	Adjective	postnatal (not comparable)
listy	Adjective	listy (comparative more listy, superlative most listy)
anecdotic	Adjective	anecdotic (comparative more anecdotic, superlative most anecdotic)
sly	Adjective	sly (comparative slier or slyer, superlative sliest or slyest)
hinder	Adjective	hinder (not comparable)
templar	Adjective	templar (comparative more templar, superlative most templar)
rath	Adjective	rath (comparative more rath, superlative most rath)
cooler	Adjective	cooler
rype	Adjective	rype
adaxial	Adjective	adaxial (not comparable)
predal	Adjective	predal (comparative more predal, superlative most predal)
variant	Adjective	variant (comparative more variant, superlative most variant)
fell	Adjective	fell (comparative feller, superlative fellest)
docent	Adjective	docent (comparative more docent, superlative most docent)
continent	Adjective	continent (comparative more continent, superlative most continent)
stupid	Adjective	stupid (comparative stupider or more stupid, superlative stupidest or most stupid)
dadaist	Adjective	dadaist (not comparable)
folk	Adjective	folk (not comparable)
marked	Adjective	marked (comparative more marked, superlative most marked)
ay	Adjective	ay (not comparable)
orgasmic	Adjective	orgasmic (comparative more orgasmic, superlative most orgasmic)
vicious	Adjective	vicious (comparative viciouser or more vicious, superlative viciousest or most vicious)
planar	Adjective	planar (comparative more planar, superlative most planar)
ol	Adjective	ol (not comparable)
open	Adjective	open (comparative more open, superlative most open)
tutelar	Adjective	tutelar (comparative more tutelar, superlative most tutelar)
tridimensional	Adjective	tridimensional (comparative more tridimensional, superlative most tridimensional)
just	Adjective	just (comparative juster or more just, superlative justest or most just)
ajar	Adjective	ajar (comparative more ajar, superlative most ajar)
signal	Adjective	signal (not comparable)
doon	Adjective	doon (not comparable)
posed	Adjective	posed
gnostic	Adjective	gnostic
real	Adjective	real (comparative realer or more real, superlative realest or most real)
damp	Adjective	damp (comparative damper, superlative dampest)
petit	Adjective	petit (comparative more petit, superlative most petit)
reflex	Adjective	reflex (comparative more reflex, superlative most reflex)
orphan	Adjective	orphan (not comparable)
ret	Adjective	ret
duplex	Adjective	duplex (not comparable)
legion	Adjective	legion (not comparable)
overall	Adjective	overall (comparative more overall, superlative most overall)
glib	Adjective	glib (comparative glibber, superlative glibbest)
UV	Adjective	UV (not comparable)
potent	Adjective	potent (comparative more potent, superlative most potent)
sibilant	Adjective	sibilant (comparative more sibilant, superlative most sibilant)
puissant	Adjective	puissant (comparative more puissant, superlative most puissant)
orbital	Adjective	orbital (comparative more orbital, superlative most orbital)
alpinist	Adjective	alpinist (not comparable)
orthogonal	Adjective	orthogonal (not comparable)
tandem	Adjective	tandem (not comparable)
swart	Adjective	swart (comparative swarter, superlative swartest)
damask	Adjective	damask (comparative more damask, superlative most damask)
artistic	Adjective	artistic (comparative more artistic, superlative most artistic)
valgus	Adjective	valgus (not comparable)
auxiliar	Adjective	auxiliar (not comparable)
pansexual	Adjective	pansexual (not comparable)
tax-free	Adjective	tax-free (not comparable)
mere	Adjective	mere (comparative more mere, superlative most mere)
mere	Adjective	mere (comparative merer, superlative merest)
popular	Adjective	popular (comparative more popular, superlative most popular)
teret	Adjective	teret (comparative more teret, superlative most teret)
eld	Adjective	eld (comparative elder, superlative eldest)
soft	Adjective	soft (comparative softer, superlative softest)
heterodox	Adjective	heterodox (not comparable)
exemplar	Adjective	exemplar (comparative more exemplar, superlative most exemplar)
abdominal	Adjective	abdominal (comparative more abdominal, superlative most abdominal)
sagittal	Adjective	sagittal (not comparable)
former	Adjective	former (not comparable)
parenteral	Adjective	parenteral (not comparable)
chauvinist	Adjective	chauvinist (comparative more chauvinist, superlative most chauvinist)
incongruent	Adjective	incongruent (comparative more incongruent, superlative most incongruent)
stock	Adjective	stock (not comparable)
licenced	Adjective	licenced (not comparable)
present	Adjective	present (comparative more present, superlative most present)
plump	Adjective	plump (comparative plumper or more plump, superlative plumpest or most plump)
modal	Adjective	modal (comparative more modal, superlative most modal)
tenuis	Adjective	tenuis (not comparable)
dumber	Adjective	dumber
electromagnetic	Adjective	electromagnetic (not comparable)
bilinguis	Adjective	bilinguis (not comparable)
amic	Adjective	amic (not comparable)
vertebral	Adjective	vertebral (not comparable)
fouler	Adjective	fouler
intact	Adjective	intact (not comparable)
had	Adjective	had
m	Adjective	m
port	Adjective	port (not comparable)
kaki	Adjective	kaki
tame	Adjective	tame (comparative tamer, superlative tamest)
spiritual	Adjective	spiritual (comparative more spiritual, superlative most spiritual)
bit	Adjective	bit (not comparable)
laid	Adjective	laid (not comparable)
Doris	Adjective	Doris (not comparable)
halal	Adjective	halal (not comparable)
regent	Adjective	regent (comparative more regent, superlative most regent)
elegant	Adjective	elegant (comparative more elegant, superlative most elegant)
weekend	Adjective	weekend (not comparable)
universal	Adjective	universal (comparative more universal, superlative most universal)
meh	Adjective	meh (comparative more meh, superlative most meh)
exorbitant	Adjective	exorbitant (comparative more exorbitant, superlative most exorbitant)
H	Adjective	H (not comparable)
spoken	Adjective	spoken (comparative more spoken, superlative most spoken)
given	Adjective	given (comparative more given, superlative most given)
jaden	Adjective	jaden (not comparable)
aidant	Adjective	aidant (comparative more aidant, superlative most aidant)
spriest	Adjective	spriest
bok	Adjective	bok
mini	Adjective	mini (not comparable)
melon	Adjective	melon
Marian	Adjective	Marian (comparative more Marian, superlative most Marian)
Marian	Adjective	Marian (comparative more Marian, superlative most Marian)
Marian	Adjective	Marian (comparative more Marian, superlative most Marian)
manual	Adjective	manual (comparative more manual, superlative most manual)
nomad	Adjective	nomad (comparative more nomad, superlative most nomad)
monster	Adjective	monster (not comparable)
crisper	Adjective	crisper
stary	Adjective	stary (comparative starier, superlative stariest)
dead	Adjective	dead (comparative deader, superlative deadest)
concolor	Adjective	concolor (not comparable)
economic	Adjective	economic (comparative more economic, superlative most economic)
bluffer	Adjective	bluffer
rusked	Adjective	rusked (comparative more rusked, superlative most rusked)
absenter	Adjective	absenter
gro	Adjective	gro (comparative more gro, superlative most gro)
pederastic	Adjective	pederastic (comparative more pederastic, superlative most pederastic)
academic	Adjective	academic (comparative more academic, superlative most academic)
aqua	Adjective	aqua (comparative more aqua, superlative most aqua)
tanner	Adjective	tanner
mesenchymal	Adjective	mesenchymal (not comparable)
trenchant	Adjective	trenchant (comparative more trenchant, superlative most trenchant)
tine	Adjective	tine (comparative tiner, superlative tinest)
penetrant	Adjective	penetrant (comparative more penetrant, superlative most penetrant)
dement	Adjective	dement (comparative more dement, superlative most dement)
alien	Adjective	alien (comparative more alien, superlative most alien)
vinous	Adjective	vinous (comparative more vinous, superlative most vinous)
hot	Adjective	hot (comparative hotter, superlative hottest)
manifest	Adjective	manifest (comparative more manifest, superlative most manifest)
lew	Adjective	lew (comparative lewer, superlative lewest)
lew	Adjective	lew (comparative more lew, superlative most lew)
democratic	Adjective	democratic (comparative more democratic, superlative most democratic)
veg	Adjective	veg (not comparable)
bain	Adjective	bain (comparative more bain, superlative most bain)
fundamental	Adjective	fundamental (comparative more fundamental, superlative most fundamental)
Slovak	Adjective	Slovak (not comparable)
prægnant	Adjective	prægnant (comparative more prægnant, superlative most prægnant)
unilateral	Adjective	unilateral (comparative more unilateral, superlative most unilateral)
asper	Adjective	asper (comparative more asper, superlative most asper)
discreet	Adjective	discreet (comparative more discreet, superlative most discreet)
buffer	Adjective	buffer
social	Adjective	social (comparative more social, superlative most social)
loyal	Adjective	loyal (comparative loyaler or loyaller, superlative loyalest or loyallest)
dun	Adjective	dun (not comparable)
macho	Adjective	macho (comparative more macho, superlative most macho)
modemed	Adjective	modemed (not comparable)
Adrian	Adjective	Adrian (comparative more Adrian, superlative most Adrian)
initial	Adjective	initial (not comparable)
even	Adjective	even (comparative more even, superlative most even)
regius	Adjective	regius (not comparable)
dexter	Adjective	dexter (not comparable)
onomatopeic	Adjective	onomatopeic (not comparable)
ferior	Adjective	ferior (comparative more ferior, superlative most ferior)
morbid	Adjective	morbid (comparative more morbid, superlative most morbid)
burra	Adjective	burra (comparative more burra, superlative most burra)
digital	Adjective	digital (not comparable)
les	Adjective	les (comparative more les, superlative most les)
ambivalent	Adjective	ambivalent (comparative more ambivalent, superlative most ambivalent)
egal	Adjective	egal (comparative more egal, superlative most egal)
sweer	Adjective	sweer (comparative more sweer, superlative most sweer)
pastoral	Adjective	pastoral (comparative more pastoral, superlative most pastoral)
raring	Adjective	raring (comparative more raring, superlative most raring)
arch	Adjective	arch (comparative archer, superlative archest)
slab	Adjective	slab (comparative more slab, superlative most slab)
mineral	Adjective	mineral
porno	Adjective	porno (not comparable)
bomber	Adjective	bomber (comparative more bomber, superlative most bomber)
dancier	Adjective	dancier
meer	Adjective	meer (comparative meerer, superlative meerest)
trew	Adjective	trew
vasal	Adjective	vasal (not comparable)
ideal	Adjective	ideal (comparative more ideal, superlative most ideal)
syn	Adjective	syn (comparative more syn, superlative most syn)
neutral	Adjective	neutral (comparative more neutral, superlative most neutral)
citron	Adjective	citron (comparative more citron, superlative most citron)
fine	Adjective	fine (comparative finer, superlative finest)
federation	Adjective	federation (not comparable)
pillier	Adjective	pillier
Elephantine	Adjective	Elephantine (not comparable)
set	Adjective	set (comparative more set, superlative most set)
prudent	Adjective	prudent (comparative more prudent, superlative most prudent)
gamer	Adjective	gamer
acceptant	Adjective	acceptant (comparative more acceptant, superlative most acceptant)
axial	Adjective	axial (comparative more axial, superlative most axial)
humble	Adjective	humble (comparative humbler, superlative humblest)
humble	Adjective	humble (not comparable)
succulent	Adjective	succulent (comparative more succulent, superlative most succulent)
bog	Adjective	bog (comparative bogger, superlative boggest)
complexer	Adjective	complexer
virgin	Adjective	virgin (not comparable)
sensorial	Adjective	sensorial (comparative more sensorial, superlative most sensorial)
fader	Adjective	fader
plantar	Adjective	plantar (comparative more plantar, superlative most plantar)
dolent	Adjective	dolent (comparative more dolent, superlative most dolent)
dental	Adjective	dental (comparative more dental, superlative most dental)
o	Adjective	o
ultimate	Adjective	ultimate (not comparable)
peroral	Adjective	peroral (not comparable)
deltoid	Adjective	deltoid (not comparable)
Deutsch	Adjective	Deutsch (comparative more Deutsch, superlative most Deutsch)
lead	Adjective	lead (not comparable)
apropos	Adjective	apropos (comparative more apropos, superlative most apropos)
exotic	Adjective	exotic (comparative more exotic, superlative most exotic)
stellar	Adjective	stellar (comparative more stellar, superlative most stellar)
Roma	Adjective	Roma (not comparable)
pensill	Adjective	pensill
camper	Adjective	camper
immigrant	Adjective	immigrant (not comparable)
flatter	Adjective	flatter
altern	Adjective	altern (not comparable)
pedant	Adjective	pedant (not comparable)
frank	Adjective	frank (comparative franker, superlative frankest)
fremd	Adjective	fremd (comparative fremder or more fremd, superlative fremdest or most fremd)
wild	Adjective	wild (comparative wilder, superlative wildest)
intern	Adjective	intern (comparative more intern, superlative most intern)
forward	Adjective	forward (comparative more forward, superlative most forward)
avantgarde	Adjective	avantgarde (comparative more avantgarde, superlative most avantgarde)
motor	Adjective	motor (not comparable)
dual	Adjective	dual (not comparable)
delicious	Adjective	delicious (comparative more delicious, superlative most delicious)
lank	Adjective	lank (comparative lanker, superlative lankest)
tenor	Adjective	tenor (not comparable)
marv	Adjective	marv
part	Adjective	part (not comparable)
metro	Adjective	metro (comparative more metro, superlative most metro)
patienter	Adjective	patienter
petulant	Adjective	petulant (comparative more petulant, superlative most petulant)
ap	Adjective	ap (not comparable)
incident	Adjective	incident (not comparable)
western	Adjective	western (not comparable)
fade	Adjective	fade (comparative fader or more fade, superlative fadest or most fade)
fade	Adjective	fade (comparative fader, superlative fadest)
iller	Adjective	iller
excellent	Adjective	excellent (comparative excellenter or more excellent, superlative excellentest or most excellent)
futurist	Adjective	futurist (comparative more futurist, superlative most futurist)
jambu	Adjective	jambu (comparative more jambu, superlative most jambu)
Sami	Adjective	Sami (not comparable)
fraile	Adjective	fraile
stop	Adjective	stop (not comparable)
Afrikaans	Adjective	Afrikaans (not comparable)
relief	Adjective	relief (comparative more relief, superlative most relief)
borian	Adjective	borian (comparative more borian, superlative most borian)
grande	Adjective	grande (not comparable)
renitent	Adjective	renitent (comparative more renitent, superlative most renitent)
strong	Adjective	strong (comparative stronger, superlative strongest)
absolvent	Adjective	absolvent (comparative more absolvent, superlative most absolvent)
cocktail	Adjective	cocktail (comparative more cocktail, superlative most cocktail)
frontal	Adjective	frontal (not comparable)
astral	Adjective	astral (comparative more astral, superlative most astral)
drab	Adjective	drab (comparative drabber, superlative drabbest)
pap	Adjective	pap (comparative more pap, superlative most pap)
pap	Adjective	pap (comparative more pap, superlative most pap)
damn	Adjective	damn (not comparable)
monoaxial	Adjective	monoaxial (not comparable)
blank	Adjective	blank (comparative blanker or more blank, superlative blankest or most blank)
trigonal	Adjective	trigonal (comparative more trigonal, superlative most trigonal)
matt	Adjective	matt
fabular	Adjective	fabular (comparative more fabular, superlative most fabular)
bull	Adjective	bull (not comparable)
foster	Adjective	foster (not comparable)
front	Adjective	front (comparative further front, superlative furthest front)
neat	Adjective	neat (comparative neater, superlative neatest)
good	Adjective	good (comparative better, superlative best)
vaginal	Adjective	vaginal (not comparable)
linked	Adjective	linked (comparative more linked, superlative most linked)
birken	Adjective	birken (not comparable)
anti	Adjective	anti (comparative more anti, superlative most anti)
soporific	Adjective	soporific (comparative more soporific, superlative most soporific)
singular	Adjective	singular (comparative more singular, superlative most singular)
extravagant	Adjective	extravagant (comparative more extravagant, superlative most extravagant)
hende	Adjective	hende (comparative more hende, superlative most hende)
abnormal	Adjective	abnormal (comparative more abnormal, superlative most abnormal)
sober	Adjective	sober (comparative soberer, superlative soberest)
grey	Adjective	grey (comparative greyer, superlative greyest) (often spelled "gray" in the US)
capital	Adjective	capital (not comparable)
second	Adjective	second (not comparable)
imperial	Adjective	imperial (comparative more imperial, superlative most imperial)
lag	Adjective	lag
exterior	Adjective	exterior (not comparable)
component	Adjective	component (not comparable)
brisant	Adjective	brisant (not comparable)
intercalar	Adjective	intercalar (not comparable)
banana	Adjective	banana (not comparable)
pastier	Adjective	pastier
bipolar	Adjective	bipolar (comparative more bipolar, superlative most bipolar)
fair	Adjective	fair (comparative fairer, superlative fairest)
dimensional	Adjective	dimensional (comparative more dimensional, superlative most dimensional)
limit	Adjective	limit (not comparable)
full	Adjective	full (comparative fuller, superlative fullest)
avocado	Adjective	avocado (not comparable)
direct	Adjective	direct (comparative directer, superlative directest)
alerter	Adjective	alerter
sexual	Adjective	sexual (comparative more sexual, superlative most sexual)
cis	Adjective	cis (not comparable)
genius	Adjective	genius (not comparable)
keen	Adjective	keen (comparative keener or more keen, superlative keenest or most keen)
perimortal	Adjective	perimortal (not comparable)
riper	Adjective	riper
nitro	Adjective	nitro (not comparable)
hetero	Adjective	hetero (comparative more hetero, superlative most hetero)
orgastic	Adjective	orgastic (comparative more orgastic, superlative most orgastic)
fat	Adjective	fat (comparative fatter, superlative fattest)
recent	Adjective	recent (comparative more recent, superlative most recent)
abject	Adjective	abject (comparative abjecter or more abject, superlative abjectest or most abject)
illiberal	Adjective	illiberal (comparative more illiberal, superlative most illiberal)
labial	Adjective	labial (not comparable)
journal	Adjective	journal (comparative more journal, superlative most journal)
rampant	Adjective	rampant (comparative more rampant, superlative most rampant)
awol	Adjective	awol (not comparable)
juxtarenal	Adjective	juxtarenal (not comparable)
magenta	Adjective	magenta (comparative more magenta, superlative most magenta)
pedal	Adjective	pedal (comparative more pedal, superlative most pedal)
happening	Adjective	happening (comparative more happening, superlative most happening)
feminal	Adjective	feminal (comparative more feminal, superlative most feminal)
canicular	Adjective	canicular (comparative more canicular, superlative most canicular)
oral	Adjective	oral (not comparable)
gradual	Adjective	gradual (comparative more gradual, superlative most gradual)
perfumy	Adjective	perfumy (comparative more perfumy, superlative most perfumy)
puke	Adjective	puke (not comparable)
illegal	Adjective	illegal (comparative more illegal, superlative most illegal)
so	Adjective	so (not comparable)
tendre	Adjective	tendre (comparative more tendre, superlative most tendre)
bingo	Adjective	bingo (not comparable)
driven	Adjective	driven (comparative more driven, superlative most driven)
elementar	Adjective	elementar (comparative more elementar, superlative most elementar)
verklemmt	Adjective	verklemmt (comparative more verklemmt, superlative most verklemmt)
exact	Adjective	exact (comparative more exact, superlative most exact)
bland	Adjective	bland (comparative blander, superlative blandest)
indigo	Adjective	indigo (comparative more indigo, superlative most indigo)
triplex	Adjective	triplex (not comparable)
fuchsia	Adjective	fuchsia (not comparable)
boring	Adjective	boring (comparative more boring, superlative most boring)
filmed	Adjective	filmed (not comparable)
braver	Adjective	braver
lamer	Adjective	lamer
proportional	Adjective	proportional (comparative more proportional, superlative most proportional)
global	Adjective	global (comparative more global, superlative most global)
citrus	Adjective	citrus (not comparable)
feudal	Adjective	feudal (not comparable)
gud	Adjective	gud
medic	Adjective	medic (not comparable)
unsexy	Adjective	unsexy (comparative unsexier, superlative unsexiest)
secret	Adjective	secret (comparative more secret, superlative most secret)
Maltese	Adjective	Maltese (not comparable)
party	Adjective	party (not comparable)
cochlear	Adjective	cochlear (not comparable)
gross	Adjective	gross (comparative grosser or more gross, superlative grossest or most gross)
Uzbek	Adjective	Uzbek (not comparable)
ultra	Adjective	ultra (comparative more ultra, superlative most ultra)
abrupt	Adjective	abrupt (comparative more abrupt or abrupter, superlative most abrupt or abruptest)
microbiologic	Adjective	microbiologic (not comparable)
domestic	Adjective	domestic (comparative more domestic, superlative most domestic)
prawny	Adjective	prawny (comparative more prawny, superlative most prawny)
tory	Adjective	tory (not comparable)
palmar	Adjective	palmar (comparative more palmar, superlative most palmar)
molle	Adjective	molle (not comparable)
Arab	Adjective	Arab (not comparable)
paprika	Adjective	paprika (comparative more paprika, superlative most paprika)
lacier	Adjective	lacier
granular	Adjective	granular (comparative more granular, superlative most granular)
primer	Adjective	primer (not comparable)
defter	Adjective	defter
kipper	Adjective	kipper (comparative more kipper, superlative most kipper)
diacritic	Adjective	diacritic (comparative more diacritic, superlative most diacritic)
regional	Adjective	regional (not comparable)
fatal	Adjective	fatal (not comparable)
innocenter	Adjective	innocenter
strang	Adjective	strang (comparative stranger, superlative strangest)
andante	Adjective	andante (not comparable)
capitular	Adjective	capitular (not comparable)
virtuoso	Adjective	virtuoso (comparative more virtuoso, superlative most virtuoso)
piercing	Adjective	piercing (comparative more piercing, superlative most piercing)
single	Adjective	single (not comparable)
sexy	Adjective	sexy (comparative sexier, superlative sexiest)
terrorist	Adjective	terrorist (not comparable)
bestial	Adjective	bestial (comparative more bestial, superlative most bestial)
mick	Adjective	mick (comparative more mick, superlative most mick)
problem	Adjective	problem (comparative more problem, superlative most problem)
lame	Adjective	lame (comparative lamer, superlative lamest)
vallar	Adjective	vallar (not comparable)
past	Adjective	past (comparative more past, superlative most past)
capitalist	Adjective	capitalist (comparative more capitalist, superlative most capitalist)
undo	Adjective	undo
primordial	Adjective	primordial (not comparable)
fluid	Adjective	fluid (comparative more fluid, superlative most fluid)
kool	Adjective	kool (comparative kooler, superlative koolest)
brunette	Adjective	brunette (not comparable)
pilot	Adjective	pilot (not comparable)
simular	Adjective	simular (comparative more simular, superlative most simular)
pi	Adjective	pi (not comparable)
starker	Adjective	starker
fele	Adjective	fele (comparative feler, superlative felest)
congruent	Adjective	congruent (comparative more congruent, superlative most congruent)
angular	Adjective	angular (comparative more angular, superlative most angular)
faux	Adjective	faux (not comparable)
pop	Adjective	pop (not comparable)
general	Adjective	general (comparative more general, superlative most general)
negro	Adjective	negro (not comparable)
wee	Adjective	wee (comparative weer, superlative weest)
alluvial	Adjective	alluvial (not comparable)
fonder	Adjective	fonder
specialist	Adjective	specialist (comparative more specialist, superlative most specialist)
breme	Adjective	breme
business	Adjective	business
jokey	Adjective	jokey (comparative more jokey, superlative most jokey)
pandeist	Adjective	pandeist (comparative more pandeist, superlative most pandeist)
antic	Adjective	antic (comparative more antic, superlative most antic)
mated	Adjective	mated (not comparable)
fey	Adjective	fey (comparative more fey, superlative most fey)
fey	Adjective	fey (comparative more fey, superlative most fey)
rosen	Adjective	rosen (comparative more rosen, superlative most rosen)
placer	Adjective	placer (not comparable)
signifer	Adjective	signifer (not comparable)
lakier	Adjective	lakier
split	Adjective	split (not comparable)
lesser	Adjective	lesser
Welsh	Adjective	Welsh (not comparable)
cerebral	Adjective	cerebral (comparative more cerebral, superlative most cerebral)
proto	Adjective	proto (not comparable)
parallel	Adjective	parallel (not comparable)
silver	Adjective	silver (comparative more silver, superlative most silver)
frequenter	Adjective	frequenter
interpolar	Adjective	interpolar (not comparable)
inhuman	Adjective	inhuman (comparative more inhuman, superlative most inhuman)
dapper	Adjective	dapper (comparative dapperer, superlative dapperest)
marish	Adjective	marish (comparative more marish, superlative most marish)
abstract	Adjective	abstract (comparative more abstract or abstracter, superlative most abstract or abstractest)[3]
internationalist	Adjective	internationalist (comparative more internationalist, superlative most internationalist)
tart	Adjective	tart (comparative tarter, superlative tartest)
multipolar	Adjective	multipolar (comparative more multipolar, superlative most multipolar)
superb	Adjective	superb (comparative superber, superlative superbest)
pan	Adjective	pan (not comparable)
brilliant	Adjective	brilliant (comparative more brilliant, superlative most brilliant)
flamingo	Adjective	flamingo (not comparable)
rigid	Adjective	rigid (comparative rigider or more rigid, superlative rigidest or most rigid)
paranormal	Adjective	paranormal (comparative more paranormal, superlative most paranormal)
less	Adjective	less (superlative least)
areal	Adjective	areal (not comparable)
hip	Adjective	hip (comparative hipper, superlative hippest)
witter	Adjective	witter (comparative more witter, superlative most witter)
rad	Adjective	rad (comparative more rad, superlative most rad)
verboten	Adjective	verboten (not comparable)
boned	Adjective	boned (not comparable)
hi	Adjective	hi
fortis	Adjective	fortis (not comparable)
wan	Adjective	wan (comparative wanner, superlative wannest)
base	Adjective	base (comparative baser or more base, superlative basest or most base)
versal	Adjective	versal
militar	Adjective	militar (comparative more militar, superlative most militar)
alert	Adjective	alert (comparative more alert, superlative most alert)
fyrst	Adjective	fyrst
competent	Adjective	competent (comparative more competent, superlative most competent)
potable	Adjective	potable (comparative more potable, superlative most potable)
munificent	Adjective	munificent (comparative more munificent, superlative most munificent)
udal	Adjective	udal (not comparable)
spinal	Adjective	spinal (not comparable)
est	Adjective	est (not comparable)
echt	Adjective	echt (comparative more echt, superlative most echt)
spalt	Adjective	spalt (comparative more spalt, superlative most spalt)
ulterior	Adjective	ulterior (not comparable)
formalist	Adjective	formalist (comparative more formalist, superlative most formalist)
senior	Adjective	senior (comparative more senior, superlative most senior)
bluff	Adjective	bluff (comparative bluffer, superlative bluffest)
ironic	Adjective	ironic (comparative more ironic, superlative most ironic)
Julian	Adjective	Julian
realis	Adjective	realis (not comparable)
hean	Adjective	hean (comparative more hean, superlative most hean)
number	Adjective	number
manipular	Adjective	manipular (comparative more manipular, superlative most manipular)
renal	Adjective	renal (not comparable)
Bengali	Adjective	Bengali (not comparable)
odder	Adjective	odder
els	Adjective	els (not comparable)
de luxe	Adjective	de luxe
veteran	Adjective	veteran (not comparable)
consular	Adjective	consular (not comparable)
horizontal	Adjective	horizontal (comparative more horizontal, superlative most horizontal)
vegetarian	Adjective	vegetarian (comparative more vegetarian, superlative most vegetarian)
crack	Adjective	crack (not comparable)
metal	Adjective	metal (comparative more metal, superlative most metal)
bicolor	Adjective	bicolor
filar	Adjective	filar (comparative more filar, superlative most filar)
alkaloid	Adjective	alkaloid (comparative more alkaloid, superlative most alkaloid)
gram	Adjective	gram (comparative more gram, superlative most gram)
dominant	Adjective	dominant (comparative more dominant, superlative most dominant)
integral	Adjective	integral (comparative more integral, superlative most integral)
delitable	Adjective	delitable (comparative more delitable, superlative most delitable)
frigid	Adjective	frigid (comparative frigider or more frigid, superlative frigidest or most frigid)
gravid	Adjective	gravid (comparative more gravid, superlative most gravid)
fulminant	Adjective	fulminant (not comparable)
panic	Adjective	panic (comparative more panic, superlative most panic)
para	Adjective	para (comparative more para, superlative most para)
over	Adjective	over (not comparable)
sure	Adjective	sure (comparative surer, superlative surest)
gear	Adjective	gear (comparative more gear, superlative most gear)
indiscreet	Adjective	indiscreet (comparative more indiscreet, superlative most indiscreet)
bi	Adjective	bi (not comparable)
ignorant	Adjective	ignorant (comparative ignoranter or more ignorant, superlative ignorantest or most ignorant)
hospital	Adjective	hospital (comparative more hospital, superlative most hospital)
extremist	Adjective	extremist (comparative more extremist, superlative most extremist)
sane	Adjective	sane (comparative saner, superlative sanest)
emotional	Adjective	emotional (comparative more emotional, superlative most emotional)
mank	Adjective	mank (not comparable)
infirmer	Adjective	infirmer
riant	Adjective	riant (comparative more riant, superlative most riant)
Fabian	Adjective	Fabian (comparative more Fabian, superlative most Fabian)
lil	Adjective	lil
gry	Adjective	gry (not comparable)
boxen	Adjective	boxen (comparative more boxen, superlative most boxen)
extern	Adjective	extern (comparative more extern, superlative most extern)
longer	Adjective	longer
magistral	Adjective	magistral (comparative more magistral, superlative most magistral)
consistent	Adjective	consistent (comparative more consistent, superlative most consistent)
postmodern	Adjective	postmodern (comparative more postmodern, superlative most postmodern)
volar	Adjective	volar (comparative more volar, superlative most volar)
pay	Adjective	pay (not comparable)
ditrigonal	Adjective	ditrigonal (not comparable)
slicken	Adjective	slicken (comparative more slicken, superlative most slicken)
legal	Adjective	legal (comparative more legal, superlative most legal)
kam	Adjective	kam (not comparable)
period	Adjective	period (not comparable)
irrelevant	Adjective	irrelevant (comparative more irrelevant, superlative most irrelevant)
patient	Adjective	patient (comparative patienter or more patient, superlative patientest or most patient)
emo	Adjective	emo (comparative more emo, superlative most emo)
respondent	Adjective	respondent (comparative more respondent, superlative most respondent)
lo	Adjective	lo (not comparable)
brusquer	Adjective	brusquer
uvular	Adjective	uvular (not comparable)
lekker	Adjective	lekker (comparative more lekker, superlative most lekker)
anormal	Adjective	anormal (comparative more anormal, superlative most anormal)
territorial	Adjective	territorial (comparative more territorial, superlative most territorial)
joint	Adjective	joint (not comparable)
road	Adjective	road (not comparable)
logier	Adjective	logier
local	Adjective	local (comparative more local, superlative most local)
systemoid	Adjective	systemoid (not comparable)
champagne	Adjective	champagne (not comparable)
stark	Adjective	stark (comparative starker, superlative starkest)
blind	Adjective	blind (comparative blinder, superlative blindest)
unorthodox	Adjective	unorthodox (comparative more unorthodox, superlative most unorthodox)
brutal	Adjective	brutal (comparative more brutal, superlative most brutal)
pragmatist	Adjective	pragmatist (comparative more pragmatist, superlative most pragmatist)
sup	Adjective	sup (not comparable)
bourgeois	Adjective	bourgeois (comparative more bourgeois, superlative most bourgeois)
biologic	Adjective	biologic (not comparable)
diet	Adjective	diet (not comparable)
toxic	Adjective	toxic (comparative more toxic, superlative most toxic)
frigider	Adjective	frigider
eng	Adjective	eng
laden	Adjective	laden (comparative more laden, superlative most laden)
furzen	Adjective	furzen (comparative more furzen, superlative most furzen)
mute	Adjective	mute (comparative muter, superlative mutest)
surd	Adjective	surd (comparative more surd, superlative most surd)
scrotal	Adjective	scrotal (not comparable)
bronzer	Adjective	bronzer
long	Adjective	long (comparative longer, superlative longest)
long	Adjective	long (not comparable)
OS	Adjective	OS (not comparable)
excelsior	Adjective	excelsior (not comparable)
fantom	Adjective	fantom (not comparable)
Marxist	Adjective	Marxist (not comparable)
manila	Adjective	manila
man	Adjective	man (not comparable)
poll	Adjective	poll
irrational	Adjective	irrational (comparative more irrational, superlative most irrational)
solemn	Adjective	solemn (comparative more solemn, superlative most solemn)
hexagonal	Adjective	hexagonal (not comparable)
regal	Adjective	regal (comparative more regal, superlative most regal)
certain	Adjective	certain (comparative more certain, superlative most certain)
kaput	Adjective	kaput (not comparable)
commuter	Adjective	commuter (not comparable)
sech	Adjective	sech (comparative more sech, superlative most sech)
gay	Adjective	gay (comparative gayer, superlative gayest)
land	Adjective	land (not comparable)
brim	Adjective	brim (comparative more brim, superlative most brim)
lit	Adjective	lit (comparative more lit, superlative most lit)
lit	Adjective	lit (comparative litter or more lit, superlative littest or most lit)
juice	Adjective	juice (not comparable)
locken	Adjective	locken (comparative more locken, superlative most locken)
ruder	Adjective	ruder
mandarin	Adjective	mandarin (comparative more mandarin, superlative most mandarin)
ape	Adjective	ape (not comparable)
male	Adjective	male (not comparable)
albino	Adjective	albino (not comparable)
hidden	Adjective	hidden (comparative more hidden, superlative most hidden)
smoking	Adjective	smoking (comparative more smoking, superlative most smoking)
medium	Adjective	medium (not comparable)
german	Adjective	german (comparative more german, superlative most german)
Roman	Adjective	Roman (comparative more Roman, superlative most Roman)
lotsa	Adjective	lotsa (not comparable)
dualist	Adjective	dualist (not comparable)
flux	Adjective	flux (not comparable)
safer	Adjective	safer
remiss	Adjective	remiss (not comparable)
random	Adjective	random (comparative more random, superlative most random)
piano	Adjective	piano (comparative more piano, superlative most piano)
underground	Adjective	underground (comparative more underground, superlative most underground)
Kosovan	Adjective	Kosovan (comparative more Kosovan, superlative most Kosovan)
vaguer	Adjective	vaguer
maximal	Adjective	maximal
monumental	Adjective	monumental (comparative more monumental, superlative most monumental)
Bacchanal	Adjective	Bacchanal (comparative more Bacchanal, superlative most Bacchanal)
ital	Adjective	ital (not comparable)
subsonic	Adjective	subsonic (not comparable)
glatt	Adjective	glatt (not comparable)
nonchalant	Adjective	nonchalant (comparative more nonchalant, superlative most nonchalant)
dir	Adjective	dir (not comparable)
botanic	Adjective	botanic (not comparable)
hardy	Adjective	hardy (comparative hardier, superlative hardiest)
positiver	Adjective	positiver
null	Adjective	null (comparative more null, superlative most null)
turbulent	Adjective	turbulent (comparative more turbulent, superlative most turbulent)
chiral	Adjective	chiral (not comparable)
wole	Adjective	wole (comparative more wole, superlative most wole)
central	Adjective	central (comparative more central, superlative most central)
particular	Adjective	particular (comparative more particular, superlative most particular) (also non-comparable)
neuter	Adjective	neuter (not comparable)
ardent	Adjective	ardent (comparative more ardent, superlative most ardent)
east	Adjective	east (not comparable)
paradoxal	Adjective	paradoxal (comparative more paradoxal, superlative most paradoxal)
loden	Adjective	loden (comparative more loden, superlative most loden)
simplex	Adjective	simplex (not comparable)
aero	Adjective	aero (comparative more aero, superlative most aero)
lateral	Adjective	lateral (comparative more lateral, superlative most lateral)
mass	Adjective	mass (not comparable)
timid	Adjective	timid (comparative timider, superlative timidest)
attent	Adjective	attent (comparative more attent, superlative most attent)
spiral	Adjective	spiral (not comparable)
rotten	Adjective	rotten (comparative rottener or more rotten, superlative rottenest or most rotten)
arid	Adjective	arid (comparative arider or more arid, superlative aridest or most arid)
best	Adjective	best
gut	Adjective	gut (comparative more gut, superlative most gut)
master	Adjective	master (not comparable)
neg	Adjective	neg (not comparable)
histologic	Adjective	histologic (not comparable)
swack	Adjective	swack (comparative swacker, superlative swackest)
impertinent	Adjective	impertinent (comparative more impertinent, superlative most impertinent)
vulg	Adjective	vulg (not comparable)
mangier	Adjective	mangier
med	Adjective	med (not comparable)
prestige	Adjective	prestige (not comparable)
lunatic	Adjective	lunatic (comparative more lunatic, superlative most lunatic)
filial	Adjective	filial (comparative more filial, superlative most filial)
jumbo	Adjective	jumbo (not comparable)
vincular	Adjective	vincular (not comparable)
filtered	Adjective	filtered (comparative more filtered, superlative most filtered)
cat	Adjective	cat (not comparable)
intestinal	Adjective	intestinal (not comparable)
macrocephalus	Adjective	macrocephalus (not comparable)
afta	Adjective	afta (not comparable)
ben	Adjective	ben (comparative benner, superlative benmost)
ben	Adjective	ben (comparative benar, superlative benat)
humanist	Adjective	humanist (not comparable)
molar	Adjective	molar (not comparable)
molar	Adjective	molar (not comparable)
aorist	Adjective	aorist (not comparable)
testicular	Adjective	testicular (not comparable)
statist	Adjective	statist (comparative more statist, superlative most statist)
blinder	Adjective	blinder
nigh	Adjective	nigh (comparative nigher or more nigh, superlative nighest or most nigh)
nex	Adjective	nex
Siamese	Adjective	Siamese (comparative more Siamese, superlative most Siamese)
contenter	Adjective	contenter
loial	Adjective	loial (comparative more loial, superlative most loial)
purist	Adjective	purist (comparative more purist, superlative most purist)
suppler	Adjective	suppler
rotund	Adjective	rotund (comparative rotunder, superlative rotundest)
premier	Adjective	premier (not comparable)
purum	Adjective	purum (not comparable)
distal	Adjective	distal (comparative more distal, superlative most distal)
ataraxic	Adjective	ataraxic (comparative more ataraxic, superlative most ataraxic)
guttural	Adjective	guttural (comparative more guttural, superlative most guttural)
worst	Adjective	worst
cliver	Adjective	cliver
mega	Adjective	mega (not comparable)
violent	Adjective	violent (comparative violenter or more violent, superlative violentest or most violent)
permanent	Adjective	permanent (comparative more permanent, superlative most permanent)
major	Adjective	major (comparative more major, superlative most major)
dirigent	Adjective	dirigent (not comparable)
desi	Adjective	desi (comparative more desi, superlative most desi)
emerita	Adjective	emerita (not comparable)
human	Adjective	human (comparative more human, superlative most human)
inner	Adjective	inner (not generally comparable, comparative, superlative innermost)
abundant	Adjective	abundant (comparative more abundant, superlative most abundant)
grill	Adjective	grill (comparative griller or more grill, superlative grillest or most grill)
ope	Adjective	ope (comparative more ope, superlative most ope)
rival	Adjective	rival (not comparable)
crosser	Adjective	crosser
counter	Adjective	counter (not comparable)
Tatar	Adjective	Tatar (comparative more Tatar, superlative most Tatar)
vermeil	Adjective	vermeil (comparative more vermeil, superlative most vermeil)
secrete	Adjective	secrete (not comparable)
mortal	Adjective	mortal (comparative more mortal, superlative most mortal)
principal	Adjective	principal (comparative more principal, superlative most principal)
diagonal	Adjective	diagonal (not comparable)
outen	Adjective	outen (comparative more outen, superlative most outen)
export	Adjective	export (not comparable)
elder	Adjective	elder
cosmic	Adjective	cosmic (comparative more cosmic, superlative most cosmic)
rong	Adjective	rong (comparative more rong, superlative most rong)
neon	Adjective	neon (not comparable)
killing	Adjective	killing (comparative more killing, superlative most killing)
finer	Adjective	finer
spicy	Adjective	spicy (comparative spicier, superlative spiciest)
fondant	Adjective	fondant (not comparable)
perse	Adjective	perse
vice	Adjective	vice (not comparable)
Székely	Adjective	Székely (not comparable)
salten	Adjective	salten (comparative more salten, superlative most salten)
ocker	Adjective	ocker (comparative more ocker, superlative most ocker)
prat	Adjective	prat (comparative more prat, superlative most prat)
ambient	Adjective	ambient (comparative more ambient, superlative most ambient)
trivial	Adjective	trivial (comparative more trivial, superlative most trivial)
rotular	Adjective	rotular (comparative more rotular, superlative most rotular)
terminal	Adjective	terminal (not comparable)
turbo	Adjective	turbo (not comparable)
fem	Adjective	fem (comparative more fem, superlative most fem)
fab	Adjective	fab (comparative fabber, superlative fabbest)
dorsal	Adjective	dorsal (not comparable)
animal	Adjective	animal (not comparable)
slipover	Adjective	slipover (not comparable)
junior	Adjective	junior (not generally comparable, comparative more junior, superlative most junior)
decimal	Adjective	decimal (not comparable)
arsenian	Adjective	arsenian (comparative more arsenian, superlative most arsenian)
touchier	Adjective	touchier
copular	Adjective	copular (not comparable)
Haken	Adjective	Haken (not comparable)
bedoven	Adjective	bedoven (not comparable)
brag	Adjective	brag (comparative bragger, superlative braggest)
festlich	Adjective	festlich (comparative more festlich, superlative most festlich)
halcyon	Adjective	halcyon (comparative more halcyon, superlative most halcyon)
pissier	Adjective	pissier
determinant	Adjective	determinant (comparative more determinant, superlative most determinant)
ae	Adjective	ae (not comparable)
mental	Adjective	mental (not comparable)
mental	Adjective	mental (not comparable)
immanent	Adjective	immanent (comparative more immanent, superlative most immanent)
activist	Adjective	activist (comparative more activist, superlative most activist)
passé	Adjective	passé (comparative more passé, superlative most passé)
paraconsistent	Adjective	paraconsistent (not comparable)
multigenus	Adjective	multigenus (not comparable)
nudist	Adjective	nudist (not comparable)
profaner	Adjective	profaner
titular	Adjective	titular (not comparable)
golden	Adjective	golden (comparative more golden or goldener, superlative most golden or goldenest)
senile	Adjective	senile (comparative more senile, superlative most senile)
rural	Adjective	rural (comparative more rural, superlative most rural)
tabloid	Adjective	tabloid (not comparable)
audio	Adjective	audio (not comparable)
out	Adjective	out (not comparable)
zen	Adjective	zen (comparative more zen, superlative most zen)
bedrunken	Adjective	bedrunken (comparative more bedrunken, superlative most bedrunken)
hea	Adjective	hea (not comparable)
perfect	Adjective	perfect (comparative perfecter or more perfect, superlative perfectest or most perfect)
pallier	Adjective	pallier
color	Adjective	color (not comparable) (American)
soon	Adjective	soon (comparative sooner, superlative soonest)
flaming	Adjective	flaming (comparative more flaming, superlative most flaming)
terser	Adjective	terser
prim	Adjective	prim (comparative primmer, superlative primmest)
bronzen	Adjective	bronzen (comparative more bronzen, superlative most bronzen)
ono	Adjective	ono (comparative more ono, superlative most ono)
cool	Adjective	cool (comparative cooler, superlative coolest)
flamboyant	Adjective	flamboyant (comparative more flamboyant, superlative most flamboyant)
sulfur	Adjective	sulfur (comparative more sulfur, superlative most sulfur)
analogic	Adjective	analogic (not comparable)
empiric	Adjective	empiric
pink	Adjective	pink (comparative pinker, superlative pinkest)
pink	Adjective	pink (not comparable)
braille	Adjective	braille (not comparable)
dry	Adjective	dry (comparative drier or dryer, superlative driest or dryest)
ovular	Adjective	ovular (comparative more ovular, superlative most ovular)
deltoideus	Adjective	deltoideus (not comparable)
prominent	Adjective	prominent (comparative more prominent, superlative most prominent)
Arm	Adjective	Arm
tor	Adjective	tor (comparative more tor, superlative most tor)
torent	Adjective	torent (comparative more torent, superlative most torent)
handled	Adjective	handled (not comparable)
kind	Adjective	kind (comparative kinder, superlative kindest)
soused	Adjective	soused (comparative more soused, superlative most soused)
sare	Adjective	sare (comparative sarer, superlative sarest)
quadruplex	Adjective	quadruplex (not comparable)
omniscient	Adjective	omniscient (not comparable)
Buddhist	Adjective	Buddhist (comparative more Buddhist, superlative most Buddhist)
minimum	Adjective	minimum (not comparable)
gemütlich	Adjective	gemütlich (comparative more gemütlich, superlative most gemütlich)
dissonant	Adjective	dissonant (comparative more dissonant, superlative most dissonant)
aerobic	Adjective	aerobic (not comparable)
gilden	Adjective	gilden (comparative more gilden, superlative most gilden)
trig	Adjective	trig (comparative trigger, superlative triggest)
tall	Adjective	tall (comparative taller, superlative tallest)
lento	Adjective	lento (comparative more lento, superlative most lento)
fugal	Adjective	fugal (not comparable)
violet	Adjective	violet (comparative violeter, superlative violetest)
fretten	Adjective	fretten (comparative more fretten, superlative most fretten)
wode	Adjective	wode (comparative woder, superlative wodest)
ellipsoid	Adjective	ellipsoid (comparative more ellipsoid, superlative most ellipsoid)
jade	Adjective	jade (not comparable)
mutant	Adjective	mutant (not comparable)
evergreen	Adjective	evergreen (not comparable)
smiley	Adjective	smiley (comparative smilier, superlative smiliest)
alar	Adjective	alar (not comparable)
pregnant	Adjective	pregnant (comparative more pregnant, superlative most pregnant)
Peking	Adjective	Peking (not comparable)
blady	Adjective	blady (comparative more blady, superlative most blady)
alveolar	Adjective	alveolar (not comparable)
adamant	Adjective	adamant (comparative more adamant, superlative most adamant)
unit	Adjective	unit (not comparable)
apod	Adjective	apod (not comparable)
cervical	Adjective	cervical (not comparable)
empire	Adjective	empire (not comparable)
Latina	Adjective	Latina (not comparable)
net	Adjective	net (not comparable)
blond	Adjective	blond (comparative blonder or more blond, superlative blondest or most blond)
bitter	Adjective	bitter (comparative bitterer or more bitter, superlative bitterest or most bitter)
Rom	Adjective	Rom (not comparable)
moral	Adjective	moral (comparative more moral, superlative most moral)
drunken	Adjective	drunken (comparative more drunken, superlative most drunken)
broad	Adjective	broad (comparative broader, superlative broadest)
maxillar	Adjective	maxillar (not comparable)
amyloid	Adjective	amyloid (comparative more amyloid, superlative most amyloid)
jubilar	Adjective	jubilar (comparative more jubilar, superlative most jubilar)
tough	Adjective	tough (comparative tougher, superlative toughest)
orange	Adjective	orange (comparative oranger or more orange, superlative orangest or most orange)
lief	Adjective	lief (comparative liefer or liever, superlative liefest or lievest)
orf	Adjective	orf
dire	Adjective	dire (comparative direr or more dire, superlative direst or most dire)
nationalist	Adjective	nationalist (comparative more nationalist, superlative most nationalist)
fail	Adjective	fail (comparative more fail, superlative most fail)
Oliver	Adjective	Oliver (comparative more Oliver, superlative most Oliver)
meeter	Adjective	meeter
spartan	Adjective	spartan (comparative more spartan, superlative most spartan)
rapid	Adjective	rapid (comparative more rapid or rapider, superlative most rapid or rapidest)
well	Adjective	well (comparative better, superlative best)
vild	Adjective	vild (comparative more vild, superlative most vild)
case	Adjective	case (not comparable)
infernal	Adjective	infernal (comparative more infernal, superlative most infernal)
mild	Adjective	mild (comparative milder, superlative mildest)
live	Adjective	live (not comparable)
fluvial	Adjective	fluvial (not comparable)
resistent	Adjective	resistent (comparative more resistent, superlative most resistent)
alkin	Adjective	alkin (not comparable)
citerior	Adjective	citerior (not comparable)
protestant	Adjective	protestant (comparative more protestant, superlative most protestant)
propositional	Adjective	propositional (comparative more propositional, superlative most propositional)
ac	Adjective	ac (not comparable)
fain	Adjective	fain (comparative more fain, superlative most fain)
delirant	Adjective	delirant (comparative more delirant, superlative most delirant)
complex	Adjective	complex (comparative more complex, superlative most complex)
identic	Adjective	identic (comparative more identic, superlative most identic) (obsolete)
heah	Adjective	heah (not comparable)
flit	Adjective	flit (comparative more flit, superlative most flit)
radial	Adjective	radial (comparative more radial, superlative most radial)
on	Adjective	on (not comparable)
gey	Adjective	gey (comparative more gey, superlative most gey)
aa	Adjective	aa (comparative more aa, superlative most aa)
aa	Adjective	aa
raven	Adjective	raven (not comparable)
tan	Adjective	tan (comparative tanner, superlative tannest)
endothelial	Adjective	endothelial (not comparable)
