isikuline	Adjective	isikuline (genitive isikulise, partitive isikulist)
pandav	Adjective	pandav (genitive pandava, partitive pandavat)
õhuke	Adjective	õhuke (genitive õhukese, partitive õhukest)
ühiskondlik	Adjective	ühiskondlik (genitive ühiskondliku, partitive ühiskondlikku)
oma	Adjective	oma (not comparable)
naljakas	Adjective	naljakas (genitive naljaka, partitive naljakat)
kaheksas	Adjective	kaheksas (genitive kaheksanda, partitive kaheksandat)
valmis	Adjective	valmis (genitive [please provide], partitive [please provide])
kitsas	Adjective	kitsas (genitive [please provide], partitive [please provide])
sisseütlev	Adjective	sisseütlev (genitive sisseütleva, partitive sisseütlevat)
kaheteistkümnes	Adjective	kaheteistkümnes (genitive [please provide], partitive [please provide])
mõttetu	Adjective	mõttetu (genitive mõttetu, partitive mõttetut)
heteroseksuaalne	Adjective	heteroseksuaalne (genitive [please provide], partitive [please provide])
paljas	Adjective	paljas (genitive palja, partitive paljast)
prii	Adjective	prii (genitive prii, partitive priid)
musta	Adjective	musta
imelik	Adjective	imelik (genitive imeliku, partitive imelikku)
luterlik	Adjective	luterlik (genitive luterliku, partitive luterlikku)
armuline	Adjective	armuline (genitive armulise, partitive armulist)
tuline	Adjective	tuline (genitive tulise, partitive tulist)
armas	Adjective	armas (genitive armsa, partitive armsat or armast, comparative armsam, superlative kõige armsam or armsaim)
kurba	Adjective	kurba
maskuliin	Adjective	maskuliin (genitive [please provide], partitive [please provide])
langev	Adjective	langev (genitive langeva, partitive langevat)
nõrk	Adjective	nõrk (genitive nõrga, partitive nõrka)
ühine	Adjective	ühine (genitive ühise, partitive ühist)
vaene	Adjective	vaene (comparative vaesem, superlative kõige vaesem, genitive vaese, partitive vaest)
sihitav	Adjective	sihitav (genitive sihitava, partitive sihitavat)
sisukas	Adjective	sisukas (genitive sisuka, partitive sisukat)
olev	Adjective	olev (genitive oleva, partitive olevat)
mustvalge	Adjective	mustvalge (genitive [please provide], partitive [please provide])
kõrb	Adjective	kõrb (genitive kõrvi, partitive kõrbi)
julm	Adjective	julm (genitive julma, partitive julma)
määr	Adjective	määr (genitive määra, partitive määra)
lame	Adjective	lame (genitive lameda, partitive lamedat)
miljonis	Adjective	miljonis (genitive [please provide], partitive [please provide])
kinni	Adjective	kinni (genitive [please provide], partitive [please provide])
hämar	Adjective	hämar (genitive hämara, partitive hämarat)
vanem	Adjective	vanem (genitive vanema, partitive vanemat)
hull	Adjective	hull (genitive hullu, partitive hullu)
viljatu	Adjective	viljatu (genitive viljatu, partitive viljatut)
mõni	Adjective	mõni (genitive mõne, partitive mõnd)
pisike	Adjective	pisike (genitive pisikese, partitive pisikest)
meene	Adjective	meene (genitive meese, partitive meest)
oimetu	Adjective	oimetu (genitive oimetu, partitive oimetut)
õrn	Adjective	õrn (genitive õrna, partitive õrna)
loll	Adjective	loll (genitive lolli, partitive lolli)
rumal	Adjective	rumal (genitive rumala, partitive rumalat, comparative rumalam, superlative kõige rumalam or rumalaim)
karm	Adjective	karm (genitive karmi, partitive karmi)
süütu	Adjective	süütu (genitive süütu, partitive süütut)
läänemeresoome	Adjective	läänemeresoome (genitive läänemeresoome, partitive läänemeresoomet)
kahekümnes	Adjective	kahekümnes (genitive [please provide], partitive [please provide])
vana	Adjective	vana (genitive vana, partitive vana, comparative vanem, superlative kõige vanem or vanim)
soolane	Adjective	soolane (genitive soolase, partitive soolast, comparative soolasem, superlative kõige soolasem)
rootsi	Adjective	rootsi
lai	Adjective	lai (genitive laia, partitive laia)
sõbralik	Adjective	sõbralik (genitive sõbraliku, partitive sõbralikku, comparative sõbralikum, superlative kõige sõbralikum)
tähelepanematu	Adjective	tähelepanematu (genitive tähelepanematu, partitive tähelepanematut)
kiire	Adjective	kiire (genitive kiire, partitive kiiret, comparative kiirem, superlative kõige kiirem or kiireim)
virka	Adjective	virka
peen	Adjective	peen (genitive peene, partitive peent)
eestikeelne	Adjective	eestikeelne (genitive eestikeelse, partitive eestikeelset)
neljateistkümnes	Adjective	neljateistkümnes (genitive neljateistkümnenda, partitive neljateistkümnendat)
selline	Adjective	selline (genitive sellise, partitive sellist)
hele	Adjective	hele (genitive heleda, partitive heledat)
kirjalik	Adjective	kirjalik (genitive kirjaliku, partitive kirjalikku)
turvaline	Adjective	turvaline (genitive turvalise, partitive turvalist)
ohutu	Adjective	ohutu (genitive ohutu, partitive ohutut)
tegelik	Adjective	tegelik (genitive tegeliku, partitive tegelikku)
lämmi	Adjective	lämmi (genitive lämmi, partitive lämmit)
sama	Adjective	sama (genitive sama, partitive sama)
viieteistkümnes	Adjective	viieteistkümnes (genitive [please provide], partitive [please provide])
kaarjas	Adjective	kaarjas (genitive [please provide], partitive [please provide])
ehe	Adjective	ehe (genitive eheda, partitive ehedat)
vaimukas	Adjective	vaimukas (genitive vaimuka, partitive vaimukat)
paks	Adjective	paks (genitive paksu, partitive paksu)
vastav	Adjective	vastav (genitive vastava, partitive vastavat)
haige	Adjective	haige (genitive haige, partitive haiget)
uus	Adjective	uus (genitive uue, partitive uut)
kolmeteistkümnes	Adjective	kolmeteistkümnes (genitive [please provide], partitive [please provide])
lell	Adjective	lell (genitive lelle, partitive lelle)
ülbe	Adjective	ülbe (genitive ülbe, partitive ülbe)
parem	Adjective	parem (genitive parema, partitive paremat)
seesugune	Adjective	seesugune (genitive seesuguse, partitive seesugust)
pornograafiline	Adjective	pornograafiline (genitive pornograafilise, partitive pornograafilist)
vaikne	Adjective	vaikne (genitive vaikse, partitive vaikset)
ütlev	Adjective	ütlev (genitive ütleva, partitive ütlevat)
oranž	Adjective	oranž (genitive [please provide], partitive [please provide])
paha	Adjective	paha (genitive paha, partitive paha)
tavaline	Adjective	tavaline (genitive tavalise, partitive tavalist, comparative tavalisem, superlative kõige tavalisem)
lihaseline	Adjective	lihaseline (genitive lihaselise, partitive lihaselist, comparative lihaselisem, superlative kõige lihaselisem)
pika	Adjective	pika
noor	Adjective	noor (genitive noore, partitive noort, comparative noorem, superlative kõige noorem or noorim)
kodune	Adjective	kodune (genitive koduse, partitive kodust)
vale	Adjective	vale (genitive vale, partitive valet)
eesti	Adjective	eesti (genitive eesti, partitive eesti)
tuhandes	Adjective	tuhandes (genitive [please provide], partitive [please provide])
hall	Adjective	hall (genitive halli, partitive halli)
surematu	Adjective	surematu (genitive surematu, partitive surematut)
kauge	Adjective	kauge (genitive kauge, partitive kauget)
värske	Adjective	värske (genitive värske, partitive värsket)
raske	Adjective	raske (genitive raske, partitive rasket)
tõeline	Adjective	tõeline (genitive tõelise, partitive tõelist, comparative tõelisem, superlative kõige tõelisem)
roheline	Adjective	roheline (genitive rohelise, partitive rohelist, comparative rohelisem, superlative kõige rohelisem)
suur	Adjective	suur (genitive suure, partitive suurt, comparative suurem, superlative kõige suurem or suurim)
süva	Adjective	süva (genitive süva, partitive süva, comparative süvem, superlative kõige süvem or süvim)
kuldne	Adjective	kuldne (genitive [please provide], partitive [please provide])
endine	Adjective	endine (genitive endise, partitive endist)
karvane	Adjective	karvane (genitive karvase, partitive karvast)
õige	Adjective	õige (genitive õige, partitive õiget)
oluline	Adjective	oluline (genitive olulise, partitive olulist, comparative olulisem, superlative kõige olulisem or olulisim)
lahja	Adjective	lahja (genitive lahja, partitive lahjat, comparative lahjem, superlative kõige lahjem)
usklik	Adjective	usklik (genitive uskliku, partitive usklikku)
lõbus	Adjective	lõbus (genitive lõbusa, partitive lõbusat)
tüüne	Adjective	tüüne (genitive tüüne, partitive tüünet)
kohane	Adjective	kohane (genitive kohase, partitive kohast)
alalütlev	Adjective	alalütlev (genitive alalütleva, partitive alalütlevat)
sisemine	Adjective	sisemine (genitive sisemise, partitive sisemist)
mitu	Adjective	mitu (genitive mitme, partitive mitut)
hea	Adjective	hea (genitive hea, partitive head, comparative parem, superlative kõige parem or parim)
valge	Adjective	valge (genitive valge, partitive valget)
maine	Adjective	maine (genitive maise, partitive maist)
taoline	Adjective	taoline (genitive taolise, partitive taolist)
puhas	Adjective	puhas (genitive puhta, partitive puhast)
kaheksateistkümnes	Adjective	kaheksateistkümnes (genitive [please provide], partitive [please provide])
ümar	Adjective	ümar (genitive ümara, partitive ümarat)
hää	Adjective	hää (genitive hää, partitive hääd)
halva	Adjective	halva
agar	Adjective	agar (genitive agara, partitive agarat)
ohtlik	Adjective	ohtlik (genitive ohtliku, partitive ohtlikku)
omastav	Adjective	omastav (genitive omastava, partitive omastavat)
niisugune	Adjective	niisugune (genitive niisuguse, partitive niisugust)
väeti	Adjective	väeti (genitive väeti, partitive väetit, comparative väetim, superlative kõige väetim or väeteim)
kalli	Adjective	kalli
kannatamatu	Adjective	kannatamatu (genitive kannatamatu, partitive kannatamatut)
homoseksuaalne	Adjective	homoseksuaalne (genitive [please provide], partitive [please provide])
tingiv	Adjective	tingiv (genitive tingiva, partitive tingivat)
kavala	Adjective	kavala
aus	Adjective	aus (genitive ausa, partitive ausat)
kolmas	Adjective	kolmas (genitive kolmanda, partitive kolmandat or kolmat)
raudne	Adjective	raudne (genitive raudse, partitive raudset, comparative raudsem, superlative kõige raudsem or raudseim)
kallis	Adjective	kallis (genitive kalli, partitive kallist)
kollane	Adjective	kollane (genitive kollase, partitive kollast)
kihvt	Adjective	kihvt (genitive kihvti, partitive kihvti)
virga	Adjective	virga
beež	Adjective	beež (genitive [please provide], partitive [please provide])
tarka	Adjective	tarka
haruldane	Adjective	haruldane (genitive haruldase, partitive haruldast, comparative haruldasem, superlative kõige haruldasem)
õnnetu	Adjective	õnnetu (genitive õnnetu, partitive õnnetut)
erootiline	Adjective	erootiline (genitive erootilise, partitive erootilist, comparative erootilisem, superlative kõige erootilisem)
rüütellik	Adjective	rüütellik (genitive rüütelliku, partitive rüütellikku, comparative rüütellikum, superlative kõige rüütellikum or rüütellikem)
kolmnurkne	Adjective	kolmnurkne (genitive [please provide], partitive [please provide])
tuttav	Adjective	tuttav (genitive tuttava, partitive tuttavat)
äge	Adjective	äge (genitive ägeda, partitive ägedam, comparative ägedam, superlative kõige ägedam or ägedaim)
ingellik	Adjective	ingellik (genitive ingelliku, partitive ingellikku, comparative ingellikum, superlative kõige ingellikum or ingellikem)
aeglane	Adjective	aeglane (genitive aeglase, partitive aeglast, comparative aeglasem, superlative kõige aeglasem or aeglaseim)
sügav	Adjective	sügav (genitive sügava, partitive sügavat, comparative sügavam, superlative kõige sügavam or sügavaim)
eriline	Adjective	eriline (genitive erilise, partitive tavalist, comparative tavalisem, superlative kõige tavalisem)
ihar	Adjective	ihar (genitive ihara, partitive iharat)
irratsionaalne	Adjective	irratsionaalne (genitive [please provide], partitive [please provide])
arg	Adjective	arg (genitive ara, partitive arga, comparative arem, superlative kõige arem)
sinine	Adjective	sinine (genitive sinise, partitive sinist)
kuninglik	Adjective	kuninglik (genitive kuningliku, partitive kuninglikku)
preisilik	Adjective	preisilik (genitive preisiliku, partitive preisilikku)
seadus	Adjective	seadus (genitive seadsa, partitive seadsat)
punane	Adjective	punane (genitive punase, partitive punast, comparative punasem, superlative kõige punasem)
kurva	Adjective	kurva
riskantne	Adjective	riskantne (genitive riskantse, partitive riskantset)
kindel	Adjective	kindel (genitive kindla, partitive kindlat)
hüva	Adjective	hüva (genitive hüva, partitive hüva)
soome	Adjective	soome (genitive [please provide], partitive [please provide])
biseksuaalne	Adjective	biseksuaalne (genitive [please provide], partitive [please provide])
igav	Adjective	igav (genitive igava, partitive igavat)
üheksateistkümnes	Adjective	üheksateistkümnes (genitive [please provide], partitive [please provide])
näljane	Adjective	näljane (genitive näljase, partitive näljast)
sajas	Adjective	sajas (genitive [please provide], partitive [please provide])
pikk	Adjective	pikk (genitive pika, partitive pikka, comparative pikem, superlative kõige pikem or pikim)
surnud	Adjective	surnud (genitive singular surnu, partitive singular surnut)
uhke	Adjective	uhke (genitive uhke, partitive uhke)
vene	Adjective	vene (genitive [please provide], partitive [please provide])
läheda	Adjective	läheda (genitive läheda, partitive lähedat, comparative lähem, superlative kõige lähem)
vastne	Adjective	vastne (genitive vastse, partitive vastset)
kõrge	Adjective	kõrge (genitive kõrge, partitive kõrget)
enneaegne	Adjective	enneaegne (genitive enneaegse, partitive enneaegset)
arusaadav	Adjective	arusaadav (genitive arusaadava, partitive arusaadavat)
antonüümne	Adjective	antonüümne (genitive antonüümse, partitive antonüümset)
alaltütlev	Adjective	alaltütlev (genitive alaltütleva, partitive alaltütlevat)
üheteistkümnes	Adjective	üheteistkümnes (genitive [please provide], partitive [please provide])
lapsik	Adjective	lapsik (genitive lapsiku, partitive lapsikut)
kinnine	Adjective	kinnine (genitive [please provide], partitive [please provide])
täis	Adjective	täis (genitive täie, partitive täit)
vägivaldne	Adjective	vägivaldne (genitive vägivaldse, partitive vägivaldset)
selge	Adjective	selge (genitive selge, partitive selget)
ilmaütlev	Adjective	ilmaütlev (genitive ilmaütleva, partitive ilmaütlevat)
kaudne	Adjective	kaudne (genitive kaudse, partitive kaudset)
terve	Adjective	terve (genitive terve, partitive tervet)
truu	Adjective	truu (genitive truu, partitive truud)
jaatav	Adjective	jaatav (genitive jaatava, partitive jaatavat)
kõlblik	Adjective	kõlblik (genitive kõlbliku, partitive kõlblikku)
eakas	Adjective	eakas (genitive eaka, partitive eakat)
paras	Adjective	paras (genitive paraja, partitive parajat or parast)
lamp	Adjective	lamp (genitive lambi, partitive lampi)
lamp	Adjective	lamp (genitive lambi, partitive lampi)
iseseisev	Adjective	iseseisev (genitive iseseisva, partitive iseseisvat)
vastupandamatu	Adjective	vastupandamatu (genitive vastupandamatu, partitive vastupandamatut)
keiserlik	Adjective	keiserlik (genitive keiserliku, partitive keiserlikku)
nimetav	Adjective	nimetav (genitive nimetava, partitive nimetavat)
elav	Adjective	elav (genitive elava, partitive elavat)
eht	Adjective	eht
keskmine	Adjective	keskmine (genitive keskmise, partitive keskmist)
ränk	Adjective	ränk (genitive ränga, partitive ränka)
ilmne	Adjective	ilmne (genitive ilmse, partitive ilmset)
rööpne	Adjective	rööpne (genitive rööpse, partitive rööpset)
harv	Adjective	harv (genitive harva, partitive harva, comparative harvem, superlative kõige harvem)
vastuvõetamatu	Adjective	vastuvõetamatu (genitive vastuvõetamatu, partitive vastuvõetamatut)
saav	Adjective	saav (genitive saava, partitive saavat)
seksuaalne	Adjective	seksuaalne (genitive seksuaalse, partitive seksuaalset)
tõrges	Adjective	tõrges (genitive tõrksa, partitive tõrksat or tõrgest, comparative tõrksam, superlative kõige tõrksam or tõrksaim)
seestütlev	Adjective	seestütlev (genitive seestütleva, partitive seestütlevat)
aseksuaalne	Adjective	aseksuaalne (genitive [please provide], partitive [please provide])
halb	Adjective	halb (genitive halva, partitive halba)
must	Adjective	must (genitive musta, partitive musta)
hell	Adjective	hell (genitive hella, partitive hella)
virk	Adjective	virk (genitive virga, partitive virka)
sinisilmne	Adjective	sinisilmne (genitive sinisilmse, partitive sinisilmset)
nüri	Adjective	nüri (genitive nüri, partitive nüri)
magus	Adjective	magus (genitive magusa, partitive magusat)
tühi	Adjective	tühi (genitive tühja, partitive tühja)
hapu	Adjective	hapu (genitive [please provide], partitive [please provide])
sünonüümne	Adjective	sünonüümne (genitive sünonüümse, partitive sünonüümset)
mehelik	Adjective	mehelik (genitive meheliku, partitive mehelikku)
mehine	Adjective	mehine (genitive mehise, partitive mehist)
lilla	Adjective	lilla (genitive lilla, partitive lillat)
kerge	Adjective	kerge (genitive kerge, partitive kerget)
käskiv	Adjective	käskiv (genitive käskiva, partitive käskivat)
silmakirjalik	Adjective	silmakirjalik (genitive silmakirjaliku, partitive silmakirjalikku)
laisk	Adjective	laisk (genitive laisa, partitive laiska)
vaba	Adjective	vaba (genitive vaba, partitive vaba, comparative vabam, superlative kõige vabam)
laiska	Adjective	laiska
jube	Adjective	jube (genitive jubeda, partitive jubedat)
peenikene	Adjective	peenikene (genitive peenikese, partitive peenikest)
lendav	Adjective	lendav (genitive lendava, partitive lendavat)
erinev	Adjective	erinev (genitive [please provide], partitive [please provide])
kunstlik	Adjective	kunstlik (genitive kunstliku, partitive kunstlikku)
eitav	Adjective	eitav (genitive eitava, partitive eitavat)
tark	Adjective	tark (genitive targa, partitive tarka)
alaleütlev	Adjective	alaleütlev (genitive alaleütleva, partitive alaleütlevat)
peenike	Adjective	peenike (genitive peenikese, partitive peenikest)
odav	Adjective	odav (genitive odava, partitive odavat)
ajalooline	Adjective	ajalooline (genitive ajaloolise, partitive ajaloolist)
osastav	Adjective	osastav (genitive osastava, partitive osastavat)
rikas	Adjective	rikas (comparative rikkam, superlative rikkaim, genitive rikka, partitive rikast)
kaasaütlev	Adjective	kaasaütlev (genitive kaasaütleva, partitive kaasaütlevat)
pakiline	Adjective	pakiline (genitive pakilise, partitive pakilist)
kõva	Adjective	kõva (genitive kõva, partitive kõva)
kuri	Adjective	kuri (genitive kurja, partitive kurja)
sitane	Adjective	sitane (genitive sitase, partitive sitast)
pruun	Adjective	pruun (genitive pruuni, partitive pruuni)
õnnelik	Adjective	õnnelik (genitive õnneliku, partitive õnnelikku, comparative õnnelikum, superlative kõige õnnelikum or õnnelikem)
seitsmeteistkümnes	Adjective	seitsmeteistkümnes (genitive [please provide], partitive [please provide])
endisaegne	Adjective	endisaegne (genitive endisaegse, partitive endisaegset)
tore	Adjective	tore (genitive toreda, partitive toredat)
kurt	Adjective	kurt (genitive kurdi, partitive kurti)
punakas	Adjective	punakas (genitive punaka, partitive punakat, comparative punakam, superlative kõige punakam)
viljakas	Adjective	viljakas (genitive viljaka, partitive viljakat)
ilus	Adjective	ilus (genitive ilusa, partitive ilusat, comparative ilusam, superlative kõige ilusam or ilusaim)
tõene	Adjective	tõene (genitive tõese, partitive tõest)
eri	Adjective	eri (genitive eri, partitive eri)
roosa	Adjective	roosa (genitive roosa, partitive roosat)
kurb	Adjective	kurb (genitive kurva, partitive kurba)
kuueteistkümnes	Adjective	kuueteistkümnes (genitive [please provide], partitive [please provide])
seesütlev	Adjective	seesütlev (genitive seesütleva, partitive seesütlevat)
tugev	Adjective	tugev (genitive tugeva, partitive tugevat)
avar	Adjective	avar (genitive [please provide], partitive [please provide])
kange	Adjective	kange (genitive kange, partitive kanget)
leebe	Adjective	leebe (genitive leebe, partitive leebet)
tasa	Adjective	tasa
ehtne	Adjective	ehtne (genitive ehtsa, partitive ehtsat, comparative ehtsam, superlative kõige ehtsam or ehtsaim)
karske	Adjective	karske (genitive karske, partitive karkset)
absoluutne	Adjective	absoluutne (genitive absoluutse, partitive absoluutset, comparative absoluutsem, superlative kõige absoluutsem or absoluutseim)
külm	Adjective	külm (genitive külma, partitive külma)
märg	Adjective	märg (genitive märja, partitive märga)
madal	Adjective	madal (genitive madala, partitive madalat)
kaunis	Adjective	kaunis (genitive kauni, partitive kaunist)
sage	Adjective	sage (genitive sageda, partitive sagedat)
rajav	Adjective	rajav (genitive rajava, partitive rajavat)
kurvikas	Adjective	kurvikas (genitive kurvika, partitive kurvikat)
viimane	Adjective	viimane (genitive viimase, partitive viimast)
surelik	Adjective	surelik (genitive sureliku, partitive surelikku)
kahekümne esimene	Adjective	kahekümne esimene (genitive [please provide], partitive [please provide])
