naer	Noun	naer (genitive naeru, partitive naeru)
punane kärbseseen	Noun	punane kärbseseen
karp	Noun	karp (genitive karbi, partitive karpi)
karp	Noun	karp (genitive karbi, partitive karpi)
vann	Noun	vann (genitive vanni, partitive vanni)
pung	Noun	pung (genitive [please provide], partitive [please provide])
anarhism	Noun	anarhism (genitive anarhismi, partitive [please provide])
keep	Noun	keep (genitive keebi, partitive keepi)
angerjas	Noun	angerjas (genitive angerja, partitive angerjat)
kael	Noun	kael (genitive kaela, partitive kaela)
toa	Noun	toa
arahnofoobia	Noun	arahnofoobia (genitive [please provide], partitive [please provide])
sisselaskesummuti	Noun	sisselaskesummuti (genitive [please provide], partitive [please provide])
abi	Noun	abi (genitive abi, partitive abi)
kaos	Noun	kaos (genitive kaose, partitive kaost)
kaup	Noun	kaup (genitive kauba, partitive kaupa)
grafiit	Noun	grafiit (genitive [please provide], partitive [please provide])
osmium	Noun	osmium (genitive osmiumi, partitive osmiumi or osmiumit)
punker	Noun	punker (genitive punkri, partitive punkrit)
käskkiri	Noun	käskkiri (genitive [please provide], partitive [please provide])
sõltuvus	Noun	sõltuvus (genitive sõltuvuse, partitive sõltuvust)
kirjutusmasin	Noun	kirjutusmasin (genitive kirjutusmasina, partitive kirjutusmasinat)
vesiveski	Noun	vesiveski (genitive vesiveski, partitive vesiveskid)
mesilane	Noun	mesilane (genitive mesilase, partitive mesilast)
ajaloolane	Noun	ajaloolane (genitive ajaloolase, partitive ajaloolast)
klubi	Noun	klubi (genitive klubi, partitive klubi)
šotlane	Noun	šotlane (genitive šotlase, partitive šotlast)
kohort	Noun	kohort (genitive [please provide], partitive [please provide])
tanner	Noun	tanner (genitive tandri, partitive tandrit)
õlikaste	Noun	õlikaste (genitive [please provide], partitive [please provide])
pindluu	Noun	pindluu (genitive pindluu, partitive pindluud)
õigeusk	Noun	õigeusk (genitive õigeusu, partitive õigeusku)
pesamuna	Noun	pesamuna (genitive [please provide], partitive [please provide])
karihiir	Noun	karihiir (genitive karihiire, partitive karihiirt)
rästik	Noun	rästik (genitive rästiku, partitive rästikut)
žest	Noun	žest (genitive [please provide], partitive [please provide])
langetõbi	Noun	langetõbi (genitive [please provide], partitive [please provide])
ameeriklane	Noun	ameeriklane (genitive ameeriklase, partitive ameeriklast)
minevik	Noun	minevik (genitive mineviku, partitive minevikku)
luteetsium	Noun	luteetsium (genitive luteetsiumi, partitive luteetsiumi or luteetsiumit)
eestlane	Noun	eestlane (genitive eestlase, partitive eestlast)
säde	Noun	säde (genitive [please provide], partitive [please provide])
semikoolon	Noun	semikoolon (genitive [please provide], partitive [please provide])
matt	Noun	matt (genitive [please provide], partitive [please provide])
linna	Noun	linna
hõõtsik	Noun	hõõtsik (genitive hõõtsiku, partitive hõõtsikut)
rubla	Noun	rubla (genitive [please provide], partitive [please provide])
hääl	Noun	hääl (genitive hääle, partitive häält)
žurnaal	Noun	žurnaal (genitive [please provide], partitive [please provide])
ameerika jalgpall	Noun	ameerika jalgpall
taldrik	Noun	taldrik (genitive taldriku, partitive taldrikut)
udu	Noun	udu (genitive [please provide], partitive [please provide])
pesa	Noun	pesa (genitive pesa, partitive pesa)
hirv	Noun	hirv (genitive hirve, partitive hirve)
haigla	Noun	haigla (genitive haigla, partitive haiglat)
klaustrofoobia	Noun	klaustrofoobia (genitive [please provide], partitive [please provide])
voos	Noun	voos (genitive voe, partitive voot)
pöörijoon	Noun	pöörijoon (genitive [please provide], partitive [please provide])
homoseksuaalsus	Noun	homoseksuaalsus (genitive homoseksuaalsuse, partitive homoseksuaalsust)
tselkva	Noun	tselkva (genitive [please provide], partitive [please provide])
keeris	Noun	keeris (genitive [please provide], partitive [please provide])
kontinent	Noun	kontinent (genitive [please provide], partitive [please provide])
matemaatika	Noun	matemaatika (genitive matemaatika, partitive matemaatikat)
pära	Noun	pära (genitive pära, partitive pära)
tegu	Noun	tegu (genitive teo, partitive tegu)
vari	Noun	vari (genitive varju, partitive varju)
höövel	Noun	höövel (genitive höövli, partitive höövlit)
itaallane	Noun	itaallane (genitive itaallase, partitive itaallast)
bussipeatus	Noun	bussipeatus (genitive bussipeatuse, partitive [please provide])
välja	Noun	välja
džinn	Noun	džinn (genitive džinni, partitive džinnit)
džinn	Noun	džinn (genitive džinni, partitive džinnit)
teave	Noun	teave (genitive [please provide], partitive [please provide])
taimer	Noun	taimer (genitive taimeri, partitive taimerit)
põsk	Noun	põsk (genitive põse, partitive põske)
mees	Noun	mees (genitive mehe, partitive meest)
kullassepp	Noun	kullassepp (genitive kullassepa, partitive kullasseppa)
vaesus	Noun	vaesus (genitive vaesuse, partitive vaesust)
rändur	Noun	rändur (genitive ränduri, partitive rändurit)
suguküpsus	Noun	suguküpsus (genitive [please provide], partitive [please provide])
ranne	Noun	ranne (genitive randme, partitive rannet)
tätoveerija	Noun	tätoveerija (genitive tätoveerija, partitive tätoveerijat)
hobu	Noun	hobu (genitive hobu, partitive hobu)
mangaan	Noun	mangaan (genitive [please provide], partitive [please provide])
kukkel	Noun	kukkel (genitive kukli, partitive kuklit)
müüja	Noun	müüja (genitive müüja, partitive müüjat)
kera	Noun	kera (genitive kera, partitive kera)
oda	Noun	oda (genitive oda, partitive oda)
raja	Noun	raja (genitive raja, partitive raja)
taimebiokeemia	Noun	taimebiokeemia (genitive [please provide], partitive [please provide])
südamesõber	Noun	südamesõber (genitive [please provide], partitive [please provide])
muusik	Noun	muusik (genitive muusiku, partitive muusikut)
komme	Noun	komme (genitive kombe, partitive kommet)
amööb	Noun	amööb (genitive [please provide], partitive [please provide])
jalalaba	Noun	jalalaba (genitive jalalaba, partitive jalalaba)
kiiruspiirik	Noun	kiiruspiirik (genitive kiiruspiiriku, partitive kiiruspiirikut)
kilpnääre	Noun	kilpnääre (genitive [please provide], partitive [please provide])
raadium	Noun	raadium (genitive raadiumi, partitive raadiumi or raadiumit)
lantaan	Noun	lantaan (genitive [please provide], partitive [please provide])
homofoobia	Noun	homofoobia (genitive [please provide], partitive [please provide])
aiamaa	Noun	aiamaa (genitive aiamaa, partitive aiamaad)
götiit	Noun	götiit (genitive [please provide], partitive [please provide])
arbuus	Noun	arbuus (genitive arbuusi, partitive arbuusi)
õu	Noun	õu (genitive õue, partitive õue)
araablane	Noun	araablane (genitive araablase, partitive araablast)
ajaleht	Noun	ajaleht (genitive ajalehe, partitive ajalehte)
vinüülplaat	Noun	vinüülplaat (genitive [please provide], partitive [please provide])
köök	Noun	köök (genitive köögi, partitive kööki)
senti	Noun	senti
laul	Noun	laul (genitive laulu, partitive laulu)
ploomipuu	Noun	ploomipuu (genitive ploomipuu, partitive ploomipuud)
heli	Noun	heli (genitive [please provide], partitive [please provide])
hõlm	Noun	hõlm (genitive hõlma, partitive hõlma)
aadel	Noun	aadel (genitive aadli, partitive aadlit)
roodium	Noun	roodium (genitive roodiumi, partitive roodiumi or roodiumit)
mendeleevium	Noun	mendeleevium (genitive mendeleeviumi, partitive mendeleeviumi or mendeleeviumit)
valuuta	Noun	valuuta (genitive [please provide], partitive [please provide])
kalju	Noun	kalju (genitive kalju, partitive kaljut)
kesi	Noun	kesi (genitive kee, partitive kett)
tina	Noun	tina (genitive [please provide], partitive [please provide])
rasunääre	Noun	rasunääre (genitive [please provide], partitive [please provide])
tõrv	Noun	tõrv (genitive [please provide], partitive [please provide])
nisu	Noun	nisu (genitive [please provide], partitive [please provide])
huumor	Noun	huumor (genitive [please provide], partitive [please provide])
kopikas	Noun	kopikas (genitive kopika, partitive kopikat)
uu	Noun	uu (genitive [please provide], partitive [please provide])
doktor	Noun	doktor (genitive doktori, partitive doktorit)
kuul	Noun	kuul (genitive kuuli, partitive kuuli)
kuul	Noun	kuul
värv	Noun	värv (genitive värvi, partitive värvi)
rööbas	Noun	rööbas (genitive rööpa, partitive rööbast)
viinamari	Noun	viinamari (genitive viinamarja, partitive viinamarja)
finiš	Noun	finiš (genitive [please provide], partitive [please provide])
haab	Noun	haab (genitive [please provide], partitive [please provide])
algaja	Noun	algaja (genitive algaja, partitive algajat)
aprikoos	Noun	aprikoos (genitive [please provide], partitive [please provide])
sukka	Noun	sukka
mõtus	Noun	mõtus (genitive [please provide], partitive [please provide])
mitmus	Noun	mitmus (genitive mitmuse, partitive mitmust)
observatoorium	Noun	observatoorium (genitive observatooriumi, partitive observatooriumi or observatooriumit)
juuni	Noun	juuni (genitive juuni, partitive juuni)
seas	Noun	seas
keel	Noun	keel (genitive keele, partitive keelt)
lörts	Noun	lörts (genitive [please provide], partitive [please provide])
kuusk	Noun	kuusk (genitive kuuse, partitive kuuske)
aseksuaalsus	Noun	aseksuaalsus (genitive aseksuaalsuse, partitive aseksuaalsust)
puder	Noun	puder (genitive pudru, partitive putru)
kuninglik mastirida	Noun	kuninglik mastirida (genitive kuningliku mastirea, partitive kuninglikku mastirida)
tulek	Noun	tulek (genitive tuleku, partitive tulekut)
koht	Noun	koht (genitive koha, partitive kohta)
liit	Noun	liit (genitive liidu, partitive liitu)
kont	Noun	kont (genitive kondi, partitive konti)
kaenal	Noun	kaenal (genitive kaenla, partitive kaenalt)
kanarbikukuu	Noun	kanarbikukuu (genitive kanarbikukuu, partitive kanarbikukuud)
kott	Noun	kott (genitive koti, partitive kotti)
kott	Noun	kott (genitive kota, partitive kotta)
indium	Noun	indium (genitive indiumi, partitive indiumi or indiumit)
kasuta	Noun	kasuta
pill	Noun	pill (genitive pilli, partitive pilli)
pill	Noun	pill (genitive pilli, partitive pilli)
sõrmistik	Noun	sõrmistik (genitive [please provide], partitive [please provide])
varrukas	Noun	varrukas (genitive varruka, partitive varrukat)
mammona	Noun	mammona (genitive [please provide], partitive [please provide])
muslim	Noun	muslim (genitive muslimi, partitive muslimit)
võileib	Noun	võileib (genitive [please provide], partitive [please provide])
psühhoanalüüs	Noun	psühhoanalüüs (genitive psühhoanalüüsi, partitive psühhoanalüüsi)
triikimislaud	Noun	triikimislaud (genitive triikimislaua, partitive triikimislauda)
veis	Noun	veis (genitive veise, partitive veist)
mineraloogia	Noun	mineraloogia (genitive mineraloogia, partitive mineraloogiat)
oavars	Noun	oavars (genitive [please provide], partitive [please provide])
sai	Noun	sai (genitive saia, partitive saia)
helilooja	Noun	helilooja (genitive helilooja, partitive heliloojat)
muutus	Noun	muutus (genitive muutuse, partitive muutust)
lehelaba	Noun	lehelaba (genitive [please provide], partitive [please provide])
paokiirus	Noun	paokiirus (genitive [please provide], partitive [please provide])
tüüp	Noun	tüüp (genitive tüübi, partitive tüüpi)
mõrv	Noun	mõrv (genitive mõrva, partitive mõrva)
liide	Noun	liide (genitive [please provide], partitive [please provide])
jagu	Noun	jagu (genitive jao, partitive jagu)
kull	Noun	kull (genitive kulli, partitive kulli)
narr	Noun	narr (genitive [please provide], partitive [please provide])
suvepuhkus	Noun	suvepuhkus (genitive [please provide], partitive [please provide])
keskiga	Noun	keskiga (genitive [please provide], partitive [please provide])
selts	Noun	selts (genitive seltsi, partitive seltsi)
tsee	Noun	tsee (genitive [please provide], partitive [please provide])
šanss	Noun	šanss (genitive [please provide], partitive [please provide])
diameeter	Noun	diameeter (genitive diameetri, partitive diameetrit)
ägiriin	Noun	ägiriin (genitive [please provide], partitive [please provide])
käsipuu	Noun	käsipuu (genitive käsipuu, partitive käsipuud)
lootus	Noun	lootus (genitive lootuse, partitive lootust)
kallas	Noun	kallas (genitive kalda, partitive kallast)
sõrmus	Noun	sõrmus (genitive sõrmuse, partitive sõrmust)
küpress	Noun	küpress (genitive [please provide], partitive [please provide])
taimekeemia	Noun	taimekeemia (genitive [please provide], partitive [please provide])
kokk	Noun	kokk (genitive koka, partitive kokka)
kalastaja	Noun	kalastaja (genitive [please provide], partitive [please provide])
poolmetall	Noun	poolmetall (genitive [please provide], partitive [please provide])
moos	Noun	moos (genitive moosi, partitive [please provide])
psühhiaater	Noun	psühhiaater (genitive psühhiaatri, partitive psühhiaatrit)
kipper	Noun	kipper (genitive kipri, partitive kiprit)
ablutofoobia	Noun	ablutofoobia (genitive [please provide], partitive [please provide])
sangar	Noun	sangar (genitive sangari, partitive sangarit)
rannatool	Noun	rannatool (genitive [please provide], partitive [please provide])
külmkapp	Noun	külmkapp (genitive [please provide], partitive [please provide])
nadu	Noun	nadu (genitive [please provide], partitive [please provide])
liiv	Noun	liiv (genitive liiva, partitive liiva)
pudel	Noun	pudel (genitive pudeli, partitive pudelit)
kaltsiit	Noun	kaltsiit (genitive [please provide], partitive [please provide])
ell	Noun	ell (genitive [please provide], partitive [please provide])
orkester	Noun	orkester (genitive orkestri, partitive orkestrit)
proosa	Noun	proosa (genitive [please provide], partitive [please provide])
krüptoon	Noun	krüptoon (genitive [please provide], partitive [please provide])
adamiit	Noun	adamiit (genitive [please provide], partitive [please provide])
vanusepiir	Noun	vanusepiir (genitive [please provide], partitive [please provide])
kägu	Noun	kägu (genitive käo, partitive kägu)
pooljuht	Noun	pooljuht (genitive [please provide], partitive [please provide])
uks	Noun	uks (genitive ukse, partitive ust)
sõnavabadus	Noun	sõnavabadus (genitive sõnavabaduse, partitive sõnavabadust)
salong	Noun	salong (genitive [please provide], partitive [please provide])
kindral	Noun	kindral (genitive [please provide], partitive [please provide])
okse	Noun	okse (genitive [please provide], partitive [please provide])
arv	Noun	arv (genitive arvu, partitive arvu)
elamine	Noun	elamine (genitive elamise, partitive elamist)
kuritöö	Noun	kuritöö (genitive kuritöö, partitive kuritööd)
kiirgusoht	Noun	kiirgusoht (genitive [please provide], partitive [please provide])
kool	Noun	kool (genitive kooli, partitive kooli)
koi	Noun	koi (genitive koi, partitive koid)
koi	Noun	koi (genitive koi, partitive koid)
loru	Noun	loru (genitive [please provide], partitive [please provide])
konstant	Noun	konstant (genitive [please provide], partitive [please provide])
tütar	Noun	tütar (genitive tütre, partitive tütart)
paas	Noun	paas (genitive [please provide], partitive [please provide])
sakslane	Noun	sakslane (genitive sakslase, partitive sakslast)
vare	Noun	vare (genitive [please provide], partitive [please provide])
varbaküüs	Noun	varbaküüs (genitive [please provide], partitive [please provide])
janu	Noun	janu (genitive janu, partitive janu)
raamatupood	Noun	raamatupood (genitive [please provide], partitive [please provide])
pilt	Noun	pilt (genitive pilt, partitive pildid)
teras	Noun	teras (genitive [please provide], partitive [please provide])
salv	Noun	salv (genitive [please provide], partitive [please provide])
kokaraamat	Noun	kokaraamat (genitive [please provide], partitive [please provide])
ettevõtmine	Noun	ettevõtmine (genitive ettevõtmise, partitive ettevõtmist)
voor	Noun	voor (genitive voore, partitive voort)
voor	Noun	voor (genitive voori, partitive voori)
voor	Noun	voor (genitive vooru, partitive vooru)
merevaik	Noun	merevaik (genitive [please provide], partitive [please provide])
fassaad	Noun	fassaad (genitive [please provide], partitive [please provide])
rehekuu	Noun	rehekuu (genitive rehekuu, partitive rehekuud)
nael	Noun	nael (genitive [please provide], partitive [please provide])
taud	Noun	taud (genitive taudi, partitive taudi)
täring	Noun	täring (genitive [please provide], partitive [please provide])
kõrb	Noun	kõrb (genitive kõrve, partitive kõrbe)
kõrb	Noun	kõrb (genitive kõrbe, partitive kõrbet)
tsirkus	Noun	tsirkus (genitive tsirkuse, partitive tsirkust)
loss	Noun	loss (genitive lossi, partitive lossi)
moor	Noun	moor (genitive [please provide], partitive [please provide])
sool	Noun	sool (genitive soole, partitive soolt)
sool	Noun	sool (genitive soola, partitive soola)
samet	Noun	samet (genitive [please provide], partitive [please provide])
lihakirves	Noun	lihakirves (genitive [please provide], partitive [please provide])
õepoeg	Noun	õepoeg (genitive [please provide], partitive [please provide])
narkar	Noun	narkar (genitive narkari, partitive narkarit)
kink	Noun	kink (genitive kingi, partitive kinki)
kink	Noun	kink (genitive kingu, partitive kinku)
kuup	Noun	kuup (genitive kuubi, partitive kuupi)
tädi	Noun	tädi (genitive tädi, partitive tädi)
kaabel	Noun	kaabel (genitive kaabli, partitive kaablit)
puna	Noun	puna (genitive puna, partitive puna)
põhikool	Noun	põhikool (genitive põhikooli, partitive põhikooli)
magneesium	Noun	magneesium (genitive magneesiumi, partitive magneesiumi or magneesiumit)
aja	Noun	aja
võlur	Noun	võlur (genitive võluri, partitive võlurit)
gee	Noun	gee (genitive [please provide], partitive [please provide])
kaelaside	Noun	kaelaside (genitive [please provide], partitive [please provide])
liige	Noun	liige (genitive liikme, partitive liiget)
hobune	Noun	hobune (genitive hobuse, partitive hobust)
müür	Noun	müür (genitive müüri, partitive müüri)
eelmäng	Noun	eelmäng (genitive eelmängu, partitive eelmängu)
nõges	Noun	nõges (genitive nõgese, partitive nõgest)
juut	Noun	juut (genitive [please provide], partitive [please provide])
supp	Noun	supp (genitive [please provide], partitive [please provide])
vargus	Noun	vargus (genitive varguse, partitive vargust)
vanaadium	Noun	vanaadium (genitive vanaadiumi, partitive vanaadiumi or vanaadiumit)
orhidee	Noun	orhidee (genitive orhidee, partitive orhideed)
reisi	Noun	reisi
hotell	Noun	hotell (genitive [please provide], partitive [please provide])
suurus	Noun	suurus (genitive suuruse, partitive suurust)
mutt	Noun	mutt (genitive muti, partitive mutti)
kõrgus	Noun	kõrgus (genitive kõrguse, partitive kõrgust)
kuninganna	Noun	kuninganna (genitive kuninganna, partitive kuningannat)
oaas	Noun	oaas (genitive [please provide], partitive [please provide])
vanem	Noun	vanem (genitive vanema, partitive vanemat)
põhiseadus	Noun	põhiseadus (genitive põhiseaduse, partitive põhiseadust)
seljaaju	Noun	seljaaju (genitive seljaju, partitive seljaaju)
silmakirjatsus	Noun	silmakirjatsus (genitive silmakirjatsuse, partitive silmakirjatsust)
koolja	Noun	koolja (genitive koolja, partitive koolja)
silmakirjatseja	Noun	silmakirjatseja (genitive silmakirjatseja, partitive silmakirjatsejat)
pee	Noun	pee (genitive [please provide], partitive [please provide])
võrdus	Noun	võrdus (genitive [please provide], partitive [please provide])
lammas	Noun	lammas (genitive lamba, partitive lammast)
peied	Noun	peied (genitive peiede, partitive peiesid)
orientatsioon	Noun	orientatsioon (genitive orientatsiooni, partitive orientatsiooni)
kolmnurk	Noun	kolmnurk (genitive [please provide], partitive [please provide])
jalgratas	Noun	jalgratas (genitive jalgratta, partitive jalgratast)
plika	Noun	plika (genitive plika, partitive plikat)
kirre	Noun	kirre (genitive kirde, partitive kirret)
mesitaru	Noun	mesitaru (genitive mesitaru, partitive mesitaru)
vaarikamahl	Noun	vaarikamahl (genitive [please provide], partitive [please provide])
pööre	Noun	pööre (genitive pöörd, partitive pööret)
varblane	Noun	varblane (genitive varblase, partitive varblast)
lihunik	Noun	lihunik (genitive [please provide], partitive [please provide])
manala	Noun	manala (genitive manala, partitive manalat)
jahimees	Noun	jahimees (genitive jahimehe, partitive jahimeest)
preester	Noun	preester (genitive preestri, partitive preestrit)
reis	Noun	reis (genitive reie, partitive reit)
reis	Noun	reis (genitive reisi, partitive reisi)
tšehhi keel	Noun	tšehhi keel
irratsionaalsus	Noun	irratsionaalsus (genitive [please provide], partitive [please provide])
nakkus	Noun	nakkus (genitive nakkuse, partitive nakkust)
norra keel	Noun	norra keel
meene	Noun	meene (genitive meene, partitive meenet)
grinda	Noun	grinda (genitive grinda, partitive grinda)
linn	Noun	linn (genitive linna, partitive linna)
kirves	Noun	kirves (genitive kirve, partitive kirvest)
grupiseks	Noun	grupiseks (genitive grupiseksi, partitive grupiseksi)
diiler	Noun	diiler (genitive diileri, partitive diilerit)
patt	Noun	patt (genitive patu, partitive pattu)
patt	Noun	patt (genitive pati, partitive patti)
hertsog	Noun	hertsog (genitive hertsogi, partitive hertsogit)
pask	Noun	pask (genitive pasa, partitive paska)
müts	Noun	müts (genitive mütsi, partitive mütsi)
enese	Noun	enese (genitive enese, partitive ennast)
voodi	Noun	voodi (genitive voodi, partitive voodit)
ameriitsium	Noun	ameriitsium (genitive ameriitsiumi, partitive ameriitsiumi or ameriitsiumit)
silmamuna	Noun	silmamuna (genitive [please provide], partitive [please provide])
pojas	Noun	pojas
pada	Noun	pada (genitive paja, partitive pada)
pada	Noun	pada (genitive pada, partitive pada)
šokk	Noun	šokk (genitive [please provide], partitive [please provide])
õiglus	Noun	õiglus (genitive õigluse, partitive õiglust)
kaksisvee	Noun	kaksisvee (genitive [please provide], partitive [please provide])
kolonel	Noun	kolonel (genitive koloneli, partitive koloneli)
raba	Noun	raba (genitive raba, partitive raba)
raba	Noun	raba (genitive raba, partitive raba)
molekulaarbioloogia	Noun	molekulaarbioloogia (genitive [please provide], partitive [please provide])
maailm	Noun	maailm (genitive maailma, partitive maailma)
err	Noun	err (genitive [please provide], partitive [please provide])
nahk	Noun	nahk (genitive naha, partitive nahka)
laid	Noun	laid (genitive laia, partitive laida)
laid	Noun	laid (genitive laiu, partitive laidu)
loll	Noun	loll (genitive lolli, partitive lolli)
kannel	Noun	kannel (genitive kandle, partitive kannelt)
hispaanlane	Noun	hispaanlane (genitive hispaanlase, partitive hispaanlast)
vulkaan	Noun	vulkaan (genitive [please provide], partitive [please provide])
vennapoeg	Noun	vennapoeg (genitive [please provide], partitive [please provide])
vahetusõpilane	Noun	vahetusõpilane (genitive vahetusõpilase, partitive vahetusõpilast)
rubiin	Noun	rubiin (genitive [please provide], partitive [please provide])
sõna	Noun	sõna (genitive sõna, partitive sõna)
skandium	Noun	skandium (genitive skandiumi, partitive skandiumi or skandiumit)
Külm sõda	Noun	Külm sõda
möga	Noun	möga (genitive [please provide], partitive [please provide])
miil	Noun	miil (genitive [please provide], partitive [please provide])
dinosaurus	Noun	dinosaurus (genitive [please provide], partitive [please provide])
suvi	Noun	suvi (genitive suve, partitive suve)
murrak	Noun	murrak (genitive murraku, partitive murrakut)
allveelaev	Noun	allveelaev (genitive [please provide], partitive [please provide])
känguru	Noun	känguru (genitive [please provide], partitive [please provide])
raal	Noun	raal (genitive raali, partitive raali)
prints	Noun	prints (genitive printsi, partitive printsi)
ee	Noun	ee (genitive [please provide], partitive [please provide])
penikoorem	Noun	penikoorem (genitive penikoorma, partitive penikoormat)
krüoliit	Noun	krüoliit (genitive [please provide], partitive [please provide])
libahunt	Noun	libahunt (genitive [please provide], partitive [please provide])
katt	Noun	katt (genitive katu, partitive kattu)
jälg	Noun	jälg (genitive jälje, partitive jälge)
maadlema	Noun	maadlema (da-infinitive maadelda)
pesumasin	Noun	pesumasin (genitive [please provide], partitive [please provide])
histoloogia	Noun	histoloogia (genitive [please provide], partitive [please provide])
kärn	Noun	kärn (genitive kärna, partitive kärna)
küla	Noun	küla (genitive küla, partitive küla)
leelismuldmetall	Noun	leelismuldmetall (genitive [please provide], partitive [please provide])
lipp	Noun	lipp (genitive lipu, partitive lippu)
liblikas	Noun	liblikas (genitive liblika, partitive liblikat)
kiil	Noun	kiil (genitive kiili, partitive kiili)
kiil	Noun	kiil (genitive kiilu, partitive kiilu)
kiil	Noun	kiil (genitive kiilu, partitive kiilu)
apelsinimahl	Noun	apelsinimahl (genitive apelsinimahla, partitive apelsinimahla)
akvaarium	Noun	akvaarium (genitive akvaariumi, partitive akvaariumi or akvaariumit)
vurr	Noun	vurr (genitive [please provide], partitive [please provide])
hambaarst	Noun	hambaarst (genitive hambaarsti, partitive [please provide])
albaania keel	Noun	albaania keel
tulirelv	Noun	tulirelv (genitive tulirelva, partitive tulirelva)
zombi	Noun	zombi (genitive zombi, partitive zombit)
venelane	Noun	venelane (genitive venelase, partitive venelast)
demokraatia	Noun	demokraatia (genitive [please provide], partitive [please provide])
väärisgaas	Noun	väärisgaas (genitive [please provide], partitive [please provide])
seiklus	Noun	seiklus (genitive seikluse, partitive seiklust)
gei	Noun	gei (genitive gei, partitive geid)
kauplus	Noun	kauplus (genitive kaupluse, partitive kauplust)
kalkun	Noun	kalkun (genitive kalkuni, partitive kalkunit)
maks	Noun	maks (genitive maksa, partitive maksa)
maks	Noun	maks (genitive maksu, partitive maksu)
tseerium	Noun	tseerium (genitive tseeriumi, partitive tseeriumi or tseeriumit)
ninasarvik	Noun	ninasarvik (genitive ninasarviku, partitive ninasarvikut)
pangakaart	Noun	pangakaart (genitive pangakaardi, partitive pangakaarti)
pliit	Noun	pliit (genitive pliidi, partitive pliiti)
redel	Noun	redel (genitive redeli, partitive redelit)
väävel	Noun	väävel (genitive väävli, partitive väävlit)
vihm	Noun	vihm (genitive vihma, partitive vihma)
olend	Noun	olend (genitive olendi, partitive olendit)
kukal	Noun	kukal (genitive kukla, partitive kukalt)
torm	Noun	torm (genitive [please provide], partitive [please provide])
kai	Noun	kai (genitive kai, partitive kaid)
vaht	Noun	vaht (genitive vahu, partitive vahtu)
vaht	Noun	vaht (genitive vahi, partitive vahti)
helilaine	Noun	helilaine (genitive [please provide], partitive [please provide])
kord	Noun	kord (genitive korra, partitive korda)
nali	Noun	nali (genitive nalja, partitive nalja)
aerofoobia	Noun	aerofoobia (genitive [please provide], partitive [please provide])
blondiin	Noun	blondiin (genitive [please provide], partitive [please provide])
polüeteen	Noun	polüeteen (genitive [please provide], partitive [please provide])
aur	Noun	aur (genitive auru, partitive auru)
vapiti	Noun	vapiti (genitive vapiti, partitive vapitit)
arve	Noun	arve (genitive arve, partitive arvet)
ööpott	Noun	ööpott (genitive [please provide], partitive [please provide])
herilane	Noun	herilane (genitive herilase, partitive herilast)
ema	Noun	ema (genitive ema, partitive ema)
roim	Noun	roim (genitive roima, partitive roima)
mõrsja	Noun	mõrsja (genitive mõrsja, partitive mõrsjat)
kroom	Noun	kroom (genitive [please provide], partitive [please provide])
keeleteadus	Noun	keeleteadus (genitive keeleteaduse, partitive keeleteadust)
esmaspäev	Noun	esmaspäev (genitive esmaspäeva, partitive esmaspäeva)
pulm	Noun	pulm (genitive pulma, partitive pulma)
laip	Noun	laip (genitive laiba, partitive laipa)
hernes	Noun	hernes (genitive herne, partitive hernest)
kapiteel	Noun	kapiteel (genitive [please provide], partitive [please provide])
suhe	Noun	suhe (genitive [please provide], partitive [please provide])
päring	Noun	päring (genitive päringu, partitive päringut)
vana	Noun	vana (genitive vana, partitive vana)
maakond	Noun	maakond (genitive maakonna, partitive maakonda)
õpetaja	Noun	õpetaja (genitive õpetaja, partitive õpetajat)
kobar	Noun	kobar (genitive kobara, partitive kobarat)
obnubilatsioon	Noun	obnubilatsioon (genitive obnubilatsiooni, partitive obnubilatsiooni)
iste	Noun	iste (genitive [please provide], partitive [please provide])
arseen	Noun	arseen (genitive [please provide], partitive [please provide])
summuti	Noun	summuti (genitive [please provide], partitive [please provide])
suguühe	Noun	suguühe (genitive suguühte, partitive suguühet)
sünnipäev	Noun	sünnipäev (genitive sünnipäeva, partitive [please provide])
vastus	Noun	vastus (genitive vastuse, partitive vastust)
palitu	Noun	palitu (genitive [please provide], partitive [please provide])
pea	Noun	pea (genitive pea, partitive pead)
sipelgas	Noun	sipelgas (genitive sipelga, partitive sipelgat)
üterbium	Noun	üterbium (genitive üterbiumi, partitive üterbiumi or üterbiumit)
kask	Noun	kask (genitive kase, partitive kaske)
viski	Noun	viski (genitive [please provide], partitive [please provide])
alumine ninakarbik	Noun	alumine ninakarbik
lõuna	Noun	lõuna (genitive lõuna, partitive lõunat)
piir	Noun	piir (genitive piiri, partitive piiri)
kotkas	Noun	kotkas (genitive [please provide], partitive [please provide])
õhtu	Noun	õhtu (genitive õhtu, partitive õhtut)
magamiskott	Noun	magamiskott (genitive [please provide], partitive [please provide])
malahhiit	Noun	malahhiit (genitive [please provide], partitive [please provide])
geoloog	Noun	geoloog (genitive [please provide], partitive [please provide])
jalanõu	Noun	jalanõu (genitive jalanõu, partitive jalanõu)
minia	Noun	minia (genitive minia, partitive miniat)
pasknäär	Noun	pasknäär (genitive pasknääri, partitive pasknääri)
äss	Noun	äss (genitive ässa, partitive ässa)
maur	Noun	maur (genitive mauri, partitive mauri)
sisselaskesüsteem	Noun	sisselaskesüsteem (genitive [please provide], partitive [please provide])
kuu	Noun	kuu (genitive kuu, partitive kuud)
kuu	Noun	kuu (genitive [please provide], partitive [please provide])
surmata	Noun	surmata
laev	Noun	laev (genitive laeva, partitive laeva)
kahjutuli	Noun	kahjutuli (genitive [please provide], partitive [please provide])
kaalikas	Noun	kaalikas (genitive kaalika, partitive kaalikat)
lennupilet	Noun	lennupilet (genitive [please provide], partitive [please provide])
kõmr	Noun	kõmr (genitive kõmri, partitive kõmri)
hõljum	Noun	hõljum (genitive hõljumi, partitive hõljumit)
süvameri	Noun	süvameri (genitive [please provide], partitive [please provide])
ralliauto	Noun	ralliauto (genitive [please provide], partitive [please provide])
sõelluu	Noun	sõelluu (genitive sõelluu, partitive sõelluud)
aare	Noun	aare (genitive aarde, partitive aaret)
kolmapäev	Noun	kolmapäev (genitive kolmapäeva, partitive kolmapäeva)
piiga	Noun	piiga (genitive piiga, partitive piigat)
rull	Noun	rull (genitive rulli, partitive rulli)
vihma	Noun	vihma
oliiv	Noun	oliiv (genitive [please provide], partitive [please provide])
vingerpuss	Noun	vingerpuss (genitive vingerpussi, partitive vingerpussi)
rootsi keel	Noun	rootsi keel
balett	Noun	balett (genitive [please provide], partitive [please provide])
lend	Noun	lend (genitive lennu, partitive lendu)
veski	Noun	veski (genitive veski, partitive veskid)
siidiuss	Noun	siidiuss (genitive [please provide], partitive [please provide])
hüdrobotaanika	Noun	hüdrobotaanika (genitive [please provide], partitive [please provide])
hein	Noun	hein (genitive heina, partitive heina)
tegevusnimi	Noun	tegevusnimi (genitive tegevusnime, partitive tegevusnime)
juust	Noun	juust (genitive juustu, partitive juustu)
reede	Noun	reede (genitive reede, partitive reedet)
roos	Noun	roos (genitive [please provide], partitive [please provide])
balustraad	Noun	balustraad (genitive [please provide], partitive [please provide])
oopium	Noun	oopium (genitive oopiumi, partitive oopiumi or oopiumit)
haa	Noun	haa (genitive [please provide], partitive [please provide])
tantaal	Noun	tantaal (genitive [please provide], partitive [please provide])
kiire	Noun	kiire (genitive kiire, partitive kiiret)
mast	Noun	mast (genitive masti, partitive masti)
kukk	Noun	kukk (genitive kuke, partitive kukke)
või	Noun	või (genitive või, partitive võid)
rukkilill	Noun	rukkilill (genitive rukkilille, partitive rukkilille)
kurjategija	Noun	kurjategija (genitive kurjategija, partitive kurjategijat)
piim	Noun	piim (genitive piima, partitive piima)
pihl	Noun	pihl (genitive pihla, partitive pihla)
viipekeel	Noun	viipekeel (genitive [please provide], partitive [please provide])
jõuluöö	Noun	jõuluöö (genitive jõuluöö, partitive jõuluööd)
munandikott	Noun	munandikott (genitive munandikoti, partitive munandikotti)
broom	Noun	broom (genitive [please provide], partitive [please provide])
lahke	Noun	lahke (genitive lahke, partitive lahket)
veli	Noun	veli (genitive velje, partitive velje)
veli (genitive velle, partitive velle)
hoov	Noun	hoov (genitive hoovi, partitive hoovi)
maasika	Noun	maasika
munandi	Noun	munandi
amiid	Noun	amiid (genitive [please provide], partitive [please provide])
köis	Noun	köis (genitive köie, partitive köit)
valgusaasta	Noun	valgusaasta (genitive valgusaasta, partitive valgusaastat)
kunst	Noun	kunst (genitive kunsti, partitive kunsti)
aer	Noun	aer (genitive [please provide], partitive [please provide])
praseodüüm	Noun	praseodüüm (genitive [please provide], partitive [please provide])
nobeelium	Noun	nobeelium (genitive nobeeliumi, partitive nobeeliumi or nobeeliumit)
võrkkest	Noun	võrkkest (genitive võrkkesta, partitive võrkkesta)
küünarluu	Noun	küünarluu (genitive küünarluu, partitive küünarluud)
põlevkivi	Noun	põlevkivi (genitive [please provide], partitive [please provide])
õde	Noun	õde (genitive õe, partitive õde)
järjehoidja	Noun	järjehoidja (genitive järjehoidja, partitive järjehoidjat)
mära	Noun	mära (genitive mära, partitive mära)
alalõug	Noun	alalõug (genitive lõua, partitive lõuga)
žargoon	Noun	žargoon (genitive [please provide], partitive [please provide])
imetaja	Noun	imetaja (genitive imetaja, partitive imetajat)
fluoriit	Noun	fluoriit (genitive [please provide], partitive [please provide])
pauk	Noun	pauk (genitive paugu, partitive pauku)
sõltlane	Noun	sõltlane (genitive sõltlase, partitive sõltlast)
riidekoi	Noun	riidekoi (genitive riidekoi, partitive riidekoid)
raamatukogu	Noun	raamatukogu (genitive raamatukogu, partitive raamatukogu)
eessõna	Noun	eessõna (genitive eessõna, partitive eessõna)
ununpentium	Noun	ununpentium (genitive ununpentiumi, partitive ununpentiumi or ununpentiumit)
aken	Noun	aken (genitive akna, partitive akent)
lehis	Noun	lehis (genitive lehise, partitive lehist)
põhiluu	Noun	põhiluu (genitive põhiluu, partitive põhiluud)
sügis	Noun	sügis (genitive sügise, partitive sügist)
kesakuu	Noun	kesakuu (genitive kesakuu, partitive kesakuud)
valdus	Noun	valdus (genitive valduse, partitive valdust)
huligaan	Noun	huligaan (genitive [please provide], partitive [please provide])
rakubioloogia	Noun	rakubioloogia (genitive [please provide], partitive [please provide])
kabe	Noun	kabe (genitive kabe, partitive kabet)
konn	Noun	konn (genitive konna, partitive konna)
mäng	Noun	mäng (genitive mängu, partitive mängu)
väli	Noun	väli (genitive välja, partitive välja)
ununoktium	Noun	ununoktium (genitive ununoktiumi, partitive ununoktiumi or ununoktiumit)
loe	Noun	loe (genitive loode, partitive loet)
kuningriik	Noun	kuningriik (genitive kuningriigi, partitive kuningriiki)
auk	Noun	auk (genitive augu, partitive auku)
tuupur	Noun	tuupur (genitive tuupuri, partitive tuupurit)
lennuk	Noun	lennuk (genitive lennuki, partitive lennukit)
kronobioloogia	Noun	kronobioloogia (genitive [please provide], partitive [please provide])
haruldus	Noun	haruldus (genitive harulduse, partitive haruldust)
spekulant	Noun	spekulant (genitive spekulandi, partitive spekulanti)
poni	Noun	poni (genitive poni, partitive poni)
formaliin	Noun	formaliin (genitive [please provide], partitive [please provide])
džäss	Noun	džäss (genitive [please provide], partitive [please provide])
optik	Noun	optik (genitive optiku, partitive optikut)
õigus	Noun	õigus (genitive õiguse, partitive õigust)
libekala	Noun	libekala (genitive [please provide], partitive [please provide])
hiinlane	Noun	hiinlane (genitive hiinlase, partitive hiinlast)
retsept	Noun	retsept (genitive [please provide], partitive [please provide])
sina	Noun	sina (genitive sina, partitive sina)
kompass	Noun	kompass (genitive [please provide], partitive [please provide])
amfetamiin	Noun	amfetamiin (genitive [please provide], partitive [please provide])
õhk	Noun	õhk (genitive õhu, partitive õhku)
kaubanduskeskus	Noun	kaubanduskeskus (genitive kaubanduskeskuse, partitive kaubanduskeskust)
kaart	Noun	kaart (genitive kaardi, partitive kaarti)
asukas	Noun	asukas (genitive [please provide], partitive [please provide])
film	Noun	film (genitive filmi, partitive filmi)
juhtkoer	Noun	juhtkoer (genitive juhtkoera, partitive juhtkoera)
geograafia	Noun	geograafia (genitive [please provide], partitive [please provide])
keiser	Noun	keiser (genitive keisri, partitive keisrit)
suus	Noun	suus
lendav taldrik	Noun	lendav taldrik
harmoonia	Noun	harmoonia (genitive [please provide], partitive [please provide])
peaaju	Noun	peaaju (genitive peaaju, partitive peaaju)
soolatüügas	Noun	soolatüügas (genitive soolatüüka, partitive soolatüügast)
hoidja	Noun	hoidja (genitive hoidja, partitive hoidjat)
metsis	Noun	metsis (genitive metsise, partitive metsist)
lõim	Noun	lõim (genitive lõime, partitive lõime)
katse	Noun	katse (genitive katse, partitive katset)
kana	Noun	kana (genitive kana, partitive kana)
tõtt	Noun	tõtt (genitive tõtu, partitive tõttu)
tasku	Noun	tasku (genitive tasku, partitive taskut)
kompott	Noun	kompott (genitive [please provide], partitive [please provide])
kaka	Noun	kaka (genitive kaka, partitive kakat)
juuli	Noun	juuli (genitive juuli, partitive juulit)
lava	Noun	lava (genitive [please provide], partitive [please provide])
toode	Noun	toode (genitive toote, partitive toodet)
hüljes	Noun	hüljes (genitive hülge, partitive hüljest)
rott	Noun	rott (genitive roti, partitive rotti)
kaste	Noun	kaste (genitive kastme, partitive kastet)
kodanlane	Noun	kodanlane (genitive kodanlase, partitive kodanlast)
ingel	Noun	ingel (genitive ingli, partitive inglit)
jaapanlane	Noun	jaapanlane (genitive jaapanlase, partitive jaapanlast)
laama	Noun	laama (genitive [please provide], partitive [please provide])
metroo	Noun	metroo (genitive metroo, partitive [please provide])
mürk	Noun	mürk (genitive mürgi, partitive mürki)
kvarts	Noun	kvarts (genitive [please provide], partitive [please provide])
naaber	Noun	naaber (genitive naabri, partitive naabrit)
lüsergiinhape	Noun	lüsergiinhape (genitive lüsergiinhappe, partitive lüsergiinhpet)
haarem	Noun	haarem (genitive haaremi, partitive haaremit)
vangerdus	Noun	vangerdus (genitive vangerduse, partitive vangerdust)
teadmine	Noun	teadmine (genitive teadmise, partitive teadmist)
möire	Noun	möire (genitive [please provide], partitive [please provide])
gallium	Noun	gallium (genitive galliumi, partitive galliumi or galliumit)
tint	Noun	tint (genitive [please provide], partitive [please provide])
part	Noun	part (genitive pardi, partitive parti)
kirjanik	Noun	kirjanik (genitive kirjaniku, partitive kirjanikku)
kiirendus	Noun	kiirendus (genitive kiirenduse, partitive kiirendust)
hai	Noun	hai (genitive hai, partitive haid)
mäger	Noun	mäger (genitive mägra, partitive mäkra)
ehe	Noun	ehe (genitive ehte, partitive ehet)
vesi	Noun	vesi (genitive vee, partitive vett)
mõis	Noun	mõis (genitive mõisa, partitive mõisat or mõisa)
programmeerimiskeel	Noun	programmeerimiskeel (genitive [please provide], partitive [please provide])
luuta	Noun	luuta
tehneetsium	Noun	tehneetsium (genitive tehneetsiumi, partitive tehneetsiumi or tehneetsiumit)
luuletus	Noun	luuletus (genitive luuletuse, partitive luuletust)
aspiriin	Noun	aspiriin (genitive [please provide], partitive [please provide])
frank	Noun	frank (genitive [please provide], partitive [please provide])
kudu	Noun	kudu (genitive [please provide], partitive [please provide])
saba	Noun	saba (genitive saba, partitive saba)
laulja	Noun	laulja (genitive laulja, partitive lauljat)
keeleluu	Noun	keeleluu (genitive keeleluu, partitive keeleluud)
käsi	Noun	käsi (genitive käe, partitive kätt)
sünoptik	Noun	sünoptik (genitive sünoptiku, partitive sünoptikut)
kadakas	Noun	kadakas (genitive kadaka, partitive kadakat)
einsteinium	Noun	einsteinium (genitive einsteiniumi, partitive einsteiniumi or einsteiniumit)
kosmoloogia	Noun	kosmoloogia (genitive [please provide], partitive [please provide])
sularaha	Noun	sularaha (genitive [please provide], partitive [please provide])
iriidium	Noun	iriidium (genitive iriidiumi, partitive iriidiumi or iriidiumit)
mesi	Noun	mesi (genitive mee, partitive mett)
tsütoloogia	Noun	tsütoloogia (genitive [please provide], partitive [please provide])
joodik	Noun	joodik (genitive joodiku, partitive joodikut)
piiritus	Noun	piiritus (genitive piirituse, partitive piiritust)
pilu	Noun	pilu (genitive pilu, partitive pilu)
reisija	Noun	reisija (genitive reisija, partitive reisijat)
boor	Noun	boor (genitive [please provide], partitive [please provide])
kaun	Noun	kaun (genitive kauna, partitive kauna)
härra	Noun	härra (genitive härra, partitive härrat)
hindi keel	Noun	hindi keel
kohv	Noun	kohv (genitive kohvi, partitive kohvi)
jaaniuss	Noun	jaaniuss (genitive [please provide], partitive [please provide])
laba	Noun	laba (genitive [please provide], partitive [please provide])
buum	Noun	buum (genitive [please provide], partitive [please provide])
usund	Noun	usund (genitive usundi, partitive usundit)
ohver	Noun	ohver (genitive ohvri, partitive ohvrit)
meitneerium	Noun	meitneerium (genitive meitneeriumi, partitive meitneeriumi or meitneeriumit)
rootslane	Noun	rootslane (genitive rootslase, partitive rootslast)
furaan	Noun	furaan (genitive [please provide], partitive [please provide])
vismut	Noun	vismut (genitive [please provide], partitive [please provide])
kolp	Noun	kolp (genitive [please provide], partitive [please provide])
veiniklaas	Noun	veiniklaas (genitive veiniklaasi, partitive [please provide])
isik	Noun	isik (genitive isiku, partitive isikut)
kee	Noun	kee (genitive kee, partitive keed)
vürst	Noun	vürst (genitive vürsti, partitive vürsti)
betoon	Noun	betoon (genitive betooni, partitive betooni)
kama	Noun	kama (genitive kama, partitive kama)
vastlakuu	Noun	vastlakuu (genitive vastlakuu, partitive vastlakuud)
tsirkoonium	Noun	tsirkoonium (genitive tsirkooniumi, partitive tsirkooniumi or tsirkooniumit)
saag	Noun	saag (genitive sae, partitive saagi)
pistrik	Noun	pistrik (genitive pistriku, partitive pistrikku)
arvuti	Noun	arvuti (genitive arvuti, partitive arvutit)
serblane	Noun	serblane (genitive serblane, partitive serblast)
hõimkond	Noun	hõimkond (genitive [please provide], partitive [please provide])
aasta	Noun	aasta (genitive aasta, partitive aastat)
sandaal	Noun	sandaal (genitive [please provide], partitive [please provide])
idee	Noun	idee (genitive idee, partitive ideed)
neer	Noun	neer (genitive [please provide], partitive [please provide])
kobedus	Noun	kobedus (genitive kobeduse, partitive kobedust)
veer	Noun	veer (genitive [please provide], partitive [please provide])
võimalus	Noun	võimalus (genitive võimaluse, partitive võimalust)
hüüumärk	Noun	hüüumärk (genitive hüüumärgi, partitive hüüumärki)
keeristorm	Noun	keeristorm (genitive [please provide], partitive [please provide])
kaasa	Noun	kaasa (genitive kaasa, partitive kaasat)
emakeel	Noun	emakeel (genitive emakeele, partitive emakeelt)
särk	Noun	särk (genitive särgi, partitive särki)
printsiip	Noun	printsiip (genitive [please provide], partitive [please provide])
suudlus	Noun	suudlus (genitive suudluse, partitive suudlust)
tennis	Noun	tennis (genitive tennise, partitive tennist)
ookean	Noun	ookean (genitive ookeani, partitive ookeani)
lust	Noun	lust (genitive lusti, partitive lusti)
orkaan	Noun	orkaan (genitive orkaani, partitive orkaani)
tükk	Noun	tükk (genitive tüki, partitive tükki)
tükk	Noun	tükk (genitive tüki, partitive tükki)
püks	Noun	püks (genitive püksi, partitive püksi)
elulugu	Noun	elulugu (genitive [please provide], partitive [please provide])
king	Noun	king (genitive kinga, partitive kinga)
raha	Noun	raha (genitive raha, partitive raha)
telefoninumber	Noun	telefoninumber (genitive telefoninumbri, partitive telefoninumbrit)
kasv	Noun	kasv (genitive kasvu, partitive kasvu)
aardelaegas	Noun	aardelaegas (genitive aarelaeka, partitive aarelaegast)
jää	Noun	jää (genitive jää, partitive jääd)
piirdeklapp	Noun	piirdeklapp (genitive [please provide], partitive [please provide])
parameeter	Noun	parameeter (genitive parameetri, partitive parameetrit)
piloot	Noun	piloot (genitive [please provide], partitive [please provide])
kadakasakslane	Noun	kadakasakslane (genitive kadakasakslase, partitive kadakasakslast)
major	Noun	major (genitive majori, partitive majorit)
ahi	Noun	ahi (genitive ahju, partitive ahju)
veekeetja	Noun	veekeetja (genitive [please provide], partitive [please provide])
teadus	Noun	teadus (genitive teaduse, partitive teadust)
jäämägi	Noun	jäämägi (genitive [please provide], partitive [please provide])
biokeemia	Noun	biokeemia (genitive [please provide], partitive [please provide])
kapp	Noun	kapp (genitive kapi, partitive kappi)
võilill	Noun	võilill (genitive [please provide], partitive [please provide])
sõrm	Noun	sõrm (genitive sõrme, partitive sõrme)
harjutus	Noun	harjutus (genitive harjutuse, partitive harjutust)
südameinfarkt	Noun	südameinfarkt (genitive [please provide], partitive [please provide])
atlass	Noun	atlass (genitive [please provide], partitive [please provide])
korsten	Noun	korsten (genitive korstna, partitive korstnat)
käpp	Noun	käpp (genitive käpa, partitive käppa)
ahhaat	Noun	ahhaat (genitive [please provide], partitive [please provide])
ükssarvik	Noun	ükssarvik (genitive ükssarviku, partitive ükssarvikut)
mudžahiid	Noun	mudžahiid (genitive mudžahiidi, partitive mudžahiidi)
eff	Noun	eff (genitive [please provide], partitive [please provide])
ökonoomika	Noun	ökonoomika (genitive ökonoomika, partitive ökonoomikat)
äi	Noun	äi (genitive äia, partitive äia)
troon	Noun	troon (genitive [please provide], partitive [please provide])
pankur	Noun	pankur (genitive pankuri, partitive pankurit)
lett	Noun	lett (genitive [please provide], partitive [please provide])
džihaad	Noun	džihaad (genitive džihaadi, partitive džihaadi)
kirsipuu	Noun	kirsipuu (genitive kirsipuu, partitive kirsipuud)
arutelu	Noun	arutelu (genitive arutelu, partitive arutelu)
omand	Noun	omand (genitive [please provide], partitive [please provide])
mets	Noun	mets (genitive metsa, partitive metsa)
pärn	Noun	pärn (genitive pärna, partitive pärna)
jõulukuu	Noun	jõulukuu (genitive jõulukuu, partitive jõulukuud)
brünett	Noun	brünett (genitive [please provide], partitive [please provide])
tibla	Noun	tibla (genitive tibla, partitive tiblat)
imu	Noun	imu (genitive elu, partitive elu)
molübdeen	Noun	molübdeen (genitive [please provide], partitive [please provide])
vaim	Noun	vaim (genitive vaimu, partitive vaimu)
kõrv	Noun	kõrv (genitive kõrva, partitive kõrva)
nöör	Noun	nöör (genitive nööri, partitive nööri)
kakao	Noun	kakao (genitive kakao, partitive kakaod)
seos	Noun	seos (genitive seose, partitive seost)
rong	Noun	rong (genitive rongi, partitive rongi)
vara	Noun	vara (genitive [please provide], partitive [please provide])
kuulutus	Noun	kuulutus (genitive [please provide], partitive [please provide])
vahejahuti	Noun	vahejahuti (genitive [please provide], partitive [please provide])
toimetaja	Noun	toimetaja (genitive toimetaja, partitive toimetajat)
ristiretk	Noun	ristiretk (genitive ristiretke, partitive ristiretke)
tuletis	Noun	tuletis (genitive tuletise, partitive tuletist)
šampanja	Noun	šampanja (genitive [please provide], partitive [please provide])
kristadelflane	Noun	kristadelflane (genitive kristadelflase, partitive kristadelflast)
rüütel	Noun	rüütel (genitive rüütli, partitive rüütlit)
jooks	Noun	jooks (genitive jooksu, partitive jooksu)
susi	Noun	susi (genitive soe, partitive sutt)
lavastaja	Noun	lavastaja (genitive lavastaja, partitive lavastajat)
kreeklane	Noun	kreeklane (genitive kreeklase, partitive kreeklast)
poolsaar	Noun	poolsaar (genitive poolsaare, partitive poolsaart)
flööt	Noun	flööt (genitive [please provide], partitive [please provide])
veinibaar	Noun	veinibaar (genitive [please provide], partitive [please provide])
neeger	Noun	neeger (genitive neegri, partitive neegrit)
karter	Noun	karter (genitive karteri, partitive karterit)
toht	Noun	toht (genitive tohu, partitive tohtu)
nädalavahetus	Noun	nädalavahetus (genitive nädalavahetuse, partitive nädalavahetust)
elutuba	Noun	elutuba (genitive elutoa, partitive elutuba)
tulekahju	Noun	tulekahju (genitive tulekahju, partitive tulekahjut)
lahing	Noun	lahing (genitive lahingu, partitive lahingut)
bioloogia	Noun	bioloogia (genitive bioloogia, partitive bioloogiat)
füsioloogia	Noun	füsioloogia (genitive füsioloogia, partitive füsioloogiat)
vägi	Noun	vägi (genitive väe, partitive väge)
inglise keel	Noun	inglise keel
kompuuter	Noun	kompuuter (genitive kompuutri, partitive kompuutrit)
kanamuna	Noun	kanamuna (genitive [please provide], partitive [please provide])
eha	Noun	eha (genitive [please provide], partitive [please provide])
lauk	Noun	lauk (genitive laugu, partitive lauku)
informatsioon	Noun	informatsioon (genitive [please provide], partitive [please provide])
lein	Noun	lein (genitive [please provide], partitive [please provide])
kida	Noun	kida (genitive [please provide], partitive [please provide])
tegumood	Noun	tegumood (genitive tegumoe, partitive tegumoodi)
bee	Noun	bee (genitive [please provide], partitive [please provide])
asbest	Noun	asbest (genitive [please provide], partitive [please provide])
võrdusmärk	Noun	võrdusmärk (genitive [please provide], partitive [please provide])
päikeseplekk	Noun	päikeseplekk (genitive [please provide], partitive [please provide])
kaelakee	Noun	kaelakee (genitive kaelakee, partitive kaelakeed)
kõneviis	Noun	kõneviis (genitive kõneviisi, partitive kõneviisi)
käekott	Noun	käekott (genitive [please provide], partitive [please provide])
punkt	Noun	punkt (genitive [please provide], partitive [please provide])
nõid	Noun	nõid (genitive nõia, partitive nõida)
õigusriik	Noun	õigusriik (genitive [please provide], partitive [please provide])
aam	Noun	aam (genitive aami, partitive aami)
sibulakoor	Noun	sibulakoor (genitive [please provide], partitive [please provide])
türannia	Noun	türannia (genitive [please provide], partitive [please provide])
apatiit	Noun	apatiit (genitive [please provide], partitive [please provide])
noor	Noun	noor (genitive noore, partitive noort)
orgia	Noun	orgia (genitive [please provide], partitive [please provide])
tänu	Noun	tänu (genitive tänu, partitive tänu)
näide	Noun	näide (genitive näite, partitive näidet)
perse	Noun	perse (genitive perse or persse, partitive perset)
aabestik	Noun	aabestik (genitive [please provide], partitive [please provide])
viinakuu	Noun	viinakuu (genitive viinakuu, partitive viinakuud)
hüpe	Noun	hüpe (genitive hüppe, partitive hüpet)
helilaad	Noun	helilaad (genitive [please provide], partitive [please provide])
teatmeteos	Noun	teatmeteos (genitive teatmeteose, partitive teatmeteost)
pori	Noun	pori (genitive [please provide], partitive [please provide])
tänapäev	Noun	tänapäev (genitive tänapäeva, partitive tänapäeva)
hüvitus	Noun	hüvitus (genitive [please provide], partitive [please provide])
fosfor	Noun	fosfor (genitive fosfori, partitive fosforit)
abikaasa	Noun	abikaasa (genitive abikaasa, partitive abikaasat)
ava	Noun	ava (genitive ava, partitive ava)
leedu keel	Noun	leedu keel
aktiinium	Noun	aktiinium (genitive aktiiniumi, partitive aktiiniumi or aktiiniumit)
pronksmedal	Noun	pronksmedal (genitive pronksmedali, partitive pronksmedalit)
peavalu	Noun	peavalu (genitive [please provide], partitive [please provide])
murre	Noun	murre (genitive [please provide], partitive [please provide])
õunapuu	Noun	õunapuu (genitive õunapuu, partitive õunapuud)
heelium	Noun	heelium (genitive heeliumi, partitive heeliumi or heeliumit)
käsivars	Noun	käsivars (genitive käsivarre, partitive käsivart)
laup	Noun	laup (genitive lauba, partitive laupa)
soon	Noun	soon (genitive soone, partitive soont)
munand	Noun	munand (genitive munandi, partitive munandit)
räni	Noun	räni (genitive [please provide], partitive [please provide])
sadam	Noun	sadam (genitive sadama, partitive sadamat)
neptuunium	Noun	neptuunium (genitive neptuuniumi, partitive neptuuniumi or neptuuniumit)
kits	Noun	kits (genitive kitse, partitive kitse)
oks	Noun	oks (genitive oksa, partitive oksa)
sukk	Noun	sukk (genitive suka, partitive sukka)
šokolaad	Noun	šokolaad (genitive [please provide], partitive [please provide])
alkohol	Noun	alkohol (genitive alkoholi, partitive alkoholi)
soov	Noun	soov (genitive soovi, partitive soovi)
palli	Noun	palli
palli	Noun	palli
peenis	Noun	peenis (genitive peenise, partitive peenist)
kratt	Noun	kratt (genitive krati, partitive kratti)
näts	Noun	näts (genitive nätsu, partitive nätsu)
ununkvaadium	Noun	ununkvaadium (genitive ununkvaadiumi, partitive ununkvaadiumi or ununkvaadiumit)
terminaator	Noun	terminaator (genitive terminaatori, partitive terminaatorit)
kurv	Noun	kurv (genitive kurvi, partitive kurvi)
berüllium	Noun	berüllium (genitive berülliumi, partitive berülliumi or berülliumit)
suhkur	Noun	suhkur (genitive suhkru, partitive suhkrut)
veebruar	Noun	veebruar (genitive veebruari, partitive veebruari or veebruarit)
leem	Noun	leem (genitive leeme, partitive leent)
pihlakas	Noun	pihlakas (genitive pihlaka, partitive pihlakat)
struuma	Noun	struuma (genitive [please provide], partitive [please provide])
vale	Noun	vale (genitive [please provide], partitive [please provide])
seeder	Noun	seeder (genitive seedri, partitive seedrit)
õve	Noun	õve (genitive õve, partitive õve)
suuseks	Noun	suuseks (genitive suuseksi, partitive suuseksi)
kodumaa	Noun	kodumaa (genitive kodumaa, partitive kodumaad)
vandenõu	Noun	vandenõu (genitive vandenõu, partitive vandenõu)
tuumasõda	Noun	tuumasõda (genitive [please provide], partitive [please provide])
oktoober	Noun	oktoober (genitive oktoobri, partitive oktoobrit)
arst	Noun	arst (genitive arsti, partitive arsti)
puts	Noun	puts (genitive putsi, partitive putsi)
pulma	Noun	pulma
tall	Noun	tall (genitive talle, partitive talle)
tuumapomm	Noun	tuumapomm (genitive [please provide], partitive [please provide])
seniit	Noun	seniit (genitive [please provide], partitive [please provide])
virts	Noun	virts (genitive virtsa, partitive virtsa)
väimees	Noun	väimees (genitive väimehe, partitive väimeest)
pronks	Noun	pronks (genitive pronksi, partitive pronksi)
rahvavabariik	Noun	rahvavabariik (genitive [please provide], partitive [please provide])
hallitus	Noun	hallitus (genitive hallituse, partitive hallitust)
jutt	Noun	jutt (genitive jutu, partitive juttu)
päts	Noun	päts (genitive [please provide], partitive [please provide])
siil	Noun	siil (genitive [please provide], partitive [please provide])
hall	Noun	hall (genitive halla, partitive halla)
hall	Noun	hall (genitive halli, partitive halli)
pärdik	Noun	pärdik (genitive pärdiku, partitive pärdikut)
piiskop	Noun	piiskop (genitive piiskopi, partitive piiskoppi)
tikk	Noun	tikk (genitive tiku, partitive tikku)
aara	Noun	aara (genitive aara, partitive aarat)
putukas	Noun	putukas (genitive putuka, partitive putukat)
kuus	Noun	kuus
tõlk	Noun	tõlk (genitive tõlgi, partitive tõlki)
titaan	Noun	titaan (genitive [please provide], partitive [please provide])
uraan	Noun	uraan (genitive [please provide], partitive [please provide])
lange	Noun	lange (genitive lange, partitive langet)
keha	Noun	keha (genitive keha, partitive keha)
vittu	Noun	vittu
oo	Noun	oo (genitive [please provide], partitive [please provide])
koda	Noun	koda (genitive koja, partitive koda)
au	Noun	au (genitive au, partitive au)
malev	Noun	malev (genitive maleva, partitive malevat)
õunamahl	Noun	õunamahl (genitive [please provide], partitive [please provide])
õigekeelsus	Noun	õigekeelsus (genitive [please provide], partitive [please provide])
lemmik	Noun	lemmik (genitive lemmiku, partitive lemmikut)
meeskond	Noun	meeskond (genitive meeskonna, partitive meeskonda)
türkiis	Noun	türkiis (genitive [please provide], partitive [please provide])
metssiga	Noun	metssiga (genitive metssea, partitive metssiga)
valgevenelane	Noun	valgevenelane (genitive valgevenelase, partitive valgevenelast)
kontor	Noun	kontor (genitive kontori, partitive kontorit)
leedulane	Noun	leedulane (genitive leedulase, partitive leedulast)
toonekurg	Noun	toonekurg (genitive toonekure, partitive toonekurge)
vanasõna	Noun	vanasõna (genitive [please provide], partitive [please provide])
vikerkaar	Noun	vikerkaar (genitive vikerkaare, partitive [please provide])
kinnistäht	Noun	kinnistäht (genitive [please provide], partitive [please provide])
traat	Noun	traat (genitive traadi, partitive traati)
egüptoloogia	Noun	egüptoloogia (genitive egüptoloogia, partitive egüptoloogiat)
murjan	Noun	murjan (genitive murjani, partitive murjanit)
sookurg	Noun	sookurg (genitive sookure, partitive sookurge)
kastan	Noun	kastan (genitive kastani, partitive kastanit)
pretsessioon	Noun	pretsessioon (genitive [please provide], partitive [please provide])
karskus	Noun	karskus (genitive karskuse, partitive karskust)
kodu	Noun	kodu (genitive kodu, partitive kodu)
hobujõud	Noun	hobujõud (genitive [please provide], partitive [please provide])
esiklaps	Noun	esiklaps (genitive [please provide], partitive [please provide])
tätoveering	Noun	tätoveering (genitive tätoveeringu, partitive tätoveeringut)
kirju	Noun	kirju (genitive kirju, partitive kirjut)
draakon	Noun	draakon (genitive draakoni, partitive draakonit)
varras	Noun	varras (genitive varda, partitive varrast)
tõuk	Noun	tõuk (genitive tõugu, partitive tõugu)
kaadmium	Noun	kaadmium (genitive kaadmiumi, partitive kaadmiumi or kaadmiumit)
islandlane	Noun	islandlane (genitive islandlase, partitive islandlast)
suu	Noun	suu (genitive suu, partitive suud)
ment	Noun	ment (genitive mendi, partitive menti)
buss	Noun	buss (genitive bussi, partitive bussi)
rula	Noun	rula (genitive rula, partitive rulad)
ämber	Noun	ämber (genitive ämbri, partitive ämbrit)
põll	Noun	põll (genitive [please provide], partitive [please provide])
lõbu	Noun	lõbu (genitive lõbu, partitive lõbu)
tööriist	Noun	tööriist (genitive [please provide], partitive [please provide])
kaltsium	Noun	kaltsium (genitive kaltsiumi, partitive kaltsiumi or kaltsiumit)
depressioon	Noun	depressioon (genitive [please provide], partitive [please provide])
värav	Noun	värav (genitive värava, partitive väravat)
piimahammas	Noun	piimahammas (genitive piimahamba, partitive piimahammast)
partii	Noun	partii (genitive partii, partitive partiid)
vee	Noun	vee (genitive [please provide], partitive [please provide])
vee	Noun	vee
kilekott	Noun	kilekott (genitive [please provide], partitive [please provide])
veetsee	Noun	veetsee (genitive veetsee, partitive veetseed)
kohta	Noun	kohta
meeter	Noun	meeter (genitive meetri, partitive meetrit)
ununbium	Noun	ununbium (genitive ununbiumi, partitive ununbiumi or ununbiumit)
ksenoon	Noun	ksenoon (genitive [please provide], partitive [please provide])
vahvel	Noun	vahvel (genitive vahvli, partitive vahvlit)
privileeg	Noun	privileeg (genitive [please provide], partitive [please provide])
nägemus	Noun	nägemus (genitive nägemuse, partitive nägemust)
and	Noun	and (genitive anni, partitive andi)
käändsõna	Noun	käändsõna (genitive käändsõna, partitive käändsõna)
põrsas	Noun	põrsas (genitive põrsa, partitive põrsast)
jõulukuusk	Noun	jõulukuusk (genitive jõulukuuse, partitive jõulukuuske)
nina	Noun	nina (genitive nina, partitive nina)
tahe	Noun	tahe (genitive tahte, partitive tahet)
nõu	Noun	nõu (genitive nõu, partitive nõu)
nõu	Noun	nõu (genitive nõu, partitive nõud)
euro	Noun	euro (genitive euro, partitive eurot)
korund	Noun	korund (genitive [please provide], partitive [please provide])
sõda	Noun	sõda (genitive sõja, partitive sõda)
iga	Noun	iga (genitive ea, partitive iga)
parun	Noun	parun (genitive paruni, partitive parunit)
sõprus	Noun	sõprus (genitive sõpruse, partitive sõprust)
Eesti kroon	Noun	Eesti kroon
darmstadtium	Noun	darmstadtium (genitive darmstadtiumi, partitive darmstadtiumi or darmstadtiumit)
omasooihar	Noun	omasooihar (genitive omasooihara, partitive omasooiharat)
sülearvuti	Noun	sülearvuti (genitive sülearvuti, partitive sülearvutit)
tänav	Noun	tänav (genitive tänava, partitive tänavat)
erbium	Noun	erbium (genitive erbiumi, partitive erbiumi or erbiumit)
koer	Noun	koer (genitive koera, partitive koera)
õppur	Noun	õppur (genitive õppuri, partitive õppurit)
nõbu	Noun	nõbu (genitive nõo, partitive nõbu)
magustoit	Noun	magustoit (genitive magustoidu, partitive magustoitu)
masturbeerimine	Noun	masturbeerimine (genitive masturbeerimise, partitive masturbeerimist)
küülik	Noun	küülik (genitive küüliku, partitive küülikut)
armastus	Noun	armastus (genitive armastuse, partitive armastust)
aa	Noun	aa (genitive aa, partitive aad)
tuulium	Noun	tuulium (genitive tuuliumi, partitive tuuliumi or tuuliumit)
mustlane	Noun	mustlane (genitive mustlase, partitive mustlast)
turv	Noun	turv (genitive turva, partitive turva)
sisu	Noun	sisu (genitive sisu, partitive sisu)
langev täht	Noun	langev täht
ateist	Noun	ateist (genitive [please provide], partitive [please provide])
lavrentsium	Noun	lavrentsium (genitive lavrentsiumi, partitive lavrentsiumi or lavrentsiumit)
maa	Noun	maa (genitive maa, partitive maad)
kakk	Noun	kakk (genitive kaku, partitive kakku)
kakk	Noun	kakk (genitive kaku, partitive kakku)
hunt	Noun	hunt (genitive hundi, partitive hunti)
jaanuar	Noun	jaanuar (genitive jaanuari, partitive jaanuari or jaanuarit)
raisk	Noun	raisk (genitive raisa, partitive raiska)
raisk	Noun	raisk (genitive raisu, partitive raisku)
telluur	Noun	telluur (genitive [please provide], partitive [please provide])
musträstas	Noun	musträstas (genitive musträsta, partitive musträstast)
bürokraatia	Noun	bürokraatia (genitive [please provide], partitive [please provide])
männik	Noun	männik (genitive männiku, partitive männikut)
pank	Noun	pank (genitive panga, partitive panka)
ruun	Noun	ruun (genitive ruuna, partitive ruuna)
leegiheitja	Noun	leegiheitja (genitive leegiheitja, partitive leegiheitjat)
kalifornium	Noun	kalifornium (genitive kaliforniumi, partitive kaliforniumi or kaliforniumit)
viha	Noun	viha (genitive viha, partitive viha)
kärnkonn	Noun	kärnkonn (genitive [please provide], partitive [please provide])
kaber	Noun	kaber (genitive kabra, partitive kapra)
lill	Noun	lill (genitive lille, partitive lille)
võõrastemaja	Noun	võõrastemaja (genitive [please provide], partitive [please provide])
kogu	Noun	kogu (genitive kogu, partitive kogu)
žurnalist	Noun	žurnalist (genitive [please provide], partitive [please provide])
usklik	Noun	usklik (genitive uskliku, partitive usklikku)
hoius	Noun	hoius (genitive [please provide], partitive [please provide])
silm	Noun	silm (genitive silma, partitive silma)
silm	Noun	silm (genitive silmu, partitive silmu)
türklane	Noun	türklane (genitive türklase, partitive türklast)
liir	Noun	liir (genitive [please provide], partitive [please provide])
aabe	Noun	aabe (genitive aape, partitive aabet)
turvas	Noun	turvas (genitive turba, partitive turvast)
koor	Noun	koor (genitive koore, partitive koort)
koor	Noun	koor (genitive koori, partitive koori)
diisel	Noun	diisel (genitive diisli, partitive diislit)
süld	Noun	süld (genitive sülla, partitive sülda)
tuul	Noun	tuul (genitive tuule, partitive tuult)
substantiiv	Noun	substantiiv (genitive [please provide], partitive [please provide])
kirjandus	Noun	kirjandus (genitive kirjanduse, partitive kirjandust)
taevas	Noun	taevas (genitive taeva, partitive taevast)
plaat	Noun	plaat (genitive plaadi, partitive plaati)
seminar	Noun	seminar (genitive seminari, partitive seminari)
vabasurm	Noun	vabasurm (genitive vabasurma, partitive vabasurma)
peenar	Noun	peenar (genitive peenra, partitive peenart)
nüktofoobia	Noun	nüktofoobia (genitive [please provide], partitive [please provide])
ununtrium	Noun	ununtrium (genitive ununtriumi, partitive ununtriumi or ununtriumit)
püss	Noun	püss (genitive püssi, partitive püssi)
habe	Noun	habe (genitive habeme, partitive habet)
kulda	Noun	kulda
seaborgium	Noun	seaborgium (genitive seaborgiumi, partitive seaborgiumi or seaborgiumit)
olevik	Noun	olevik (genitive oleviku, partitive olevikku)
juuksur	Noun	juuksur (genitive juuksuri, partitive juuksurit)
number	Noun	number (genitive numbri, partitive numbrit)
soome keel	Noun	soome keel
pääsuke	Noun	pääsuke (genitive pääsukese, partitive pääsukest)
nool	Noun	nool (genitive noole, partitive noolt)
veinipudel	Noun	veinipudel (genitive veinipudeli, partitive [please provide])
keeks	Noun	keeks (genitive [please provide], partitive [please provide])
vaarikamoos	Noun	vaarikamoos (genitive [please provide], partitive [please provide])
botaanika	Noun	botaanika (genitive [please provide], partitive [please provide])
küün	Noun	küün (genitive küüni, partitive küüni)
maasikas	Noun	maasikas (genitive maasika, partitive maasikat)
kino	Noun	kino (genitive [please provide], partitive [please provide])
granaadid	Noun	granaadid (genitive [please provide], partitive [please provide])
planktoloogia	Noun	planktoloogia (genitive [please provide], partitive [please provide])
kõmri keel	Noun	kõmri keel
põhi	Noun	põhi (genitive põhja, partitive põhja)
biseksuaalsus	Noun	biseksuaalsus (genitive biseksuaalsuse, partitive biseksuaalsust)
fütokeemia	Noun	fütokeemia (genitive [please provide], partitive [please provide])
ait	Noun	ait
rõhk	Noun	rõhk (genitive rõhu, partitive rõhku)
saar	Noun	saar (genitive saare, partitive saart)
saar	Noun	saar (genitive saare, partitive saart)
juus	Noun	juus (genitive juukse, partitive juust)
pealinn	Noun	pealinn (genitive pealinna, partitive pealinna)
aastaaeg	Noun	aastaaeg (genitive aastaaja, partitive aastaaega)
savi	Noun	savi (genitive [please provide], partitive [please provide])
tuju	Noun	tuju (genitive [please provide], partitive [please provide])
vorm	Noun	vorm (genitive vormi, partitive vormi)
hommikueine	Noun	hommikueine (genitive [please provide], partitive [please provide])
nädalalõpp	Noun	nädalalõpp (genitive [please provide], partitive [please provide])
mõõk	Noun	mõõk (genitive mõõga, partitive mõõka)
bussijuht	Noun	bussijuht (genitive [please provide], partitive [please provide])
oder	Noun	oder (genitive odra, partitive otra)
suude	Noun	suude
pidu	Noun	pidu (genitive peo, partitive pidu)
usk	Noun	usk (genitive usu, partitive usku)
aine	Noun	aine (genitive aine, partitive ainet)
inimkond	Noun	inimkond (genitive [please provide], partitive [please provide])
vabariik	Noun	vabariik (genitive vabariigi, partitive vabariiki)
tiib	Noun	tiib (genitive [please provide], partitive [please provide])
taanlane	Noun	taanlane (genitive taanlase, partitive taanlast)
valve	Noun	valve (genitive valve, partitive valvet)
valge	Noun	valge (genitive valge, partitive valget)
maine	Noun	maine (genitive maine, partitive mainet)
kalasupp	Noun	kalasupp (genitive [please provide], partitive [please provide])
kirurg	Noun	kirurg (genitive [please provide], partitive [please provide])
ruumis	Noun	ruumis
kaasavara	Noun	kaasavara (genitive [please provide], partitive [please provide])
taal	Noun	taal (genitive [please provide], partitive [please provide])
väi	Noun	väi (genitive väi, partitive väid)
pokker	Noun	pokker (genitive pokkeri, partitive pokkerit)
orel	Noun	orel (genitive oreli, partitive orelit)
hommik	Noun	hommik (genitive hommiku, partitive hommikut)
lõvi	Noun	lõvi (genitive lõvi, partitive lõvi)
nurk	Noun	nurk (genitive nurga, partitive nurka)
mõla	Noun	mõla (genitive mõla, partitive mõla)
jõulukink	Noun	jõulukink (genitive [please provide], partitive [please provide])
tulemus	Noun	tulemus (genitive tulemuse, partitive tulemust)
realism	Noun	realism (genitive [please provide], partitive [please provide])
piirik	Noun	piirik (genitive [please provide], partitive [please provide])
tahm	Noun	tahm (genitive [please provide], partitive [please provide])
džemper	Noun	džemper (genitive džempri, partitive džemprit)
kehaosa	Noun	kehaosa (genitive [please provide], partitive [please provide])
supernoova	Noun	supernoova (genitive [please provide], partitive [please provide])
papagoi	Noun	papagoi (genitive papagoi, partitive papagoid)
liivlane	Noun	liivlane (genitive liivlase, partitive liivlast)
pere	Noun	pere (genitive pere, partitive peret)
ajukasvaja	Noun	ajukasvaja (genitive [please provide], partitive [please provide])
heteroseksuaalsus	Noun	heteroseksuaalsus (genitive heteroseksuaalsuse, partitive heteroseksuaalsust)
põrn	Noun	põrn (genitive [please provide], partitive [please provide])
petersell	Noun	petersell (genitive peterselli, partitive peterselli)
strontsium	Noun	strontsium (genitive strontsiumi, partitive strontsiumi or strontsiumit)
ruteenium	Noun	ruteenium (genitive ruteeniumi, partitive ruteeniumi or ruteeniumit)
rõhukamber	Noun	rõhukamber (genitive rõhukambri, partitive rõhukambrit)
võrk	Noun	võrk (genitive võrgu, partitive võrku)
küünal	Noun	küünal (genitive küünla, partitive küünalt)
arutleja	Noun	arutleja (genitive [please provide], partitive [please provide])
kaklus	Noun	kaklus (genitive kakluse, partitive kaklust)
buldooser	Noun	buldooser (genitive buldooseri, partitive buldooserit)
isadus	Noun	isadus (genitive isaduse, partitive isadust)
enneaegne seemnepurse	Noun	enneaegne seemnepurse (genitive enneaegse seemnepurske, partitive enneaegset seemnepurset)
keelkond	Noun	keelkond (genitive [please provide], partitive [please provide])
sauna	Noun	sauna
tomat	Noun	tomat (genitive [please provide], partitive [please provide])
reklaam	Noun	reklaam (genitive [please provide], partitive [please provide])
valguskiir	Noun	valguskiir (genitive [please provide], partitive [please provide])
lüsergiinhappe dietüülamiid	Noun	lüsergiinhappe dietüülamiid
otsmikuluu	Noun	otsmikuluu (genitive otsmikuluu, partitive otsmikuluud)
nägu	Noun	nägu (genitive näo, partitive nägu)
kaassõna	Noun	kaassõna (genitive kaassõna, partitive kaassõna)
kiirgus	Noun	kiirgus (genitive kiirguse, partitive kiirgust)
kolmainsus	Noun	kolmainsus (genitive kolmainsuse, partitive kolmainsust)
burger	Noun	burger (genitive [please provide], partitive [please provide])
oksjon	Noun	oksjon (genitive oksjoni, partitive oksjonit)
kali	Noun	kali (genitive kalja, partitive kalja)
tapatalgud	Noun	tapatalgud (genitive [please provide], partitive [please provide])
oktaav	Noun	oktaav (genitive [please provide], partitive [please provide])
jobu	Noun	jobu (genitive jobu, partitive jobu)
pubi	Noun	pubi (genitive pubi, partitive pubi)
norralane	Noun	norralane (genitive norralase, partitive norralast)
orav	Noun	orav (genitive orava, partitive oravat)
kiosk	Noun	kiosk (genitive [please provide], partitive [please provide])
antimon	Noun	antimon (genitive antimoni, partitive antimoni)
delfiin	Noun	delfiin (genitive [please provide], partitive [please provide])
tuletikk	Noun	tuletikk (genitive [please provide], partitive [please provide])
magnetiit	Noun	magnetiit (genitive [please provide], partitive [please provide])
kaabakas	Noun	kaabakas (genitive kaabaka, partitive kaabakat)
naps	Noun	naps (genitive [please provide], partitive [please provide])
pandeism	Noun	pandeism (genitive [please provide], partitive [please provide])
relv	Noun	relv (genitive relva, partitive relva)
uba	Noun	uba (genitive oa, partitive uba)
foobia	Noun	foobia (genitive [please provide], partitive [please provide])
oinas	Noun	oinas (genitive [please provide], partitive [please provide])
laegas	Noun	laegas (genitive laeka, partitive laegast)
uss	Noun	uss (genitive ussi, partitive ussi)
õun	Noun	õun (genitive õuna, partitive õuna)
kaltsedon	Noun	kaltsedon (genitive kaltsedoni, partitive kaltsedoni)
jõud	Noun	jõud (genitive jõu, partitive jõudu)
riisivein	Noun	riisivein (genitive [please provide], partitive [please provide])
asula	Noun	asula (genitive asula, partitive asulat)
ööklubi	Noun	ööklubi (genitive ööklubi, partitive ööklubi)
päike	Noun	päike (genitive päikese, partitive päikest)
kalli	Noun	kalli (genitive kalli, partitive kallit)
parm	Noun	parm (genitive parmu, partitive parmu)
pood	Noun	pood (genitive poe, partitive poodi)
astenosfäär	Noun	astenosfäär (genitive [please provide], partitive [please provide])
peldik	Noun	peldik (genitive peldiku, partitive peldikut)
keemik	Noun	keemik (genitive keemiku, partitive keemikut)
vaik	Noun	vaik (genitive [please provide], partitive [please provide])
nurksulg	Noun	nurksulg (genitive [please provide], partitive [please provide])
statistika	Noun	statistika (genitive statistika, partitive statistikat)
dünamo	Noun	dünamo (genitive [please provide], partitive [please provide])
kajastus	Noun	kajastus (genitive [please provide], partitive [please provide])
infrastruktuur	Noun	infrastruktuur (genitive [please provide], partitive [please provide])
türa	Noun	türa (genitive türa, partitive türa)
must auk	Noun	must auk (genitive musta augu, partitive musta auku)
häire	Noun	häire (genitive häire, partitive häiret)
hüüdsõna	Noun	hüüdsõna (genitive hüüdsõna, partitive hüüdsõna)
klaas	Noun	klaas (genitive klaasi, partitive klaasi)
male	Noun	male (genitive male, partitive malet)
aser	Noun	aser (genitive aseri, partitive aserit)
kraan	Noun	kraan (genitive kraani, partitive kraani)
piinia	Noun	piinia (genitive [please provide], partitive [please provide])
kodakondsus	Noun	kodakondsus (genitive kodakondsuse, partitive [please provide])
hammas	Noun	hammas (genitive hamba, partitive hammast)
alkoholism	Noun	alkoholism (genitive [please provide], partitive [please provide])
tiik	Noun	tiik (genitive tiigi, partitive tiiki)
kastehein	Noun	kastehein (genitive [please provide], partitive [please provide])
põder	Noun	põder (genitive põdra, partitive põtra)
brändi	Noun	brändi (genitive [please provide], partitive [please provide])
ämblikulaadne	Noun	ämblikulaadne (genitive ämblikulaadse, partitive ämblikulaadset)
kiri	Noun	kiri (genitive kirja, partitive kirja)
müüt	Noun	müüt (genitive müüdi, partitive müüti)
polaarjoon	Noun	polaarjoon (genitive [please provide], partitive [please provide])
poro	Noun	poro (genitive poro, partitive poro or porot)
antonüüm	Noun	antonüüm (genitive antonüümi, partitive antonüümi)
sisalik	Noun	sisalik (genitive sisaliku, partitive sisalikku)
homoseksuaal	Noun	homoseksuaal (genitive homoseksuaali, partitive homoseksuaali)
madrus	Noun	madrus (genitive madruse, partitive madrust)
süstal	Noun	süstal (genitive süstla, partitive süstalt)
kuld	Noun	kuld (genitive kulla, partitive kulda)
sünnitus	Noun	sünnitus (genitive sünnituse, partitive sünnitust)
põtk	Noun	põtk (genitive põtku, partitive põtku)
röntgeenium	Noun	röntgeenium (genitive röntgeeniumi, partitive röntgeeniumi or röntgeeniumit)
ööelu	Noun	ööelu (genitive [please provide], partitive [please provide])
opaal	Noun	opaal (genitive [please provide], partitive [please provide])
söögilaud	Noun	söögilaud (genitive [please provide], partitive [please provide])
šiiit	Noun	šiiit (genitive [please provide], partitive [please provide])
võitja	Noun	võitja (genitive võitja, partitive võitjat)
sitikas	Noun	sitikas (genitive sitika, partitive sitikat)
evolutsioon	Noun	evolutsioon (genitive evolutsiooni, partitive evolutsiooni)
kirja	Noun	kirja
demograafia	Noun	demograafia (genitive [please provide], partitive [please provide])
porgand	Noun	porgand (genitive porgandi, partitive porgandit)
kartul	Noun	kartul (genitive kartuli, partitive kartulit)
hamburger	Noun	hamburger (genitive [please provide], partitive [please provide])
viiul	Noun	viiul (genitive [please provide], partitive [please provide])
jääkaru	Noun	jääkaru (genitive jääkaru, partitive jääkaru)
pidžaama	Noun	pidžaama (genitive [please provide], partitive [please provide])
osake	Noun	osake (genitive osakese, partitive osakest)
peeniseluu	Noun	peeniseluu (genitive peeniseluu, partitive peeniseluud)
elavhõbe	Noun	elavhõbe (genitive [please provide], partitive [please provide])
kallis	Noun	kallis (genitive kalli, partitive kallist)
küberneetika	Noun	küberneetika (genitive küberneetika, partitive küberneetikat)
šaht	Noun	šaht (genitive [please provide], partitive [please provide])
muudatus	Noun	muudatus (genitive [please provide], partitive [please provide])
eesti keel	Noun	eesti keel
tolmuimeja	Noun	tolmuimeja (genitive tolmuimeja, partitive tolmuimejat)
peaminister	Noun	peaminister (genitive peaministri, partitive peaministrit)
mölder	Noun	mölder (genitive möldri, partitive möldrit)
jõgi	Noun	jõgi (genitive jõe, partitive jõge)
vaikus	Noun	vaikus (genitive vaikuse, partitive vaikust)
põhjanaba	Noun	põhjanaba (genitive [please provide], partitive [please provide])
rästas	Noun	rästas (genitive rästa, partitive rästas)
vunts	Noun	vunts (genitive vuntsi, partitive vuntsi)
šaakal	Noun	šaakal (genitive šaakali, partitive šaakalit)
küünlakuu	Noun	küünlakuu (genitive küünlakuu, partitive küünlakuud)
taevakeha	Noun	taevakeha (genitive [please provide], partitive [please provide])
rõõm	Noun	rõõm (genitive rõõmu, partitive rõõmu)
helikaart	Noun	helikaart (genitive [please provide], partitive [please provide])
sahkluu	Noun	sahkluu (genitive sahkluu, partitive sahkluud)
entsüklopeedia	Noun	entsüklopeedia (genitive entsüklopeedia, partitive entsüklopeediat)
vend	Noun	vend (genitive venna, partitive venda)
kihvt	Noun	kihvt (genitive kihvti, partitive kihvti)
seller	Noun	seller (genitive selleri, partitive sellerit)
vald	Noun	vald (genitive valla, partitive valda)
kilp	Noun	kilp (genitive kilbi, partitive kilpi)
banaan	Noun	banaan (genitive [please provide], partitive [please provide])
mulla	Noun	mulla
postimees	Noun	postimees (genitive [please provide], partitive [please provide])
ariaanlus	Noun	ariaanlus (genitive ariaanluse, partitive ariaanlust)
kesköö	Noun	kesköö (genitive kesköö, partitive keskööd)
aabits	Noun	aabits (genitive aabitsa, partitive aabitsat)
ajakirjanik	Noun	ajakirjanik (genitive ajakirjaniku, partitive ajakirjanikku)
peni	Noun	peni (genitive peni, partitive peni)
sügavus	Noun	sügavus (genitive sügavuse, partitive sügavust)
parti	Noun	parti
kõiv	Noun	kõiv (genitive kõivu, partitive kõivu)
rivistus	Noun	rivistus (genitive rivistuse, partitive rvistust)
hüüd	Noun	hüüd (genitive hüüu, partitive hüüdu)
mälestus	Noun	mälestus (genitive mälestuse, partitive mälestust)
puu	Noun	puu (genitive puu, partitive puud)
pink	Noun	pink (genitive pingi, partitive pinki)
tool	Noun	tool (genitive tooli, partitive tooli)
rasvaimu	Noun	rasvaimu (genitive rasvaimu, partitive rasvaimu)
pomm	Noun	pomm (genitive pommi, partitive pommi)
majandus	Noun	majandus (genitive majanduse, partitive majandust)
sudenkuu	Noun	sudenkuu (genitive sudenkuu, partitive sudenkuud)
muruniiduk	Noun	muruniiduk (genitive [please provide], partitive [please provide])
peenendus	Noun	peenendus (genitive [please provide], partitive [please provide])
siuts	Noun	siuts (genitive [please provide], partitive [please provide])
paik	Noun	paik (genitive paiga, partitive paika)
tõsi	Noun	tõsi (genitive tõe, partitive tõtt)
põu	Noun	põu (genitive põue, partitive põue)
mood	Noun	mood (genitive moe, partitive moodi)
tuhk	Noun	tuhk (genitive tuha, partitive tuhka)
meri	Noun	meri (genitive mere, partitive merd)
mõõt	Noun	mõõt (genitive [please provide], partitive [please provide])
edel	Noun	edel (genitive edela, partitive edelat)
tõik	Noun	tõik (genitive tõiga, partitive tõika)
alus	Noun	alus (genitive aluse, partitive alust)
käitumine	Noun	käitumine (genitive käitumise, partitive käitumist)
lävi	Noun	lävi (genitive [please provide], partitive [please provide])
härg	Noun	härg (genitive [please provide], partitive [please provide])
vares	Noun	vares (genitive varese, partitive varest)
nikkel	Noun	nikkel (genitive nikli, partitive niklit)
päikesetuul	Noun	päikesetuul (genitive [please provide], partitive [please provide])
pikkus	Noun	pikkus (genitive pikkuse, partitive pikkust)
ettekuulutus	Noun	ettekuulutus (genitive [please provide], partitive [please provide])
skorpion	Noun	skorpion (genitive skorpioni, partitive skorpioni or skorpionit)
näitlejatar	Noun	näitlejatar (genitive näitlejatari, partitive näitlejatari)
arhitekt	Noun	arhitekt (genitive [please provide], partitive [please provide])
polüsahhariid	Noun	polüsahhariid (genitive [please provide], partitive [please provide])
ausus	Noun	ausus (genitive aususe, partitive ausust)
mittemetall	Noun	mittemetall (genitive [please provide], partitive [please provide])
koni	Noun	koni (genitive koni, partitive koni)
tald	Noun	tald (genitive talla, partitive talda)
koeratoit	Noun	koeratoit (genitive koeratoidu, partitive koeratoitu)
hüpik	Noun	hüpik (genitive hüpiku, partitive hüpikut)
sõiduriist	Noun	sõiduriist (genitive sõiduriista, partitive sõiduriista)
plaatina	Noun	plaatina (genitive [please provide], partitive [please provide])
sokk	Noun	sokk (genitive soki, partitive sokki)
sokk	Noun	sokk (genitive soku, partitive sokku)
trofee	Noun	trofee (genitive trofee, partitive trofeed)
tuttav	Noun	tuttav (genitive tuttava, partitive tuttavat)
soo	Noun	soo (genitive soo, partitive sood)
ananass	Noun	ananass (genitive ananassi, partitive ananassi)
heteroseksuaal	Noun	heteroseksuaal (genitive heteroseksuaali, partitive heteroseksuaali)
tammetõru	Noun	tammetõru (genitive tammetõru, partitive tammetõru)
neem	Noun	neem (genitive [please provide], partitive [please provide])
rahvaarv	Noun	rahvaarv (genitive rahvaarvu, partitive rahvaarvu)
kood	Noun	kood (genitive koodi, partitive koodi)
religioon	Noun	religioon (genitive [please provide], partitive [please provide])
kalliskivi	Noun	kalliskivi (genitive [please provide], partitive [please provide])
loom	Noun	loom (genitive looma, partitive looma)
kapsas	Noun	kapsas (genitive kapsa, partitive kapsast)
luuletaja	Noun	luuletaja (genitive luuletaja, partitive luuletajat)
rool	Noun	rool (genitive rooli, partitive rooli)
anatoomia	Noun	anatoomia (genitive [please provide], partitive [please provide])
vennas	Noun	vennas (genitive vennase, partitive vennast)
vennas	Noun	vennas
neitsinahk	Noun	neitsinahk (genitive neitsinaha, partitive neitsinahka)
rivi	Noun	rivi (genitive rivi, partitive rivi)
sibul	Noun	sibul (genitive sibula, partitive sibulat)
küünar	Noun	küünar (genitive küünra, partitive küünart)
mätas	Noun	mätas (genitive [please provide], partitive [please provide])
torn	Noun	torn (genitive torni, partitive torni)
pühapäev	Noun	pühapäev (genitive pühapäeva, partitive pühapäeva)
türgi keel	Noun	türgi keel
želatiin	Noun	želatiin (genitive [please provide], partitive [please provide])
sülg	Noun	sülg (genitive sülje, partitive sülge)
küüslauk	Noun	küüslauk (genitive [please provide], partitive [please provide])
mobiiltelefon	Noun	mobiiltelefon (genitive mobiiltelefoni, partitive mobiiltelefoni)
imidž	Noun	imidž (genitive imidži, partitive imidžit)
õis	Noun	õis (genitive õie, partitive õit)
sepp	Noun	sepp (genitive sepa, partitive seppa)
vanker	Noun	vanker (genitive vankri, partitive vankrit)
katalüüsneutralisaator	Noun	katalüüsneutralisaator (genitive katalüüsneutralisaatori, partitive katalüüsneutralisaatorit)
halogeen	Noun	halogeen (genitive [please provide], partitive [please provide])
toru	Noun	toru (genitive toru, partitive toru)
kättemaks	Noun	kättemaks (genitive [please provide], partitive [please provide])
ahven	Noun	ahven (genitive ahvena, partitive ahvenat)
lõug	Noun	lõug (genitive lõua, partitive lõuga)
täht	Noun	täht (genitive tähe, partitive tähte)
selga	Noun	selga
munarakk	Noun	munarakk (genitive [please provide], partitive [please provide])
händ	Noun	händ (genitive hänna, partitive hända)
pilusilm	Noun	pilusilm (genitive pilusilma, partitive pilusilma)
rinnahoidja	Noun	rinnahoidja (genitive rinnahoidja, partitive rinnahoidjat)
näitleja	Noun	näitleja (genitive näitleja, partitive näitlejat)
kohtupidamine	Noun	kohtupidamine (genitive kohtupidamise, partitive kohtupidamist)
vadjalane	Noun	vadjalane (genitive vadjalase, partitive vadjalast)
euroopium	Noun	euroopium (genitive euroopiumi, partitive euroopiumi or euroopiumit)
peet	Noun	peet (genitive peedi, partitive peeti)
ettur	Noun	ettur (genitive etturi, partitive etturit)
nioobium	Noun	nioobium (genitive nioobiumi, partitive nioobiumi or nioobiumit)
kasutaja	Noun	kasutaja (genitive kasutaja, partitive kasutajat)
kirik	Noun	kirik (genitive kiriku, partitive kirikut)
aprill	Noun	aprill (genitive aprilli, partitive aprilli)
tulemägi	Noun	tulemägi (genitive [please provide], partitive [please provide])
kanep	Noun	kanep (genitive kanepi, partitive kanepit)
mänd	Noun	mänd (genitive männi, partitive mändi)
õli	Noun	õli (genitive [please provide], partitive [please provide])
klooster	Noun	klooster (genitive kloostri, partitive kloostrit)
zooloogia	Noun	zooloogia (genitive [please provide], partitive [please provide])
küsimärk	Noun	küsimärk (genitive [please provide], partitive [please provide])
töö	Noun	töö (genitive töö, partitive tööd)
tõestus	Noun	tõestus (genitive tõestuse, partitive tõestust)
sitt	Noun	sitt (genitive sita, partitive sitta)
abielu	Noun	abielu (genitive abielu, partitive abielu)
jalka	Noun	jalka (genitive jalka, partitive jalkat)
onu	Noun	onu (genitive onu, partitive onu)
tolm	Noun	tolm (genitive tolmu, partitive tolmu)
tööriistakomplekt	Noun	tööriistakomplekt (genitive [please provide], partitive [please provide])
silmatera	Noun	silmatera (genitive [please provide], partitive [please provide])
järg	Noun	järg (genitive järje, partitive järge)
tallium	Noun	tallium (genitive talliumi, partitive talliumi or talliumit)
direktiiv	Noun	direktiiv (genitive [please provide], partitive [please provide])
seadus	Noun	seadus (genitive seaduse, partitive seadust)
ost	Noun	ost (genitive ostu, partitive ostu)
maja	Noun	maja (genitive maja, partitive maja)
porr	Noun	porr (genitive porr, partitive [please provide])
plankton	Noun	plankton (genitive [please provide], partitive [please provide])
kalamees	Noun	kalamees (genitive kalamehe, partitive kalameest)
pihk	Noun	pihk (genitive pihu, partitive pihku)
tuba	Noun	tuba (genitive toa, partitive tuba)
kaa	Noun	kaa (genitive [please provide], partitive [please provide])
hiir	Noun	hiir (genitive hiire, partitive hiirt)
abil	Noun	abil
sulg	Noun	sulg (genitive sule, partitive sulge)
sulg	Noun	sulg (genitive sulu, partitive sulgu)
käsklus	Noun	käsklus (genitive käskluse, partitive käsklust)
karsklane	Noun	karsklane (genitive karsklase, partitive karsklast)
sarm	Noun	sarm (genitive [please provide], partitive [please provide])
puus	Noun	puus (genitive puusa, partitive puusa)
puus	Noun	puus
punarind	Noun	punarind (genitive punarinna, partitive punarinda)
pulmapidu	Noun	pulmapidu (genitive [please provide], partitive [please provide])
maakera	Noun	maakera (genitive maakera, partitive maakera)
ühiskond	Noun	ühiskond (genitive ühiskonna, partitive ühiskonda)
hüdroloogia	Noun	hüdroloogia (genitive [please provide], partitive [please provide])
imik	Noun	imik (genitive imiku, partitive imikut)
paise	Noun	paise (genitive [please provide], partitive [please provide])
tapp	Noun	tapp (genitive tapu, partitive tappu)
vaenlane	Noun	vaenlane (genitive vaenlase, partitive vaenlast)
pesu	Noun	pesu (genitive [please provide], partitive [please provide])
külm sõda	Noun	külm sõda
tööriistariba	Noun	tööriistariba (genitive [please provide], partitive [please provide])
laupäev	Noun	laupäev (genitive laupäeva, partitive laupäeva)
kilu	Noun	kilu (genitive kilu, partitive kilu)
põrand	Noun	põrand (genitive põranda, partitive põrandat)
kaar	Noun	kaar (genitive kaare, partitive kaart)
umbisikuline	Noun	umbisikuline (genitive umbisikulise, partitive umbisikulist)
retk	Noun	retk (genitive retke, partitive retke)
hauakivi	Noun	hauakivi (genitive [please provide], partitive [please provide])
õmblusmasin	Noun	õmblusmasin (genitive õmblusmasina, partitive õmblusmasinat)
toitaine	Noun	toitaine (genitive [please provide], partitive [please provide])
seksuaalpartner	Noun	seksuaalpartner (genitive seksuaalpartneri, partitive seksuaalpartnerit)
talu	Noun	talu (genitive talu, partitive talu)
asjatundja	Noun	asjatundja (genitive asjatundja, partitive asjatundjat)
vasar	Noun	vasar (genitive vasara, partitive vasarat)
õetütar	Noun	õetütar (genitive õetütre, partitive õetütart)
ilma	Noun	ilma
nooremleitnant	Noun	nooremleitnant (genitive [please provide], partitive [please provide])
pisar	Noun	pisar (genitive pisara, partitive pisarat)
ime	Noun	ime (genitive ime, partitive imet)
kaaries	Noun	kaaries (genitive kaariese, partitive kaariest)
raudtee	Noun	raudtee (genitive raudtee, partitive raudteed)
muumia	Noun	muumia (genitive [please provide], partitive [please provide])
segu	Noun	segu (genitive segu, partitive segu)
alalõualuu	Noun	alalõualuu (genitive alalõualuu, partitive alalõualuud)
hambahari	Noun	hambahari (genitive [please provide], partitive [please provide])
silla	Noun	silla
mägi	Noun	mägi (genitive mäe, partitive mäge)
õpilane	Noun	õpilane (genitive õpilase, partitive õpilast)
ravim	Noun	ravim (genitive ravimi, partitive ravimit)
põldpüü	Noun	põldpüü (genitive põldpüü, partitive põldpüüd)
heeringas	Noun	heeringas (genitive heeringa, partitive heeringat)
orjus	Noun	orjus (genitive orjuse, partitive orjust)
ümberlõikamine	Noun	ümberlõikamine (genitive ümberlõikamise, partitive ümberlõikamist)
kuudes	Noun	kuudes
Aspergeri sündroom	Noun	Aspergeri sündroom
ots	Noun	ots (genitive otsa, partitive otsa)
labidas	Noun	labidas (genitive labida, partitive labidat)
noolsulg	Noun	noolsulg (genitive [please provide], partitive [please provide])
ninaluu	Noun	ninaluu (genitive ninaluu, partitive ninaluud)
kaugus	Noun	kaugus (genitive kauguse, partitive kaugust)
sara	Noun	sara (genitive [please provide], partitive [please provide])
tarkvara	Noun	tarkvara (genitive tarkvara, partitive tarkvara)
mark	Noun	mark (genitive margi, partitive marki)
mark	Noun	mark (genitive marga, partitive marka)
doktriin	Noun	doktriin (genitive [please provide], partitive [please provide])
austus	Noun	austus (genitive austuse, partitive austust)
õueaiamaa	Noun	õueaiamaa (genitive õueaiamaa, partitive õueaiamaad)
horvaat	Noun	horvaat (genitive horvaadi, partitive horvaati)
grupp	Noun	grupp (genitive [please provide], partitive [please provide])
astmevaheldus	Noun	astmevaheldus (genitive astmevahelduse, partitive astmevaheldust)
esmaabi	Noun	esmaabi (genitive esmaabi, partitive esmaabi)
kelder	Noun	kelder (genitive keldri, partitive keldrit)
jõululaupäev	Noun	jõululaupäev (genitive [please provide], partitive [please provide])
-näär	Noun	-näär (genitive -nääri, partitive -nääri)
raamatukoi	Noun	raamatukoi (genitive raamatukoi, partitive raamatukoid)
baarium	Noun	baarium (genitive baariumi, partitive baariumi or baariumit)
smaragd	Noun	smaragd (genitive [please provide], partitive [please provide])
tequila	Noun	tequila (genitive [please provide], partitive [please provide])
taim	Noun	taim (genitive [please provide], partitive [please provide])
kohus	Noun	kohus (genitive kohtu, partitive kohut)
tautomeeria	Noun	tautomeeria (genitive [please provide], partitive [please provide])
rada	Noun	rada (genitive raja, partitive rada)
suguti	Noun	suguti (genitive suguti, partitive sugutit)
objekt	Noun	objekt (genitive objekti, partitive objekti)
laadileht	Noun	laadileht (genitive [please provide], partitive [please provide])
vene	Noun	vene (genitive vene, partitive venet)
õhufilter	Noun	õhufilter (genitive õhufiltri, partitive õhufiltrit)
vagiina	Noun	vagiina (genitive vagiina, partitive vagiinat)
komm	Noun	komm (genitive kommi, partitive kommi)
otsus	Noun	otsus (genitive otsuse, partitive otsust)
korpus	Noun	korpus (genitive korpuse, partitive korpust)
vastne	Noun	vastne (genitive vastse, partitive vastset)
lagi	Noun	lagi (genitive lae, partitive lage)
maarahvas	Noun	maarahvas (genitive maarahva, partitive maarahvast)
veetulv	Noun	veetulv (genitive [please provide], partitive [please provide])
palatalisatsioon	Noun	palatalisatsioon (genitive [please provide], partitive [please provide])
alastus	Noun	alastus (genitive alastuse, partitive alastust)
tuhka	Noun	tuhka
rakk	Noun	rakk (genitive [please provide], partitive [please provide])
füüsik	Noun	füüsik (genitive füüsiku, partitive füüsikut)
jumal	Noun	jumal (genitive jumala, partitive jumalat)
vaade	Noun	vaade (genitive [please provide], partitive [please provide])
kilpkonn	Noun	kilpkonn (genitive kilpkonna, partitive kilpkonna)
kuur	Noun	kuur (genitive kuuri, partitive kuuri)
kuur	Noun	kuur (genitive kuuri, partitive kuuri)
nikutus	Noun	nikutus (genitive [please provide], partitive [please provide])
laatsaret	Noun	laatsaret (genitive [please provide], partitive [please provide])
arm	Noun	arm (genitive armi, partitive armi)
arm	Noun	arm (genitive armu, partitive armu)
voolik	Noun	voolik (genitive vooliku, partitive voolikut)
rõngas	Noun	rõngas (genitive rõnga, partitive rõngast)
juhind	Noun	juhind (genitive [please provide], partitive [please provide])
siss	Noun	siss (genitive sissi, partitive sissi)
september	Noun	september (genitive septembri, partitive septembrit)
peavoolustamine	Noun	peavoolustamine (genitive peavoolustamise, partitive peavoolustamist)
süüdlane	Noun	süüdlane (genitive süüdlase, partitive süüdlast)
kõht	Noun	kõht (genitive kõhu, partitive kõhtu)
ruum	Noun	ruum (genitive ruumi, partitive ruumi)
jaanituli	Noun	jaanituli (genitive [please provide], partitive [please provide])
kõnekeel	Noun	kõnekeel (genitive [please provide], partitive [please provide])
moslem	Noun	moslem (genitive moslemi, partitive moslemit)
minut	Noun	minut (genitive minuti, partitive minutit)
püriit	Noun	püriit (genitive [please provide], partitive [please provide])
hoone	Noun	hoone (genitive hoone, partitive hoonet)
loodus	Noun	loodus (genitive looduse, partitive loodust)
vaarikas	Noun	vaarikas (genitive vaarika, partitive vaarikat)
paju	Noun	paju (genitive [please provide], partitive [please provide])
läti keel	Noun	läti keel
orjaturg	Noun	orjaturg (genitive orjaturu, partitive orjaturgu)
polümerisatsioon	Noun	polümerisatsioon (genitive [please provide], partitive [please provide])
hoiatus	Noun	hoiatus (genitive [please provide], partitive [please provide])
toom	Noun	toom (genitive toome, partitive toome)
riietumine	Noun	riietumine (genitive riietumise, partitive riietumist)
hing	Noun	hing (genitive hinge, partitive hinge)
hing	Noun	hing (genitive hinge, partitive hinge)
nelik	Noun	nelik (genitive neliku, partitive nelikut)
lind	Noun	lind (genitive linnu, partitive lindu)
vile	Noun	vile (genitive vile, partitive vilet)
kude	Noun	kude (genitive koe, partitive kude)
kohvimasin	Noun	kohvimasin (genitive kohvimasina, partitive kohvimasinat)
masin	Noun	masin (genitive masina, partitive masinat)
naarits	Noun	naarits (genitive [please provide], partitive [please provide])
aastasada	Noun	aastasada (genitive aastasaja, partitive aastasada)
kastekann	Noun	kastekann (genitive [please provide], partitive [please provide])
löök	Noun	löök (genitive löögi, partitive lööki)
orb	Noun	orb (genitive orvu, partitive orbu)
äike	Noun	äike (genitive äikese, partitive äikest)
rahvastikuteadus	Noun	rahvastikuteadus (genitive rahvastikuteaduse, partitive rahvastikuteadust)
raekoda	Noun	raekoda (genitive raekoja, partitive raekoda)
bohrium	Noun	bohrium (genitive bohriumi, partitive bohriumi or bohriumit)
astronoomia	Noun	astronoomia (genitive [please provide], partitive [please provide])
feromoon	Noun	feromoon (genitive [please provide], partitive [please provide])
laug	Noun	laug (genitive lau, partitive laugu)
tsaar	Noun	tsaar (genitive [please provide], partitive [please provide])
vihik	Noun	vihik (genitive vihiku, partitive vihikut)
põrgu	Noun	põrgu (genitive põrgu, partitive põrgut)
leer	Noun	leer (genitive leeri, partitive leeri)
leer	Noun	leer (genitive leeri, partitive leeri)
somm	Noun	somm (genitive sommi, partitive sommi)
puri	Noun	puri (genitive purje, partitive purje)
kääbus	Noun	kääbus (genitive kääbuse, partitive kääbust)
vikerkaarelipp	Noun	vikerkaarelipp (genitive [please provide], partitive [please provide])
psühholoog	Noun	psühholoog (genitive [please provide], partitive [please provide])
eset	Noun	eset
ploom	Noun	ploom (genitive [please provide], partitive [please provide])
helmekuu	Noun	helmekuu (genitive helmekuu, partitive helmekuud)
tšerokii keel	Noun	tšerokii keel
toorium	Noun	toorium (genitive tooriumi, partitive tooriumi or tooriumit)
enda	Noun	enda (genitive enda, partitive end)
võim	Noun	võim (genitive [please provide], partitive [please provide])
hüümen	Noun	hüümen (genitive hüümeni, partitive hüümenit)
ais	Noun	ais (genitive [please provide], partitive [please provide])
triple sec	Noun	triple sec (genitive triple sec'i, partitive triple sec'i)
meest	Noun	meest
nuss	Noun	nuss (genitive nussi, partitive nussi)
algus	Noun	algus (genitive alguse, partitive algust)
haud	Noun	haud (genitive [please provide], partitive [please provide])
niit	Noun	niit (genitive niidi, partitive niiti)
ovaal	Noun	ovaal (genitive [please provide], partitive [please provide])
hõbemedal	Noun	hõbemedal (genitive hõbemedali, partitive hõbemedalit)
lause	Noun	lause (genitive lause, partitive lauset)
moldovlane	Noun	moldovlane (genitive moldovlase, partitive moldovlast)
ehitis	Noun	ehitis (genitive ehitise, partitive ehitist)
koma	Noun	koma (genitive [please provide], partitive [please provide])
kinaver	Noun	kinaver (genitive kinaveri, partitive kinaveri)
täis	Noun	täis
kurk	Noun	kurk (genitive kurgu, partitive kurku)
kurk	Noun	kurk (genitive kurgi, partitive kurki)
roimar	Noun	roimar (genitive roimari, partitive roimarit)
kagu	Noun	kagu (genitive kagu, partitive kagu)
seemnepurse	Noun	seemnepurse (genitive seemnepurske, partitive seemnepurset)
rauk	Noun	rauk (genitive rauga, partitive rauka)
jeen	Noun	jeen (genitive [please provide], partitive [please provide])
purikas	Noun	purikas (genitive [please provide], partitive [please provide])
tiss	Noun	tiss (genitive [please provide], partitive [please provide])
nööp	Noun	nööp (genitive nööbi, partitive nööpi)
vitt	Noun	vitt (genitive vitu, partitive vittu)
kriips	Noun	kriips (genitive [please provide], partitive [please provide])
pagan	Noun	pagan (genitive pagana, partitive paganat)
tasu	Noun	tasu (genitive tasu, partitive tasu)
muld	Noun	muld (genitive mulla, partitive mulda)
üü	Noun	üü (genitive [please provide], partitive [please provide])
rabi	Noun	rabi (genitive [please provide], partitive [please provide])
vask	Noun	vask (genitive [please provide], partitive [please provide])
luule	Noun	luule (genitive luule, partitive luulet)
luule	Noun	luule
poeg	Noun	poeg (genitive poja, partitive poega)
puuvili	Noun	puuvili (genitive puuvilja, partitive puuvilja)
viis	Noun	viis (genitive viisi, partitive viisi)
mihklikuu	Noun	mihklikuu (genitive mihklikuu, partitive mihklikuud)
inglane	Noun	inglane (genitive inglase, partitive inglast)
riist	Noun	riist (genitive riista, partitive riista)
kaan	Noun	kaan (genitive [please provide], partitive [please provide])
häbe	Noun	häbe (genitive häbeme, partitive häbet)
kesksõna	Noun	kesksõna (genitive kesksõna, partitive kesksõna)
pingviin	Noun	pingviin (genitive [please provide], partitive [please provide])
hämarik	Noun	hämarik (genitive hämariku, partitive hämarikku)
katseklaas	Noun	katseklaas (genitive [please provide], partitive [please provide])
sõsar	Noun	sõsar (genitive sõsara, partitive sõsarat)
tarvas	Noun	tarvas (genitive tarva, partitive tarvast)
karu	Noun	karu (genitive karu, partitive karu)
tekst	Noun	tekst (genitive [please provide], partitive [please provide])
palee	Noun	palee (genitive [please provide], partitive [please provide])
hakkliha	Noun	hakkliha (genitive hakkliha, partitive hakkliha)
till	Noun	till (genitive tilli, partitive tilli)
õpetus	Noun	õpetus (genitive õpetuse, partitive õpetust)
jaan	Noun	jaan (genitive jaani, partitive jaani)
õigekeelsussõnaraamat	Noun	õigekeelsussõnaraamat (genitive õigekeelsussõnaraamatu, partitive õigekeelsussõnaraamatut)
pöör	Noun	pöör (genitive pööra, partitive pööra)
püü	Noun	püü (genitive püü, partitive püüd)
menu	Noun	menu (genitive menu, partitive menu)
baleriin	Noun	baleriin (genitive baleriini, partitive baleriini)
ester	Noun	ester (genitive estri, partitive estrit)
kalamari	Noun	kalamari (genitive kalamarja, partitive kalamarja)
šeik	Noun	šeik (genitive [please provide], partitive [please provide])
naine	Noun	naine (genitive naise, partitive naist)
kaplan	Noun	kaplan (genitive kaplani, partitive kaplanit)
valge kääbus	Noun	valge kääbus
kompvek	Noun	kompvek (genitive kompveki, partitive kompvekki)
kapral	Noun	kapral (genitive kaprali, partitive kapralit)
jalga	Noun	jalga
kiiruluu	Noun	kiiruluu (genitive kiiruluu, partitive kiiruluud)
oliviin	Noun	oliviin (genitive [please provide], partitive [please provide])
rand	Noun	rand (genitive ranna, partitive randa)
raud	Noun	raud (genitive raua, partitive rauda)
pärak	Noun	pärak (genitive päraku, partitive pärakut)
valetaja	Noun	valetaja (genitive valetaja, partitive valetajat)
käskjalg	Noun	käskjalg (genitive [please provide], partitive [please provide])
näiline	Noun	näiline (genitive näilise, partitive näilist)
mõtlemine	Noun	mõtlemine (genitive mõtlemise, partitive mõtlemist)
õpetamine	Noun	õpetamine (genitive õpetamise, partitive õpetamist)
suguvõsa	Noun	suguvõsa (genitive suguvõsa, partitive suguvõsa)
lugu	Noun	lugu (genitive loo, partitive lugu)
mošee	Noun	mošee (genitive mošee, partitive mošeed)
raam	Noun	raam (genitive raami, partitive raami)
märklaud	Noun	märklaud (genitive märklaua, partitive märklauda)
taani keel	Noun	taani keel
tase	Noun	tase (genitive [please provide], partitive [please provide])
umbtee	Noun	umbtee (genitive umbtee, partitive umbteed)
looja	Noun	looja (genitive [please provide], partitive [please provide])
öö	Noun	öö (genitive öö, partitive ööd)
öö	Noun	öö (genitive [please provide], partitive [please provide])
seksinälg	Noun	seksinälg (genitive seksinälja, partitive seksinälga)
grusiin	Noun	grusiin (genitive grusiini, partitive grusiini)
kasu	Noun	kasu (genitive kasu, partitive kasu)
arutlus	Noun	arutlus (genitive [please provide], partitive [please provide])
tosin	Noun	tosin (genitive tosina, partitive tosinat)
selja	Noun	selja
pool	Noun	pool (genitive poole, partitive poolt)
pool	Noun	pool (genitive pooli, partitive pooli)
vilk	Noun	vilk (genitive [please provide], partitive [please provide])
kaubamärk	Noun	kaubamärk (genitive [please provide], partitive [please provide])
biofüüsika	Noun	biofüüsika (genitive [please provide], partitive [please provide])
türm	Noun	türm (genitive [please provide], partitive [please provide])
öötöö	Noun	öötöö (genitive öötöö, partitive öötööd)
tuletõrjuja	Noun	tuletõrjuja (genitive tuletõrjuja, partitive tuletõrjujat)
mootorratas	Noun	mootorratas (genitive mootorratta, partitive mootorratast)
nälg	Noun	nälg (genitive nälja, partitive nälga)
poomissurm	Noun	poomissurm (genitive poomissurma, partitive poomissurma)
plats	Noun	plats (genitive platsi, partitive platsi)
päev	Noun	päev (genitive päeva, partitive päeva)
naatrium	Noun	naatrium (genitive naatriumi, partitive naatriumi or naatriumit)
tegija	Noun	tegija (genitive tegija, partitive tegijat)
ase	Noun	ase (genitive aseme, partitive aset)
rändaja	Noun	rändaja (genitive rändaja, partitive rändajat)
fermium	Noun	fermium (genitive fermiumi, partitive fermiumi or fermiumit)
sihtasutus	Noun	sihtasutus (genitive [please provide], partitive [please provide])
südameatakk	Noun	südameatakk (genitive [please provide], partitive [please provide])
pisaraluu	Noun	pisaraluu (genitive pisaraluu, partitive pisaraluud)
teemant	Noun	teemant (genitive [please provide], partitive [please provide])
nääre	Noun	nääre (genitive [please provide], partitive [please provide])
tsentromeer	Noun	tsentromeer (genitive [please provide], partitive [please provide])
laager	Noun	laager (genitive laagri, partitive laagrit)
varvas	Noun	varvas (genitive varba, partitive varvast)
ilu	Noun	ilu (genitive ilu, partitive ilu)
kloor	Noun	kloor (genitive [please provide], partitive [please provide])
geneetika	Noun	geneetika (genitive [please provide], partitive [please provide])
diskriminatsioon	Noun	diskriminatsioon (genitive [please provide], partitive [please provide])
korrus	Noun	korrus (genitive korruse, partitive korruse)
helmes	Noun	helmes (genitive helme, partitive helmest)
sõber	Noun	sõber (genitive sõbra, partitive sõpra)
ununseptium	Noun	ununseptium (genitive ununseptiumi, partitive ununseptiumi or ununseptiumit)
promeetium	Noun	promeetium (genitive promeetiumi, partitive promeetiumi or promeetiumit)
ilves	Noun	ilves (genitive ilvese, partitive ilvest)
rämps	Noun	rämps (genitive rämpsu, partitive rämpsu)
kääne	Noun	kääne (genitive käände, partitive käänet)
džiip	Noun	džiip (genitive [please provide], partitive [please provide])
planktonoloogia	Noun	planktonoloogia (genitive [please provide], partitive [please provide])
erootika	Noun	erootika (genitive erootika, partitive erootikat)
emme	Noun	emme (genitive emme, partitive emmet)
õhujõud	Noun	õhujõud (genitive [please provide], partitive [please provide])
deism	Noun	deism (genitive [please provide], partitive [please provide])
iva	Noun	iva (genitive [please provide], partitive [please provide])
alküün	Noun	alküün (genitive [please provide], partitive [please provide])
rumm	Noun	rumm (genitive [please provide], partitive [please provide])
kuritegu	Noun	kuritegu (genitive kuriteo, partitive kuritegu)
intervjuu	Noun	intervjuu (genitive intervjuu, partitive intervjuud)
määrsõna	Noun	määrsõna (genitive määrsõna, partitive määrsõna)
nimekaim	Noun	nimekaim (genitive nimekaimu, partitive nimekaimu)
ajalugu	Noun	ajalugu (genitive ajaloo, partitive ajalugu)
kaalium	Noun	kaalium (genitive kaaliumi, partitive kaaliumi or kaaliumit)
värdjas	Noun	värdjas (genitive värdja, partitive värdjat)
telefon	Noun	telefon (genitive telefoni, partitive telefoni)
luid	Noun	luid
himu	Noun	himu (genitive [please provide], partitive [please provide])
redis	Noun	redis (genitive redise, partitive redist)
vine	Noun	vine (genitive vine, partitive vinet)
endisaeg	Noun	endisaeg (genitive endisaja, partitive endisaega)
pidamine	Noun	pidamine (genitive pidamise, partitive pidamist)
vaheldus	Noun	vaheldus (genitive [please provide], partitive [please provide])
hüpiknukk	Noun	hüpiknukk (genitive [please provide], partitive [please provide])
vanus	Noun	vanus (genitive [please provide], partitive [please provide])
seksuaalne orientatsioon	Noun	seksuaalne orientatsioon
kass	Noun	kass (genitive kassi, partitive kassi)
salat	Noun	salat (genitive salati, partitive salatit)
rahvus	Noun	rahvus (genitive rahvuse, partitive rahvust)
pillu	Noun	pillu
maak	Noun	maak (genitive [please provide], partitive [please provide])
maavald	Noun	maavald (genitive maavalla, partitive maavalda)
õlg	Noun	õlg (genitive õla, partitive õlga)
õlg	Noun	õlg (genitive õle, partitive õlge)
tervis	Noun	tervis (genitive tervise, partitive tervist)
šoti keel	Noun	šoti keel
kaja	Noun	kaja (genitive [please provide], partitive [please provide])
jääpurikas	Noun	jääpurikas (genitive jääpurika, partitive jääpurikat)
enesetapp	Noun	enesetapp (genitive enesetapu, partitive enesetappu)
pirnipuu	Noun	pirnipuu (genitive pirnipuu, partitive pirnipuud)
biseksuaal	Noun	biseksuaal (genitive biseksuaali, partitive biseksuaali)
koobas	Noun	koobas (genitive koopa, partitive koobast)
viroloog	Noun	viroloog (genitive [please provide], partitive [please provide])
vennatütar	Noun	vennatütar (genitive vennatütre, partitive vennatütart)
eelarve	Noun	eelarve (genitive eelarve, partitive eelarvet)
eutanaasia	Noun	eutanaasia (genitive [please provide], partitive [please provide])
aste	Noun	aste (genitive astme, partitive astet)
atmosfäär	Noun	atmosfäär (genitive [please provide], partitive [please provide])
düsproosium	Noun	düsproosium (genitive düsproosiumi, partitive düsproosiumi or düsproosiumit)
lohe	Noun	lohe (genitive lohe, partitive lohet)
sümptom	Noun	sümptom (genitive sümptomi, partitive sümptomit)
jäätis	Noun	jäätis (genitive jäätise, partitive jäätist)
huvi	Noun	huvi (genitive [please provide], partitive [please provide])
täi	Noun	täi (genitive täi, partitive täid)
vangla	Noun	vangla (genitive [please provide], partitive [please provide])
pealuu	Noun	pealuu (genitive pealuu, partitive pealuud)
šampoon	Noun	šampoon (genitive šampooni, partitive šampooni)
jää-äär	Noun	jää-äär (genitive jää-ääre, partitive jää-äärt)
kips	Noun	kips (genitive [please provide], partitive [please provide])
õhtusöök	Noun	õhtusöök (genitive [please provide], partitive [please provide])
narkolepsia	Noun	narkolepsia (genitive [please provide], partitive [please provide])
aktinoid	Noun	aktinoid (genitive [please provide], partitive [please provide])
lennujaam	Noun	lennujaam (genitive [please provide], partitive [please provide])
kelm	Noun	kelm (genitive kelmi, partitive kelmi)
hind	Noun	hind (genitive hinna, partitive hinda)
hõljumiteadus	Noun	hõljumiteadus (genitive [please provide], partitive [please provide])
laut	Noun	laut (genitive lauda, partitive lauta)
morfiin	Noun	morfiin (genitive [please provide], partitive [please provide])
büroo	Noun	büroo (genitive büroo, partitive bürood)
parasiit	Noun	parasiit (genitive parasiidi, partitive parasiiti)
lamp	Noun	lamp (genitive lambi, partitive lampi)
faasan	Noun	faasan (genitive faasani, partitive faasanit)
boikott	Noun	boikott (genitive [please provide], partitive [please provide])
tellimus	Noun	tellimus (genitive tellimuse, partitive tellimust)
higi	Noun	higi (genitive higi, partitive higi)
varas	Noun	varas (genitive varga, partitive varast)
kari	Noun	kari (genitive karja, partitive karja)
kari	Noun	kari (genitive kari, partitive kari)
kari	Noun	kari (genitive kari, partitive kari)
teisipäev	Noun	teisipäev (genitive teisipäeva, partitive teisipäeva)
loode	Noun	loode (genitive loote, partitive loodet)
loode	Noun	loode (genitive loode, partitive loodet)
loode	Noun	loode
lastehaigla	Noun	lastehaigla (genitive [please provide], partitive [please provide])
kupriit	Noun	kupriit (genitive [please provide], partitive [please provide])
lehm	Noun	lehm (genitive lehma, partitive lehma)
frantsium	Noun	frantsium (genitive frantsiumi, partitive frantsiumi or frantsiumit)
sünonüüm	Noun	sünonüüm (genitive sünonüümi, partitive sünonüümi)
käsitlus	Noun	käsitlus (genitive käsitluse, partitive käsitlust)
pirn	Noun	pirn (genitive pirni, partitive pirni)
oim	Noun	oim (genitive oimu, partitive oimu)
politseiriik	Noun	politseiriik (genitive politseiriigi, partitive [please provide])
ejakulatsioon	Noun	ejakulatsioon (genitive ejakulatsiooni, partitive ejakulatsiooni)
põleng	Noun	põleng (genitive [please provide], partitive [please provide])
kiiktool	Noun	kiiktool (genitive [please provide], partitive [please provide])
veoauto	Noun	veoauto (genitive [please provide], partitive [please provide])
moraal	Noun	moraal (genitive [please provide], partitive [please provide])
kurat	Noun	kurat (genitive kuradi, partitive kuradit)
süsinik	Noun	süsinik (genitive [please provide], partitive [please provide])
hetk	Noun	hetk (genitive hetke, partitive hetke)
ligniin	Noun	ligniin (genitive [please provide], partitive [please provide])
piin	Noun	piin (genitive piina, partitive piina)
armastuskiri	Noun	armastuskiri (genitive [please provide], partitive [please provide])
ruut	Noun	ruut (genitive ruudu, partitive ruutu)
seen	Noun	seen (genitive [please provide], partitive [please provide])
omadussõna	Noun	omadussõna (genitive omadussõna, partitive omadussõna)
viin	Noun	viin (genitive viina, partitive viina)
absint	Noun	absint (genitive absindi, partitive absinti)
häbemekink	Noun	häbemekink (genitive häbemekingu, partitive häbemekinku)
volber	Noun	volber (genitive volbri, partitive volbrit)
greif	Noun	greif (genitive greifi, partitive greifi)
kuldmedal	Noun	kuldmedal (genitive kuldmedali, partitive kuldmedalit)
sõiduk	Noun	sõiduk (genitive sõiduki, partitive sõidukit)
koobalt	Noun	koobalt (genitive [please provide], partitive [please provide])
hall hunt	Noun	hall hunt
korv	Noun	korv (genitive korvi, partitive korvi)
iha	Noun	iha (genitive iha, partitive iha)
hool	Noun	hool (genitive hoole, partitive hoolt)
söök	Noun	söök (genitive söögi, partitive sööki)
ukrainlane	Noun	ukrainlane (genitive ukrainlase, partitive ukrainlast)
sort	Noun	sort (genitive riigi, partitive riiki)
lehtpuu	Noun	lehtpuu (genitive lehtpuu, partitive lehtpuud)
jääaeg	Noun	jääaeg (genitive jääaja, partitive jääaja)
isand	Noun	isand (genitive isanda, partitive isandat)
ristkülik	Noun	ristkülik (genitive ristküliku, partitive ristkülikut)
klaviatuur	Noun	klaviatuur (genitive klaviatuuri, partitive klaviatuuri)
kube	Noun	kube (genitive [please provide], partitive [please provide])
kusi	Noun	kusi (genitive kuse, partitive kust)
laad	Noun	laad (genitive laadi, partitive laadi)
muusika	Noun	muusika (genitive [please provide], partitive [please provide])
tseesium	Noun	tseesium (genitive tseesiumi, partitive tseesiumi or tseesiumit)
pätt	Noun	pätt (genitive päti, partitive pätti)
mõnu	Noun	mõnu (genitive mõnu, partitive mõnu)
pagar	Noun	pagar (genitive pagari, partitive pagarit)
astronoomiline ühik	Noun	astronoomiline ühik
muru	Noun	muru (genitive muru, partitive muru)
seeme	Noun	seeme (genitive seemne, partitive seemet)
kvaliteet	Noun	kvaliteet (genitive [please provide], partitive [please provide])
kangelane	Noun	kangelane (genitive kangelase, partitive kangelast)
padi	Noun	padi (genitive padja, partitive patja)
hõlmkuu	Noun	hõlmkuu (genitive hõlmkuu, partitive hõlmkuud)
aeg	Noun	aeg (genitive aja, partitive aega)
tööstus	Noun	tööstus (genitive tööstuse, partitive tööstust)
koeõpetus	Noun	koeõpetus (genitive [please provide], partitive [please provide])
ii	Noun	ii (genitive [please provide], partitive [please provide])
eine	Noun	eine (genitive eine, partitive einet)
füüsika	Noun	füüsika (genitive füüsika, partitive füüsikat)
kaas	Noun	kaas (genitive kaane, partitive kaant)
aastatuhat	Noun	aastatuhat (genitive aastatuhande, partitive aastatuhandet)
protsent	Noun	protsent (genitive [please provide], partitive [please provide])
ülikool	Noun	ülikool (genitive ülikooli, partitive ülikooli)
romu	Noun	romu (genitive romu, partitive romu)
meskaliin	Noun	meskaliin (genitive [please provide], partitive [please provide])
jaam	Noun	jaam (genitive jaama, partitive jaama)
keskmine	Noun	keskmine (genitive keskmise, partitive keskmist)
leiutis	Noun	leiutis (genitive leiutise, partitive leiutist)
kiird	Noun	kiird (genitive kiiru, partitive kiirdu)
agu	Noun	agu (genitive ao, partitive agu)
pepu	Noun	pepu (genitive pepu, partitive peput)
beebi	Noun	beebi (genitive [please provide], partitive [please provide])
immunoloogia	Noun	immunoloogia (genitive [please provide], partitive [please provide])
sfäär	Noun	sfäär (genitive sfääri, partitive sfääri)
pede	Noun	pede (genitive pede, partitive pedet)
kaelkirjak	Noun	kaelkirjak (genitive kaelkirjaku, partitive kaelkirjakut)
elektrilöök	Noun	elektrilöök (genitive [please provide], partitive [please provide])
valimine	Noun	valimine (genitive valimise, partitive valimist)
medal	Noun	medal (genitive [please provide], partitive [please provide])
parallaks	Noun	parallaks (genitive [please provide], partitive [please provide])
ike	Noun	ike (genitive [please provide], partitive [please provide])
teadvus	Noun	teadvus (genitive [please provide], partitive [please provide])
aatom	Noun	aatom (genitive aatomi, partitive aatomit)
tuli	Noun	tuli (genitive tule, partitive tuld)
vihmavari	Noun	vihmavari (genitive vihmavarju, partitive [please provide])
külmrelv	Noun	külmrelv (genitive külmrelva, partitive külmrelva)
burks	Noun	burks (genitive burksi, partitive burksi)
roojamine	Noun	roojamine (genitive roojamise, partitive roojamist)
õpik	Noun	õpik (genitive õpiku, partitive õpikut)
side	Noun	side (genitive sideme, partitive sidet)
side	Noun	side (genitive side, partitive sidet)
klass	Noun	klass (genitive klassi, partitive klassi)
jänes	Noun	jänes (genitive jänese, partitive jänest)
nimisõna	Noun	nimisõna (genitive nimisõna, partitive nimisõna)
liivi	Noun	liivi (genitive liivi, partitive liivit)
aadress	Noun	aadress (genitive aadressi, partitive aadressi)
berüll	Noun	berüll (genitive [please provide], partitive [please provide])
hoor	Noun	hoor (genitive hoora, partitive hoora)
armeenlane	Noun	armeenlane (genitive armeenlase, partitive armeenlast)
raibe	Noun	raibe (genitive raipe, partitive raibet)
saatus	Noun	saatus (genitive saatuse, partitive saatust)
jaa	Noun	jaa (genitive jaa, partitive jaad)
sammas	Noun	sammas (genitive samba, partitive sammast)
rebane	Noun	rebane (genitive rebase, partitive rebast)
fluor	Noun	fluor (genitive [please provide], partitive [please provide])
kallistus	Noun	kallistus (genitive kallistuse, partitive kallistust)
pilet	Noun	pilet (genitive pileti, partitive piletit)
mustluik	Noun	mustluik (genitive mustluige, partitive mustluike)
bensiin	Noun	bensiin (genitive [please provide], partitive [please provide])
häkker	Noun	häkker (genitive häkkeri, partitive häkkerit)
roie	Noun	roie (genitive roide, partitive roiet)
valdaja	Noun	valdaja (genitive valdaja, partitive valdajat)
öölaud	Noun	öölaud (genitive [please provide], partitive [please provide])
refrään	Noun	refrään (genitive refrääni, partitive refrääni)
ihu	Noun	ihu (genitive ihu, partitive ihu)
kolmik	Noun	kolmik (genitive kolmiku, partitive kolmikut)
kevad	Noun	kevad (genitive kevade, partitive kevadet)
poolakas	Noun	poolakas (genitive poolaka, partitive poolakat)
marihuaana	Noun	marihuaana (genitive [please provide], partitive [please provide])
kütus	Noun	kütus (genitive [please provide], partitive [please provide])
aju	Noun	aju (genitive aju, partitive aju)
rahvas	Noun	rahvas (genitive rahva, partitive rahvast)
nõukogu	Noun	nõukogu (genitive nõukogu, partitive nõukogu)
sugu	Noun	sugu (genitive soo, partitive sugu)
kann	Noun	kann (genitive kannu, partitive kannu)
kann	Noun	kann (genitive kanni, partitive kanni)
isamaa	Noun	isamaa (genitive isamaa, partitive isamaad)
programm	Noun	programm (genitive [please provide], partitive [please provide])
rist	Noun	rist (genitive risti, partitive risti)
katedraal	Noun	katedraal (genitive katedraali, partitive katedraali)
klaver	Noun	klaver (genitive klaveri, partitive klaverit)
lantanoid	Noun	lantanoid (genitive [please provide], partitive [please provide])
viina	Noun	viina
kivi	Noun	kivi (genitive kivi, partitive kivi)
pärastlõuna	Noun	pärastlõuna (genitive pärastlõuna, partitive pärastlõunat)
õhusõiduk	Noun	õhusõiduk (genitive [please provide], partitive [please provide])
grimass	Noun	grimass (genitive [please provide], partitive [please provide])
kõrvits	Noun	kõrvits (genitive kõrvitsa, partitive kõrvitsat)
jaanipäev	Noun	jaanipäev (genitive [please provide], partitive [please provide])
teke	Noun	teke (genitive tekke, partitive teket)
linnus	Noun	linnus (genitive [please provide], partitive [please provide])
artikkel	Noun	artikkel (genitive artikli, partitive artiklit)
politsei	Noun	politsei (genitive politsei, partitive politseid)
maailmajagu	Noun	maailmajagu (genitive maailmajao, partitive maailmajagu)
süü	Noun	süü (genitive süü, partitive süüd)
nussija	Noun	nussija (genitive [please provide], partitive [please provide])
võit	Noun	võit (genitive võidu, partitive võitu)
väärjumal	Noun	väärjumal (genitive väärjumala, partitive väärjumalat)
oht	Noun	oht (genitive ohu, partitive ohtu)
protaktiinium	Noun	protaktiinium (genitive protaktiiniumi, partitive protaktiiniumi or protaktiiniumit)
ess	Noun	ess (genitive [please provide], partitive [please provide])
seks	Noun	seks (genitive seksi, partitive seksi)
nõmm	Noun	nõmm (genitive [please provide], partitive [please provide])
ollus	Noun	ollus (genitive olluse, partitive ollust)
võõras	Noun	võõras (genitive võõra, partitive võõrast)
november	Noun	november (genitive novembri, partitive novembrit)
juht	Noun	juht (genitive juhi, partitive juhti)
traditsioon	Noun	traditsioon (genitive [please provide], partitive [please provide])
mälu	Noun	mälu (genitive mälu, partitive mälu)
ekvaator	Noun	ekvaator (genitive ekvaatori, partitive ekvaatorit)
koha	Noun	koha (genitive koha, partitive koha)
koha	Noun	koha (genitive koha, partitive koha)
koha	Noun	koha
enne	Noun	enne (genitive ende, partitive ennet)
kõõm	Noun	kõõm (genitive kõõma, partitive kõõma)
operatsioon	Noun	operatsioon (genitive [please provide], partitive [please provide])
kaal	Noun	kaal (genitive kaalu, partitive kaalu)
liim	Noun	liim (genitive [please provide], partitive [please provide])
rohi	Noun	rohi (genitive rohu, partitive rohtu)
lõikuskuu	Noun	lõikuskuu (genitive lõikuskuu, partitive lõikuskuud)
vinüül	Noun	vinüül (genitive [please provide], partitive [please provide])
õõ	Noun	õõ (genitive [please provide], partitive [please provide])
lämmastik	Noun	lämmastik (genitive [please provide], partitive [please provide])
vabadus	Noun	vabadus (genitive vabaduse, partitive vabadust)
klamber	Noun	klamber (genitive klambri, partitive klambrit)
dee	Noun	dee (genitive [please provide], partitive [please provide])
insener	Noun	insener (genitive inseneri, partitive inseneri)
prügikott	Noun	prügikott (genitive [please provide], partitive [please provide])
õgard	Noun	õgard (genitive [please provide], partitive [please provide])
poloonium	Noun	poloonium (genitive polooniumi, partitive polooniumi or polooniumit)
biotiit	Noun	biotiit (genitive [please provide], partitive [please provide])
rukis	Noun	rukis (genitive rukki, partitive rukkist)
armee	Noun	armee (genitive armee, partitive armee)
teekann	Noun	teekann (genitive [please provide], partitive [please provide])
küberseks	Noun	küberseks (genitive küberseksi, partitive küberseksi)
pensionär	Noun	pensionär (genitive pensionäri, partitive pensionäri)
joogiklaas	Noun	joogiklaas (genitive [please provide], partitive [please provide])
koolivorm	Noun	koolivorm (genitive [please provide], partitive [please provide])
leek	Noun	leek (genitive leegi, partitive leeki)
literatuur	Noun	literatuur (genitive literatuuri, partitive literatuuri)
zee	Noun	zee (genitive [please provide], partitive [please provide])
proua	Noun	proua (genitive proua, partitive prouat)
käekell	Noun	käekell (genitive käekella, partitive käekella)
heinakuu	Noun	heinakuu (genitive heinakuu, partitive heinakuud)
neel	Noun	neel (genitive [please provide], partitive [please provide])
süda	Noun	süda (genitive südame, partitive südant)
õile	Noun	õile (genitive õilme, partitive õilet)
baar	Noun	baar (genitive [please provide], partitive [please provide])
lillevaas	Noun	lillevaas (genitive [please provide], partitive [please provide])
katus	Noun	katus (genitive katuse, partitive katust)
turg	Noun	turg (genitive turu, partitive turgu)
vesimelon	Noun	vesimelon (genitive vesimeloni, partitive vesimelonit)
Ameerika Ühendriikide dollar	Noun	Ameerika Ühendriikide dollar
tugevus	Noun	tugevus (genitive tugevuse, partitive tugevust)
kaevik	Noun	kaevik (genitive kaeviku, partitive kaevikut)
värk	Noun	värk (genitive värgi, partitive värki)
lusikas	Noun	lusikas (genitive lusika, partitive lusikat)
sall	Noun	sall (genitive salli, partitive salli)
konjak	Noun	konjak (genitive [please provide], partitive [please provide])
sidrun	Noun	sidrun (genitive sidruni, partitive sidrunit)
hari	Noun	hari (genitive harja, partitive harja)
kirss	Noun	kirss (genitive kirsi, partitive kirssi)
lojus	Noun	lojus (genitive lojuse, partitive lojust)
siirup	Noun	siirup (genitive siirupi, partitive siirupit)
ilm	Noun	ilm (genitive ilma, partitive ilma)
lõbumaja	Noun	lõbumaja (genitive [please provide], partitive [please provide])
sein	Noun	sein (genitive seina, partitive seina)
hiis	Noun	hiis (genitive hiie, partitive hiit)
holmium	Noun	holmium (genitive holmiumi, partitive holmiumi or holmiumit)
odekolonn	Noun	odekolonn (genitive [please provide], partitive [please provide])
taristu	Noun	taristu (genitive [please provide], partitive [please provide])
fantoom	Noun	fantoom (genitive [please provide], partitive [please provide])
surm	Noun	surm (genitive surma, partitive surma)
kaarik	Noun	kaarik (genitive kaariku, partitive kaarikut)
õppimine	Noun	õppimine (genitive õppimise, partitive õppimist)
kiilkiri	Noun	kiilkiri (genitive [please provide], partitive [please provide])
argoon	Noun	argoon (genitive [please provide], partitive [please provide])
jott	Noun	jott (genitive [please provide], partitive [please provide])
haliit	Noun	haliit (genitive [please provide], partitive [please provide])
heraldika	Noun	heraldika (genitive [please provide], partitive [please provide])
ülikond	Noun	ülikond (genitive ülikonna, partitive ülikonda)
seksism	Noun	seksism (genitive [please provide], partitive [please provide])
sissetulek	Noun	sissetulek (genitive sissetuleku, partitive sissetulekut)
kamm	Noun	kamm (genitive kammi, partitive kammi)
rähn	Noun	rähn (genitive rähni, partitive rähni)
kodanik	Noun	kodanik (genitive [please provide], partitive [please provide])
prantslane	Noun	prantslane (genitive prantslase, partitive prantslast)
seleen	Noun	seleen (genitive [please provide], partitive [please provide])
rind	Noun	rind (genitive rinna, partitive rinda)
kutt	Noun	kutt (genitive kuti, partitive kutti)
künnis	Noun	künnis (genitive künnise, partitive künnist)
funktsioon	Noun	funktsioon (genitive [please provide], partitive [please provide])
aku	Noun	aku (genitive aku, partitive akut)
äär	Noun	äär (genitive ääre, partitive äärt)
mure	Noun	mure (genitive mure, partitive muret)
poliitika	Noun	poliitika (genitive poliitika, partitive poliitikat)
vaher	Noun	vaher (genitive vahtra, partitive vahtrat)
vesinik	Noun	vesinik (genitive vesiniku, partitive vesinikku)
dubnium	Noun	dubnium (genitive dubniumi, partitive dubniumi or dubniumit)
talv	Noun	talv (genitive talve, partitive talve)
nikk	Noun	nikk (genitive niku, partitive nikku)
toit	Noun	toit (genitive toidu, partitive toitu)
samblikuteadus	Noun	samblikuteadus (genitive [please provide], partitive [please provide])
sõnastik	Noun	sõnastik (genitive sõnastiku, partitive sõnastikku)
pipar	Noun	pipar (genitive [please provide], partitive [please provide])
kanarbik	Noun	kanarbik (genitive [please provide], partitive [please provide])
plutoonium	Noun	plutoonium (genitive plutooniumi, partitive plutooniumi or plutooniumit)
laine	Noun	laine (genitive [please provide], partitive [please provide])
riis	Noun	riis (genitive [please provide], partitive [please provide])
auto	Noun	auto (genitive auto, partitive autot)
oga	Noun	oga (genitive [please provide], partitive [please provide])
pall	Noun	pall (genitive palli, partitive palli)
sugupool	Noun	sugupool (genitive [please provide], partitive [please provide])
kell	Noun	kell (genitive kella, partitive kella)
jäätisemasin	Noun	jäätisemasin (genitive jäätisemasina, partitive jäätisemasinat)
ämblik	Noun	ämblik (genitive ämbliku, partitive ämblikku)
juhe	Noun	juhe (genitive juhtme, partitive juhet)
saks	Noun	saks (genitive saksa, partitive saksa)
alam	Noun	alam (genitive alama, partitive alama)
raamat	Noun	raamat (genitive raamatu, partitive raamatut)
tants	Noun	tants (genitive tantsu, partitive tantsu)
puuta	Noun	puuta
kiir	Noun	kiir (genitive kiire, partitive kiirt)
kiir	Noun	kiir (genitive kiiru, partitive kiiru)
kefiir	Noun	kefiir (genitive [please provide], partitive [please provide])
mink	Noun	mink (genitive mingi, partitive minki)
mink	Noun	mink (genitive mingi, partitive minki)
tund	Noun	tund (genitive tunni, partitive tundi)
ununheksium	Noun	ununheksium (genitive ununheksiumi, partitive ununheksiumi or ununheksiumit)
omlett	Noun	omlett (genitive [please provide], partitive [please provide])
vägivald	Noun	vägivald (genitive vägivalla, partitive vägivalda)
ööbik	Noun	ööbik (genitive ööbiku, partitive ööbikut)
lilla	Noun	lilla (genitive [please provide], partitive [please provide])
kaubandus	Noun	kaubandus (genitive kaubanduse, partitive kaubandust)
hoog	Noun	hoog (genitive hoo, partitive hoogu)
puskar	Noun	puskar (genitive puskari, partitive puskarit)
kiik	Noun	kiik (genitive kiige, partitive kiike)
kiik	Noun	kiik (genitive kiigu, partitive kiiku)
oliiviõli	Noun	oliiviõli (genitive [please provide], partitive [please provide])
kult	Noun	kult (genitive kuldi, partitive kulti)
olu	Noun	olu (genitive olu, partitive olu)
jaapani keel	Noun	jaapani keel
määre	Noun	määre (genitive [please provide], partitive [please provide])
germaanium	Noun	germaanium (genitive germaaniumi, partitive germaaniumi or germaaniumit)
laud	Noun	laud (genitive laua, partitive lauda)
mükoloogia	Noun	mükoloogia (genitive [please provide], partitive [please provide])
puhmas	Noun	puhmas (genitive [please provide], partitive [please provide])
kalur	Noun	kalur (genitive kaluri, partitive kalurit)
leelismetall	Noun	leelismetall (genitive [please provide], partitive [please provide])
poiss	Noun	poiss (genitive poisi, partitive poissi)
taara	Noun	taara (genitive [please provide], partitive [please provide])
kuurium	Noun	kuurium (genitive kuuriumi, partitive kuuriumi or kuuriumit)
oimuluu	Noun	oimuluu (genitive oimuluu, partitive oimuluud)
kamber	Noun	kamber (genitive kambri, partitive kambrit)
purse	Noun	purse (genitive purske, partitive purset)
siga	Noun	siga (genitive sea, partitive siga)
pale	Noun	pale (genitive [please provide], partitive [please provide])
dessert	Noun	dessert (genitive [please provide], partitive [please provide])
kapital	Noun	kapital (genitive kapitali, partitive kapitali)
tera	Noun	tera (genitive tera, partitive tera)
leht	Noun	leht (genitive lehe, partitive lehte)
lepp	Noun	lepp (genitive lepa, partitive leppa)
keemia	Noun	keemia (genitive [please provide], partitive [please provide])
tõbi	Noun	tõbi (genitive tõve, partitive tõbe)
radoon	Noun	radoon (genitive [please provide], partitive [please provide])
mais	Noun	mais (genitive [please provide], partitive [please provide])
suura	Noun	suura (genitive suura, partitive suurat)
eos	Noun	eos (genitive [please provide], partitive [please provide])
hüdrobioloogia	Noun	hüdrobioloogia (genitive [please provide], partitive [please provide])
selg	Noun	selg (genitive selja, partitive selga)
otsetõus	Noun	otsetõus (genitive [please provide], partitive [please provide])
eesel	Noun	eesel (genitive eesli, partitive eeslit)
sirel	Noun	sirel (genitive sireli, partitive sirelit)
plii	Noun	plii (genitive plii, partitive pliid)
märk	Noun	märk (genitive märgi, partitive märki)
lumi	Noun	lumi (genitive lume, partitive lund)
sigaret	Noun	sigaret (genitive [please provide], partitive [please provide])
asi	Noun	asi (genitive asja, partitive asja)
rasu	Noun	rasu (genitive [please provide], partitive [please provide])
sekund	Noun	sekund (genitive sekundi, partitive sekundit)
jalg	Noun	jalg (genitive jala, partitive jalga)
sarv	Noun	sarv (genitive sarve, partitive sarve)
vene keel	Noun	vene keel
psühholoogia	Noun	psühholoogia (genitive [please provide], partitive [please provide])
kaamel	Noun	kaamel (genitive kaameli, partitive kaamelit)
mai	Noun	mai (genitive mai, partitive maid)
ütrium	Noun	ütrium (genitive ütriumi, partitive ütriumi or ütriumit)
neoon	Noun	neoon (genitive [please provide], partitive [please provide])
kasulaps	Noun	kasulaps (genitive [please provide], partitive [please provide])
ravi	Noun	ravi (genitive [please provide], partitive [please provide])
jumalus	Noun	jumalus (genitive jumaluse, partitive jumalust)
nahkhiir	Noun	nahkhiir (genitive nahkhiire, partitive nahkhiirt)
asesõna	Noun	asesõna (genitive asesõna, partitive asesõna)
otell	Noun	otell (genitive [please provide], partitive [please provide])
sisselasketorustik	Noun	sisselasketorustik (genitive [please provide], partitive [please provide])
merisiga	Noun	merisiga (genitive [please provide], partitive [please provide])
boliid	Noun	boliid (genitive [please provide], partitive [please provide])
kroonu	Noun	kroonu (genitive kroonu, partitive kroonut)
märgend	Noun	märgend (genitive [please provide], partitive [please provide])
suits	Noun	suits (genitive suitsu, partitive suitsu)
kaamera	Noun	kaamera (genitive [please provide], partitive [please provide])
volfram	Noun	volfram (genitive [please provide], partitive [please provide])
külg	Noun	külg (genitive külje, partitive külge)
ankur	Noun	ankur (genitive ankru, partitive ankrut)
leivanuga	Noun	leivanuga (genitive [please provide], partitive [please provide])
tüdruk	Noun	tüdruk (genitive tüdruku, partitive tüdrukut)
viupart	Noun	viupart (genitive [please provide], partitive [please provide])
varb	Noun	varb (genitive varva, partitive varba)
karboksüülhape	Noun	karboksüülhape (genitive [please provide], partitive [please provide])
keefir	Noun	keefir (genitive keefiri, partitive keefirit)
liin	Noun	liin (genitive [please provide], partitive [please provide])
vannituba	Noun	vannituba (genitive vannitoa, partitive vannituba)
hoidla	Noun	hoidla (genitive [please provide], partitive [please provide])
osa	Noun	osa (genitive osa, partitive osa)
kest	Noun	kest (genitive kesta, partitive kesta)
kasetoht	Noun	kasetoht (genitive kasetohu, partitive kasetohu)
liiper	Noun	liiper (genitive liipri, partitive liiprit)
biskviit	Noun	biskviit (genitive [please provide], partitive [please provide])
tõru	Noun	tõru (genitive tõru, partitive tõru)
hassium	Noun	hassium (genitive hassiumi, partitive hassiumi or hassiumit)
levik	Noun	levik (genitive leviku, partitive levikut)
käli	Noun	käli (genitive käli, partitive käli)
kanuu	Noun	kanuu (genitive kanuu, partitive kanuud)
pull	Noun	pull (genitive pulli, partitive pulli)
nukk	Noun	nukk (genitive nuku, partitive nukku)
žürii	Noun	žürii (genitive žürii, partitive žüriid)
karbonüül	Noun	karbonüül (genitive [please provide], partitive [please provide])
grappa	Noun	grappa (genitive [please provide], partitive [please provide])
kahjurõõm	Noun	kahjurõõm (genitive kahjurõõmu, partitive kahjurõõmu)
õlu	Noun	õlu (genitive õlle, partitive õlut)
nulg	Noun	nulg (genitive [please provide], partitive [please provide])
rahu	Noun	rahu (genitive rahu, partitive rahu)
rahu	Noun	rahu (genitive rahu, partitive rahu)
kastanjett	Noun	kastanjett (genitive [please provide], partitive [please provide])
aaloe	Noun	aaloe (genitive aaloe, partitive aaloed)
huul	Noun	huul (genitive [please provide], partitive [please provide])
paber	Noun	paber (genitive paberi, partitive paberit)
soekuu	Noun	soekuu (genitive soekuu, partitive soekuud)
saalibändi	Noun	saalibändi (genitive [please provide], partitive [please provide])
neljapäev	Noun	neljapäev (genitive neljapäeva, partitive neljapäeva)
kabel	Noun	kabel (genitive kabeli, partitive kabelit)
ööpäev	Noun	ööpäev (genitive [please provide], partitive [please provide])
kabi	Noun	kabi (genitive kabja, partitive kapja)
muna	Noun	muna (genitive muna, partitive muna)
pappel	Noun	pappel (genitive papli, partitive paplit)
inimkaubandus	Noun	inimkaubandus (genitive inimkaubanduse, partitive inimkaubandust)
määrus	Noun	määrus (genitive [please provide], partitive [please provide])
hernesupp	Noun	hernesupp (genitive hernesupi, partitive hernesuppi)
arvsõna	Noun	arvsõna (genitive arvsõna, partitive arvsõna)
manner	Noun	manner (genitive mandri, partitive mandrit)
lips	Noun	lips (genitive [please provide], partitive [please provide])
pruut	Noun	pruut (genitive pruudi, partitive pruuti)
emaplaat	Noun	emaplaat (genitive emaplaadi, partitive emaplaati)
tark	Noun	tark (genitive targa, partitive tarka)
hahk	Noun	hahk (genitive [please provide], partitive [please provide])
ahv	Noun	ahv (genitive ahvi, partitive ahvi)
lauamäng	Noun	lauamäng (genitive [please provide], partitive [please provide])
soomlane	Noun	soomlane (genitive soomlase, partitive soomlast)
protsessor	Noun	protsessor (genitive protsessori, partitive protsessorit)
kulles	Noun	kulles (genitive kullese, partitive kullest)
jumala	Noun	jumala
näitlejanna	Noun	näitlejanna (genitive [please provide], partitive [please provide])
lihhenoloogia	Noun	lihhenoloogia (genitive [please provide], partitive [please provide])
veri	Noun	veri (genitive vere, partitive verd)
detsember	Noun	detsember (genitive detsembri, partitive detsembrit)
vars	Noun	vars (genitive varre, partitive vart)
šampus	Noun	šampus (genitive [please provide], partitive [please provide])
sõtse	Noun	sõtse (genitive sõtse, partitive sõtset)
dolomiit	Noun	dolomiit (genitive [please provide], partitive [please provide])
ala	Noun	ala (genitive ala, partitive ala)
sõdur	Noun	sõdur (genitive sõduri, partitive sõdurit)
nädalapäev	Noun	nädalapäev (genitive nädalapäeva, partitive nädalapäeva)
kasiino	Noun	kasiino (genitive [please provide], partitive [please provide])
tramm	Noun	tramm (genitive trammi, partitive trammi)
heroiin	Noun	heroiin (genitive [please provide], partitive [please provide])
saabas	Noun	saabas (genitive saapa, partitive saabast)
kauboi	Noun	kauboi (genitive kauboi, partitive kauboid)
haug	Noun	haug (genitive haugi, partitive haugi)
linnusitt	Noun	linnusitt (genitive linnusita, partitive linnusitta)
arvutimäng	Noun	arvutimäng (genitive arvutimängu, partitive arvutimängu)
oliivipuu	Noun	oliivipuu (genitive oliivipuu, partitive oliivipuud)
joogivesi	Noun	joogivesi (genitive [please provide], partitive [please provide])
jaht	Noun	jaht (genitive jahi, partitive jahti)
jaht	Noun	jaht (genitive jahi, partitive jahti)
tamm	Noun	tamm (genitive tamme, partitive tamme)
tamm	Noun	tamm (genitive tammi, partitive tammi)
probleem	Noun	probleem (genitive [please provide], partitive [please provide])
leheneeger	Noun	leheneeger (genitive leheneegri, partitive leheneegrit)
kesa	Noun	kesa (genitive kesa, partitive kesa)
tang	Noun	tang (genitive [please provide], partitive [please provide])
põld	Noun	põld (genitive põllu, partitive põldu)
sent	Noun	sent (genitive sendi, partitive senti)
rebu	Noun	rebu (genitive rebu, partitive rebut)
kepp	Noun	kepp (genitive kepi, partitive keppi)
kepp	Noun	kepp (genitive kepi, partitive keppi)
nimi	Noun	nimi (genitive nime, partitive nime)
luu	Noun	luu (genitive luu, partitive luud)
sapp	Noun	sapp (genitive sapi, partitive sappi)
demokraat	Noun	demokraat (genitive [please provide], partitive [please provide])
põhjapõder	Noun	põhjapõder (genitive põhjapõdra, partitive põhjapõtra)
samasooliste abielu	Noun	samasooliste abielu (genitive [please provide], partitive [please provide])
minarett	Noun	minarett (genitive [please provide], partitive [please provide])
astaat	Noun	astaat (genitive [please provide], partitive [please provide])
iharus	Noun	iharus (genitive iharuse, partitive iharust)
rongijaam	Noun	rongijaam (genitive [please provide], partitive [please provide])
kreeka keel	Noun	kreeka keel
ratsu	Noun	ratsu (genitive ratsu, partitive ratsut)
kraana	Noun	kraana (genitive kraana, partitive kraanat)
kodanlus	Noun	kodanlus (genitive kodanluse, partitive kodanlust)
magamistuba	Noun	magamistuba (genitive magamistoa, partitive [please provide])
pärmseened	Noun	pärmseened (genitive [please provide], partitive [please provide])
raudne eesriie	Noun	raudne eesriie
riik	Noun	riik (genitive riigi, partitive riiki)
nuga	Noun	nuga (genitive [please provide], partitive [please provide])
kunde	Noun	kunde (genitive [please provide], partitive [please provide])
kõne	Noun	kõne (genitive kõne, partitive kõnet)
kolju	Noun	kolju (genitive kolju, partitive koljut)
turvaseks	Noun	turvaseks (genitive turvaseksi, partitive turvaseksi)
erinevus	Noun	erinevus (genitive erinevuse, partitive erinevust)
berkeelium	Noun	berkeelium (genitive berkeeliumi, partitive berkeeliumi or berkeeliumit)
kolonelleitnant	Noun	kolonelleitnant (genitive kolonelleitnandi, partitive kolonelleitnanti)
haridus	Noun	haridus (genitive hariduse, partitive haridust)
kokaiin	Noun	kokaiin (genitive [please provide], partitive [please provide])
värvus	Noun	värvus (genitive värvus, partitive värvust)
allkiri	Noun	allkiri (genitive allkirja, partitive allkirja)
elu	Noun	elu (genitive elu, partitive elu)
lõunasöök	Noun	lõunasöök (genitive lõunasöögi, partitive lõunasööki)
tagasõna	Noun	tagasõna (genitive tagasõna, partitive tagasõna)
vanne	Noun	vanne (genitive [please provide], partitive [please provide])
org	Noun	org (genitive [please provide], partitive [please provide])
mastirida	Noun	mastirida (genitive mastirea, partitive mastirida)
elevant	Noun	elevant (genitive [please provide], partitive [please provide])
lääs	Noun	lääs (genitive lääne, partitive läänt)
fopaa	Noun	fopaa (genitive fopaa, partitive fopaad)
maantee	Noun	maantee (genitive maantee, partitive maanteed)
kasvuhoone	Noun	kasvuhoone (genitive [please provide], partitive [please provide])
liitsõna	Noun	liitsõna (genitive [please provide], partitive [please provide])
jugapuu	Noun	jugapuu (genitive jugapuu, partitive jugapuud)
eesnahk	Noun	eesnahk (genitive eesnaha, partitive eesnahka)
põõsas	Noun	põõsas (genitive põõsa, partitive põõsast)
käärid	Noun	käärid (genitive kääride, partitive kääre)
mustikas	Noun	mustikas (genitive mustika, partitive mustikat)
mürsk	Noun	mürsk (genitive mürsu, partitive mürsku)
gaasikamber	Noun	gaasikamber (genitive [please provide], partitive [please provide])
võsa	Noun	võsa (genitive võsa, partitive võsa)
enn	Noun	enn (genitive [please provide], partitive [please provide])
ülihiid	Noun	ülihiid (genitive [please provide], partitive [please provide])
organisatsioon	Noun	organisatsioon (genitive [please provide], partitive [please provide])
kahjum	Noun	kahjum (genitive kahjumi, partitive kahjumit)
öösärk	Noun	öösärk (genitive [please provide], partitive [please provide])
ülalõualuu	Noun	ülalõualuu (genitive ülalõualuu, partitive ülalõualuud)
reenium	Noun	reenium (genitive reeniumi, partitive reeniumi or reeniumit)
kalmaar	Noun	kalmaar (genitive kalmaari, partitive kalmaari)
avamäng	Noun	avamäng (genitive [please provide], partitive [please provide])
mere	Noun	mere
liha	Noun	liha (genitive liha, partitive liha)
orbiit	Noun	orbiit (genitive [please provide], partitive [please provide])
nutatsioon	Noun	nutatsioon (genitive [please provide], partitive [please provide])
poolkuu	Noun	poolkuu (genitive poolkuu, partitive poolkuud)
sotsialism	Noun	sotsialism (genitive [please provide], partitive [please provide])
sink	Noun	sink (genitive singi, partitive sinki)
kiisu	Noun	kiisu (genitive kiisu, partitive kiisut)
õnn	Noun	õnn (genitive õnne, partitive õnne)
kapten	Noun	kapten (genitive kapteni, partitive kaptenit)
abielumees	Noun	abielumees (genitive [please provide], partitive [please provide])
oja	Noun	oja (genitive [please provide], partitive [please provide])
järv	Noun	järv (genitive järve, partitive järve)
nikkuja	Noun	nikkuja (genitive nikkuja, partitive nikkujat)
joba	Noun	joba (genitive joba, partitive joba)
lesk	Noun	lesk (genitive lese, partitive leske)
toonela	Noun	toonela (genitive toonela, partitive toonelat)
valgus	Noun	valgus (genitive valguse, partitive valgust)
säng	Noun	säng (genitive [please provide], partitive [please provide])
otsetabamus	Noun	otsetabamus (genitive otsetabamuse, partitive otsetabamust)
rida	Noun	rida (genitive rea, partitive rida)
kuningas	Noun	kuningas (genitive kuninga, partitive kuningat)
seemnevedelik	Noun	seemnevedelik (genitive seemnevedeliku, partitive seemnevedelikku)
ödeem	Noun	ödeem (genitive [please provide], partitive [please provide])
uni	Noun	uni (genitive une, partitive und)
ribi	Noun	ribi (genitive ribi, partitive ribi)
sperma	Noun	sperma (genitive sperma, partitive spermat)
käik	Noun	käik (genitive käigu, partitive käiku)
jope	Noun	jope (genitive jope, partitive jopet)
laps	Noun	laps (genitive lapse, partitive last)
lendur	Noun	lendur (genitive lenduri, partitive lendurit)
biogeograafia	Noun	biogeograafia (genitive [please provide], partitive [please provide])
liustik	Noun	liustik (genitive [please provide], partitive [please provide])
krabi	Noun	krabi (genitive [please provide], partitive [please provide])
seeneteadus	Noun	seeneteadus (genitive [please provide], partitive [please provide])
jäse	Noun	jäse (genitive [please provide], partitive [please provide])
raadio	Noun	raadio (genitive [please provide], partitive [please provide])
öökull	Noun	öökull (genitive [please provide], partitive [please provide])
süüme	Noun	süüme (genitive [please provide], partitive [please provide])
korter	Noun	korter (genitive korteri, partitive korterit)
fossiil	Noun	fossiil (genitive [please provide], partitive [please provide])
kassiliiv	Noun	kassiliiv (genitive kassiliiva, partitive kassiliiva)
diivan	Noun	diivan (genitive diivani, partitive diivanit)
rekord	Noun	rekord (genitive [please provide], partitive [please provide])
geoloogia	Noun	geoloogia (genitive [please provide], partitive [please provide])
valu	Noun	valu (genitive valu, partitive valu)
valu	Noun	valu (genitive valu, partitive valu)
valu	Noun	valu (genitive valu, partitive valu)
terbium	Noun	terbium (genitive terbiumi, partitive terbiumi or terbiumit)
skolioos	Noun	skolioos (genitive [please provide], partitive [please provide])
vaas	Noun	vaas (genitive vaasi, partitive vaasi)
erektsioon	Noun	erektsioon (genitive erektsiooni, partitive erektsiooni)
püttsepp	Noun	püttsepp (genitive [please provide], partitive [please provide])
aseksuaal	Noun	aseksuaal (genitive aseksuaali, partitive aseksuaali)
siid	Noun	siid (genitive [please provide], partitive [please provide])
metall	Noun	metall (genitive [please provide], partitive [please provide])
saun	Noun	saun (genitive sauna, partitive sauna)
jõehobu	Noun	jõehobu (genitive [please provide], partitive [please provide])
sarnaluu	Noun	sarnaluu (genitive sarnaluu, partitive sarnaluud)
paanika	Noun	paanika (genitive [please provide], partitive [please provide])
sekretär	Noun	sekretär (genitive sekretäri, partitive sekretäri)
laht	Noun	laht (genitive lahe, partitive lahte)
kulla	Noun	kulla
esindus	Noun	esindus (genitive esinduse, partitive esindust)
mahl	Noun	mahl (genitive mahla, partitive mahla)
tegusõna	Noun	tegusõna (genitive tegusõna, partitive tegusõna)
kooljakuu	Noun	kooljakuu (genitive kooljakuu, partitive kooljakuud)
seep	Noun	seep (genitive seebi, partitive seepi)
küsimus	Noun	küsimus (genitive küsimuse, partitive küsimust)
rasv	Noun	rasv (genitive [please provide], partitive [please provide])
nädal	Noun	nädal (genitive nädala, partitive nädalat)
aed	Noun	aed (genitive aia, partitive aeda)
saal	Noun	saal (genitive saali, partitive saali)
neuroloogia	Noun	neuroloogia (genitive [please provide], partitive [please provide])
hõberebane	Noun	hõberebane (genitive hõberebase, partitive hõberebast)
kubism	Noun	kubism (genitive [please provide], partitive [please provide])
valge vein	Noun	valge vein (genitive [please provide], partitive [please provide])
kraad	Noun	kraad (genitive kraadi, partitive kraadi)
liik	Noun	liik (genitive liigi, partitive liiki)
aragoniit	Noun	aragoniit (genitive [please provide], partitive [please provide])
naisterahvas	Noun	naisterahvas (genitive naisterahva, partitive naisterahvast)
muuseum	Noun	muuseum (genitive muuseumi, partitive muuseumi or muuseumit)
jook	Noun	jook (genitive joogi, partitive jooki)
põis	Noun	põis (genitive [please provide], partitive [please provide])
põrm	Noun	põrm (genitive [please provide], partitive [please provide])
aatomipomm	Noun	aatomipomm (genitive aatomipommi, partitive aatomipommi)
ratas	Noun	ratas (genitive ratta, partitive ratast)
sammal	Noun	sammal (genitive sambla, partitive sammalt)
inimene	Noun	inimene (genitive inimese, partitive inimest)
ämblikuvõrk	Noun	ämblikuvõrk (genitive ämblikuvõrgu, partitive ämblikuvõrku)
apelsin	Noun	apelsin (genitive apelsini, partitive apelsini)
neutrontäht	Noun	neutrontäht (genitive [please provide], partitive [please provide])
atsetüül	Noun	atsetüül (genitive [please provide], partitive [please provide])
paaritumine	Noun	paaritumine (genitive paaritumise, partitive paaritumist)
rahulolu	Noun	rahulolu (genitive rahulolu, partitive rahulolu)
vaarikapõõsas	Noun	vaarikapõõsas (genitive [please provide], partitive [please provide])
vaha	Noun	vaha (genitive vaha, partitive vaha)
pöök	Noun	pöök (genitive [please provide], partitive [please provide])
ainsus	Noun	ainsus (genitive ainsuse, partitive ainsust)
küüs	Noun	küüs (genitive küüne, partitive küünt)
galeniit	Noun	galeniit (genitive [please provide], partitive [please provide])
lume	Noun	lume
embus	Noun	embus (genitive embuse, partitive embust)
maakeel	Noun	maakeel (genitive maakeele, partitive maakeelt)
perenaine	Noun	perenaine (genitive perenaise, partitive perenaist)
sõnaraamat	Noun	sõnaraamat (genitive sõnaraamatu, partitive sõnaraamatut)
pühapäevakool	Noun	pühapäevakool (genitive [please provide], partitive [please provide])
kobras	Noun	kobras (genitive [please provide], partitive [please provide])
kalender	Noun	kalender (genitive kalendri, partitive kalendrit)
hispaania	Noun	hispaania (genitive [please provide], partitive [please provide])
islandi keel	Noun	islandi keel
portvein	Noun	portvein (genitive [please provide], partitive [please provide])
trollibuss	Noun	trollibuss (genitive trollibussi, partitive [please provide])
last	Noun	last
keisririik	Noun	keisririik (genitive keisririigi, partitive keisririiki)
naba	Noun	naba (genitive naba, partitive naba)
toomingas	Noun	toomingas (genitive toominga, partitive toomingat)
ionosfäär	Noun	ionosfäär (genitive ionosfääri, partitive ionosfääri)
ühendus	Noun	ühendus (genitive ühenduse, partitive ühendust)
pang	Noun	pang (genitive [please provide], partitive [please provide])
traktor	Noun	traktor (genitive traktori, partitive traktorit)
kassi	Noun	kassi
kassi	Noun	kassi
kaksik	Noun	kaksik (genitive kaksiku, partitive kaksikut)
pidalitõbi	Noun	pidalitõbi (genitive pidalitõve, partitive pidalitõbe)
ring	Noun	ring (genitive ringi, partitive ringi)
eri	Noun	eri (genitive eri, partitive eri)
vaen	Noun	vaen (genitive vaenu, partitive vaenu)
galaktika	Noun	galaktika (genitive [please provide], partitive [please provide])
tölner	Noun	tölner (genitive tölneri, partitive tölner)
leitnant	Noun	leitnant (genitive leitnandi, partitive leitnanti)
konna	Noun	konna
aim	Noun	aim (genitive aimu, partitive aimu)
rahaühik	Noun	rahaühik (genitive rahaühiku, partitive rahaühikut)
ümbrik	Noun	ümbrik (genitive ümbriku, partitive ümbrikku)
kõri	Noun	kõri (genitive kõri, partitive kõri)
liitium	Noun	liitium (genitive liitiumi, partitive liitiumi or liitiumit)
silmaarst	Noun	silmaarst (genitive silmaarsti, partitive silmaarsti)
safiir	Noun	safiir (genitive [please provide], partitive [please provide])
peatus	Noun	peatus (genitive peatuse, partitive peatust)
korea keel	Noun	korea keel
orgasm	Noun	orgasm (genitive orgasmi, partitive orgasmi)
vermut	Noun	vermut (genitive [please provide], partitive [please provide])
vöö	Noun	vöö (genitive vöö, partitive vööd)
topaas	Noun	topaas (genitive [please provide], partitive [please provide])
dokument	Noun	dokument (genitive [please provide], partitive [please provide])
mardikas	Noun	mardikas (genitive mardika, partitive mardikat)
lõpp	Noun	lõpp (genitive lõpu, partitive lõppu)
välde	Noun	välde (genitive välte, partitive väldet)
kohin	Noun	kohin (genitive kohina, partitive kohinat)
saldo	Noun	saldo (genitive [please provide], partitive [please provide])
novell	Noun	novell (genitive novelli, partitive novelli)
lääts	Noun	lääts (genitive [please provide], partitive [please provide])
tigu	Noun	tigu (genitive [please provide], partitive [please provide])
rubiidium	Noun	rubiidium (genitive rubiidiumi, partitive rubiidiumi or rubiidiumit)
biograafia	Noun	biograafia (genitive [please provide], partitive [please provide])
alatus	Noun	alatus
kindralmajor	Noun	kindralmajor (genitive kindralmajori, partitive kindralmajorit)
puiestik	Noun	puiestik (genitive [please provide], partitive [please provide])
kiirus	Noun	kiirus (genitive kiiruse, partitive kiirust)
žanr	Noun	žanr (genitive [please provide], partitive [please provide])
siidisaba	Noun	siidisaba (genitive [please provide], partitive [please provide])
pesapall	Noun	pesapall (genitive pesapalli, partitive pesapalli)
ümarsulg	Noun	ümarsulg (genitive [please provide], partitive [please provide])
kutse	Noun	kutse (genitive kutse, partitive kutset)
püstol	Noun	püstol (genitive püstoli, partitive püstolit)
loendus	Noun	loendus (genitive loenduse, partitive loendust)
hõim	Noun	hõim (genitive hõimu, partitive hõimu)
pesukaru	Noun	pesukaru (genitive [please provide], partitive [please provide])
kaim	Noun	kaim (genitive kaimu, partitive kaimu)
süli	Noun	süli (genitive süle, partitive süle)
emm	Noun	emm (genitive [please provide], partitive [please provide])
ferriit	Noun	ferriit (genitive [please provide], partitive [please provide])
rahuldus	Noun	rahuldus (genitive rahulduse, partitive rahuldust)
tähtkuju	Noun	tähtkuju (genitive [please provide], partitive [please provide])
lätlane	Noun	lätlane (genitive lätlase, partitive lätlast)
aldehüüd	Noun	aldehüüd (genitive [please provide], partitive [please provide])
sohva	Noun	sohva (genitive [please provide], partitive [please provide])
ühend	Noun	ühend (genitive [please provide], partitive [please provide])
hooaeg	Noun	hooaeg (genitive hooaja, partitive hooaega)
leib	Noun	leib (genitive leiva, partitive leiba)
pakk	Noun	pakk (genitive paku, partitive pakku)
pakk	Noun	pakk (genitive paki, partitive pakki)
pakk	Noun	pakk (genitive paki, partitive pakki)
võrkkiik	Noun	võrkkiik (genitive [please provide], partitive [please provide])
andur	Noun	andur (genitive andru, partitive andrut)
andur	Noun	andur (genitive anduri, partitive andurit)
välismaa	Noun	välismaa (genitive välismaa, partitive välismaad)
tähestik	Noun	tähestik (genitive [please provide], partitive [please provide])
tuumor	Noun	tuumor (genitive tuumori, partitive tuumorit)
suulaeluu	Noun	suulaeluu (genitive suulaeluu, partitive suulaeluud)
komeet	Noun	komeet (genitive [please provide], partitive [please provide])
vett	Noun	vett
ämm	Noun	ämm (genitive ämma, partitive ämma)
televisioon	Noun	televisioon (genitive [please provide], partitive [please provide])
alasi	Noun	alasi (genitive alasi, partitive alasit)
akrofoobia	Noun	akrofoobia (genitive akrofoobia, partitive akrofoobiat)
pallaadium	Noun	pallaadium (genitive pallaadiumi, partitive pallaadiumi or pallaadiumit)
pornograafia	Noun	pornograafia (genitive pornograafia, partitive pornograafiat)
seik	Noun	seik (genitive seiga, partitive seika)
tsink	Noun	tsink (genitive [please provide], partitive [please provide])
šamaan	Noun	šamaan (genitive šamaani, partitive šamaani)
märts	Noun	märts (genitive märtsi, partitive märtsi)
sigar	Noun	sigar (genitive sigari, partitive sigarit)
kahvel	Noun	kahvel (genitive kahvli, partitive kahvlit)
kroon	Noun	kroon (genitive krooni, partitive krooni)
kaev	Noun	kaev (genitive kaevu, partitive kaevu)
vein	Noun	vein (genitive veini, partitive veini)
keskus	Noun	keskus (genitive [please provide], partitive [please provide])
hääldus	Noun	hääldus (genitive häälduse, partitive hääldust)
kajakas	Noun	kajakas (genitive kajaka, partitive kajakat)
jahu	Noun	jahu (genitive jahu, partitive jahu)
pöördsõna	Noun	pöördsõna (genitive pöördsõna, partitive pöördsõna)
käsk	Noun	käsk (genitive käsu, partitive käsku)
sibulakuppel	Noun	sibulakuppel (genitive sibulakupli, partitive sibulakuplit)
vibu	Noun	vibu (genitive vibu, partitive vibu)
liköör	Noun	liköör (genitive [please provide], partitive [please provide])
ori	Noun	ori (genitive orja, partitive orja)
asteroid	Noun	asteroid (genitive [please provide], partitive [please provide])
mongoollane	Noun	mongoollane (genitive mongoollase, partitive mongoollast)
sidesõna	Noun	sidesõna (genitive sidesõna, partitive sidesõna)
isa	Noun	isa (genitive isa, partitive isa)
aasialane	Noun	aasialane (genitive aasialase, partitive aasialast)
portree	Noun	portree (genitive portree, partitive portreed)
olemasolu	Noun	olemasolu (genitive olemasolu, partitive olemasolu)
lahkliha	Noun	lahkliha (genitive lahkliha, partitive lahkliha)
polümeer	Noun	polümeer (genitive [please provide], partitive [please provide])
juur	Noun	juur (genitive juure, partitive juurt)
neodüüm	Noun	neodüüm (genitive [please provide], partitive [please provide])
tuhnik	Noun	tuhnik (genitive tuhniku, partitive tuhnikut)
pärm	Noun	pärm (genitive [please provide], partitive [please provide])
alamliik	Noun	alamliik (genitive alamliigi, partitive alamliiki)
mander	Noun	mander (genitive mandri, partitive mandrit)
puding	Noun	puding (genitive [please provide], partitive [please provide])
keraamik	Noun	keraamik (genitive keraamiku, partitive keraamikut)
koperniitsium	Noun	koperniitsium (genitive koperniitsiumi, partitive koperniitsiumi or koperniitsiumit)
homonüüm	Noun	homonüüm (genitive [please provide], partitive [please provide])
nõder	Noun	nõder (genitive nõdra, partitive nõtra)
kiilluu	Noun	kiilluu (genitive kiilluu, partitive kiilluud)
ää	Noun	ää (genitive [please provide], partitive [please provide])
ige	Noun	ige (genitive [please provide], partitive [please provide])
aru	Noun	aru (genitive aru, partitive aru)
müra	Noun	müra (genitive müra, partitive müra)
tantsupõrand	Noun	tantsupõrand (genitive [please provide], partitive [please provide])
jood	Noun	jood (genitive [please provide], partitive [please provide])
ilusalong	Noun	ilusalong (genitive [please provide], partitive [please provide])
oras	Noun	oras (genitive orase, partitive orast)
hõbekuusk	Noun	hõbekuusk (genitive [please provide], partitive [please provide])
kasvaja	Noun	kasvaja (genitive kasvaja, partitive kasvajat)
võti	Noun	võti (genitive võtme, partitive võtit)
sugulane	Noun	sugulane (genitive sugulase, partitive sugulast)
gadoliinium	Noun	gadoliinium (genitive gadoliiniumi, partitive gadoliiniumi or gadoliiniumit)
rutherfordium	Noun	rutherfordium (genitive rutherfordiumi, partitive rutherfordiumi or rutherfordiumit)
mulk	Noun	mulk (genitive mulgi, partitive mulki)
tee	Noun	tee (genitive tee, partitive teed)
tee	Noun	tee (genitive tee, partitive teed)
tee	Noun	tee (genitive [please provide], partitive [please provide])
perekond	Noun	perekond (genitive [please provide], partitive [please provide])
alumiinium	Noun	alumiinium (genitive alumiiniumi, partitive alumiiniumi or alumiiniumit)
koit	Noun	koit (genitive koidu, partitive koitu)
kurg	Noun	kurg (genitive kure, partitive kurge)
polüester	Noun	polüester (genitive polüestri, partitive polüestrit)
aamissepp	Noun	aamissepp (genitive aamissepa, partitive aamisseppa)
ristisõda	Noun	ristisõda (genitive ristisõja, partitive ristisõda)
hani	Noun	hani (genitive hane, partitive hane)
seksuaalne suundumus	Noun	seksuaalne suundumus
liivi keel	Noun	liivi keel (genitive [please provide], partitive [please provide])
aberratsioon	Noun	aberratsioon (genitive aberratsiooni, partitive aberratsiooni)
madu	Noun	madu (genitive mao, partitive madu)
selgitus	Noun	selgitus (genitive [please provide], partitive [please provide])
hõbe	Noun	hõbe (genitive hõbeda, partitive hõbedat)
sild	Noun	sild (genitive silla, partitive silda)
pidal	Noun	pidal (genitive õpiku, partitive õpikut)
mari	Noun	mari (genitive marja, partitive marja)
õhulaev	Noun	õhulaev (genitive [please provide], partitive [please provide])
aaker	Noun	aaker (genitive aakri, partitive aakrit)
serpentiin	Noun	serpentiin (genitive [please provide], partitive [please provide])
väljalaskesüsteem	Noun	väljalaskesüsteem (genitive [please provide], partitive [please provide])
hommikusöök	Noun	hommikusöök (genitive [please provide], partitive [please provide])
kirp	Noun	kirp (genitive kirbu, partitive kirpu)
ioon	Noun	ioon (genitive [please provide], partitive [please provide])
luik	Noun	luik (genitive [please provide], partitive [please provide])
koorem	Noun	koorem (genitive koorma, partitive koormat)
kultuur	Noun	kultuur (genitive [please provide], partitive [please provide])
maal	Noun	maal (genitive maali, partitive maali)
rahvaloendus	Noun	rahvaloendus (genitive rahvaloenduse, partitive rahvaloendust)
kahju	Noun	kahju (genitive kahju, partitive kahjut)
meditsiin	Noun	meditsiin (genitive [please provide], partitive [please provide])
luterlane	Noun	luterlane (genitive luterlase, partitive luterlast)
jalgpall	Noun	jalgpall (genitive jalgpalli, partitive jalgpalli)
hafnium	Noun	hafnium (genitive hafniumi, partitive hafniumi or hafniumit)
mõdu	Noun	mõdu (genitive mõdu, partitive mõdu)
adjektiiv	Noun	adjektiiv (genitive adjektiivi, partitive adjektiivi)
ristiusk	Noun	ristiusk (genitive ristiusu, partitive ristiusku)
kemmerg	Noun	kemmerg (genitive kemmergu, partitive kemmergut)
päikene	Noun	päikene (genitive päikese, partitive päikest)
tüvi	Noun	tüvi (genitive [please provide], partitive [please provide])
tuvi	Noun	tuvi (genitive [please provide], partitive [please provide])
võrgukaart	Noun	võrgukaart (genitive [please provide], partitive [please provide])
ese	Noun	ese (genitive eseme, partitive eset)
vint	Noun	vint (genitive vindi, partitive vinti)
tahvel	Noun	tahvel (genitive tahvli, partitive tahvlit)
asutus	Noun	asutus (genitive asutuse, partitive asutust)
lihas	Noun	lihas (genitive lihase, partitive lihast)
naissugu	Noun	naissugu (genitive naissoo, partitive naissugu)
kütt	Noun	kütt (genitive küti, partitive kütti)
lemmikloom	Noun	lemmikloom (genitive lemmiklooma, partitive lemmiklooma)
põhjasaami keel	Noun	põhjasaami keel
kulm	Noun	kulm (genitive kulmu, partitive kulmu)
samaarium	Noun	samaarium (genitive samaariumi, partitive samaariumi or samaariumit)
mõte	Noun	mõte (genitive mõtte, partitive mõtet)
palk	Noun	palk (genitive palga, partitive palka)
palk	Noun	palk (genitive palgi, partitive palki)
lund	Noun	lund
fallos	Noun	fallos (genitive fallose, partitive fallost)
tava	Noun	tava (genitive tava, partitive tava)
žee	Noun	žee (genitive [please provide], partitive [please provide])
munn	Noun	munn (genitive munni, partitive munni)
jalus	Noun	jalus (genitive jaluse, partitive jalust)
koeras	Noun	koeras (genitive koerase, partitive koeras)
mahla	Noun	mahla
pilv	Noun	pilv (genitive [please provide], partitive [please provide])
august	Noun	august (genitive augusti, partitive augustit)
liivatee	Noun	liivatee (genitive liivatee, partitive liivateed)
kulli	Noun	kulli
nääl	Noun	nääl (genitive näälu, partitive näälu)
hapnik	Noun	hapnik (genitive [please provide], partitive [please provide])
teadlane	Noun	teadlane (genitive teadlase, partitive teadlast)
kala	Noun	kala (genitive kala, partitive kala)
imago	Noun	imago (genitive imago, partitive imagot)
teleskoop	Noun	teleskoop (genitive [please provide], partitive [please provide])
alkeen	Noun	alkeen (genitive [please provide], partitive [please provide])
saladus	Noun	saladus (genitive saladuse, partitive saladust)
kaevur	Noun	kaevur (genitive kaevuri, partitive kaevurit)
poliitik	Noun	poliitik (genitive poliitiku, partitive poliitikut)
sõnum	Noun	sõnum (genitive sõnumi, partitive sõnumi)
ida	Noun	ida (genitive [please provide], partitive [please provide])
kuklaluu	Noun	kuklaluu (genitive kuklaluu, partitive kuklaluud)
