brosa	Noun	brosa f (plural brosas)
peza	Noun	peza f (plural pezas)
zoofilia	Noun	zoofilia f (uncountable)
orca	Noun	orca f (plural orcas)
ovo	Noun	ovo m (plural ovos)
tele	Noun	tele f (plural teles)
tinta	Noun	tinta f (plural tintas)
aire	Noun	aire m (plural aires)
tortilla	Noun	tortilla f (plural tortillas)
vida	Noun	vida f (plural vidas)
aleta	Noun	aleta f (plural aletas)
tíos	Noun	tíos m pl
grima	Noun	grima f (plural grimas)
loita	Noun	loita f (plural loitas)
sorgo	Noun	sorgo m (plural sorgos)
onda	Noun	onda f (plural ondas)
lingua	Noun	lingua f (plural linguas)
libro	Noun	libro m (plural libros)
mar	Noun	mar m (plural mares)
torta	Noun	torta f (plural tortas)
ben	Noun	ben m (plural bens)
artista	Noun	artista m, f (plural artistas)
xaponés	Noun	xaponés m (plural xaponeses)
ampere	Noun	ampere m (plural amperes)
sono	Noun	sono m (uncountable)
eremita	Noun	eremita m, f (plural eremitas)
carpo	Noun	carpo m (plural carpos)
lupa	Noun	lupa f (plural lupas)
atmosfera	Noun	atmosfera f (plural atmosferas)
museo	Noun	museo m (plural museos)
farad	Noun	farad m (plural [please provide])
res	Noun	res f (plural reses)
res	Noun	res m pl
elefante	Noun	elefante m (plural elefantes)
basalto	Noun	basalto m (plural basaltos)
nora	Noun	nora f (plural noras)
hospital	Noun	hospital m (plural hospitais)
kiwi	Noun	kiwi m (plural kiwis)
oliva	Noun	oliva f (plural olivas)
alemán	Noun	alemán m (plural alemáns) (alemá f, alemás f pl)
po	Noun	po m (plural pos)
porta	Noun	porta f (plural portas)
pato	Noun	pato m (plural patos)
sis	Noun	sis m pl
sirena	Noun	sirena f (plural sirenas)
hospedar	Noun	hospedar (first-person singular present hospedo, first-person singular preterite hospedei, past participle hospedado)
codia	Noun	codia f (plural codias)
cubo	Noun	cubo m (plural cubos)
mis	Noun	mis m pl
rosa	Noun	rosa f (plural rosas)
orangután	Noun	orangután m (plural orangutáns)
madeira	Noun	madeira f (plural madeiras)
boi	Noun	boi m (plural bois)
ser	Noun	ser m (plural seres)
mal	Noun	mal m (plural males)
belga	Noun	belga m, f (plural belgas)
agricultura	Noun	agricultura f
emu	Noun	emu m (plural emus)
transistor	Noun	transistor m (plural transistores)
teta	Noun	teta f (plural tetas)
moto	Noun	moto f (plural motos)
dala	Noun	dala f (plural dalas)
col	Noun	col f (plural coles)
muro	Noun	muro m (plural muros)
pole	Noun	pole m (plural poles)
sal	Noun	sal m
merda	Noun	merda f (plural merdas)
café	Noun	café m (plural cafés)
auga	Noun	auga f (uncountable)
tía	Noun	tía f (plural tías)
uso	Noun	uso m (plural usos)
pavo	Noun	pavo m (plural pavos)
walkie-talkie	Noun	walkie-talkie m (plural [please provide])
ulna	Noun	ulna f (plural ulnas)
pubes	Noun	pubes
pubes	Noun	pubes
brinde	Noun	brinde m (plural brindes)
glutamina	Noun	glutamina f (uncountable)
cabo	Noun	cabo m (plural cabos)
periferia	Noun	periferia f (plural periferias)
treonina	Noun	treonina f (uncountable)
lura	Noun	lura f (plural luras)
cine	Noun	cine m (uncountable)
radar	Noun	radar m (plural radares)
mi	Noun	mi m (plural mis)
sistema	Noun	sistema m (plural sistemas)
actor	Noun	actor m (plural actores)
andas	Noun	andas f (plural andas)
pai	Noun	pai m (plural pais)
rima	Noun	rima f (plural rimas)
rima	Noun	rima f (plural rimas)
zoofobia	Noun	zoofobia f (plural zoofobias)
asteroide	Noun	asteroide m (plural asteroides)
ave	Noun	ave f (plural aves)
só	Noun	só m (plural sós)
figo	Noun	figo m (plural figos)
morsa	Noun	morsa f (plural morsas)
carta	Noun	carta f (plural cartas)
placenta	Noun	placenta f (plural placentas)
cobra	Noun	cobra f (plural cobras)
galego	Noun	galego m (feminine galega, masculine plural galegos, feminine plural galegas)
potasio	Noun	potasio m (uncountable)
bar	Noun	bar m (plural bares)
bar	Noun	bar m (plural bares)
fe	Noun	fe f (uncountable)
animal	Noun	animal m (plural animais)
ripa	Noun	ripa f (plural ripas)
aligator	Noun	aligator m (plural aligatores)
territorio	Noun	territorio m (plural territorios)
dós	Noun	dós m pl
hora	Noun	hora f (plural horas)
familia	Noun	familia f (plural familias)
problema	Noun	problema m (plural problemas)
textura	Noun	textura f (plural texturas)
ideal	Noun	ideal m (plural ideais)
golfista	Noun	golfista m, f (plural golfistas)
porno	Noun	porno m (uncountable)
mineral	Noun	mineral m (plural minerais)
té	Noun	té m (plural tés)
freo	Noun	freo m (plural freos)
esca	Noun	esca f (plural escas)
ar	Noun	ar m (plural ares)
danés	Noun	danés m (plural daneses)
cara	Noun	cara f (plural caras)
si	Noun	si m (plural sis)
internet	Noun	internet f (uncountable)
area	Noun	area f (plural areas)
van	Noun	van m (plural vans)
temporal	Noun	temporal m (plural temporais)
dor	Noun	dor f (plural dores)
medicina	Noun	medicina f (uncountable)
forma	Noun	forma f (plural formas)
metanol	Noun	metanol m (uncountable)
grao	Noun	grao m (plural graos)
pluma	Noun	pluma f (plural plumas)
español	Noun	español m (plural españois, feminine española, feminine plural españolas)
fada	Noun	fada f (plural fadas)
vedro	Noun	vedro m (plural vedros)
neve	Noun	neve f (plural neves)
moa	Noun	moa f (plural moas)
finlandés	Noun	finlandés m (plural finlandeses)
sacro	Noun	sacro m (plural sacros)
festa	Noun	festa f (plural festas)
alcohol	Noun	alcohol m (plural alcohois)
albanés	Noun	albanés m (plural albaneses)
francés	Noun	francés m (plural franceses)
francés	Noun	francés m
francés	Noun	francés m (uncountable)
abade	Noun	abade m (plural abades, feminine abadesa, feminine plural abadesas)
trauma	Noun	trauma m (plural traumas)
oferta	Noun	oferta f (plural ofertas)
carbón	Noun	carbón m (plural carbóns)
trombón	Noun	trombón m (plural trombóns)
carne	Noun	carne f (plural carnes)
raia	Noun	raia f (plural raias)
arbusto	Noun	arbusto m (plural arbustos)
mapa	Noun	mapa m (plural mapas)
melón	Noun	melón m (plural melóns)
herba	Noun	herba f (plural herbas)
golf	Noun	golf m (uncountable)
newton	Noun	newton m (plural newtons)
ala	Noun	ala f (plural alas)
perda	Noun	perda f (plural perdas)
fas	Noun	fas m pl
lista	Noun	lista f (plural listas)
mans	Noun	mans m pl
whisky	Noun	whisky m (plural [please provide])
albatros	Noun	albatros m (plural albatros)
radio	Noun	radio m (plural radios)
calcaria	Noun	calcaria f (plural calcarias)
millo	Noun	millo m (plural millos)
enigma	Noun	enigma m (plural enigmas)
hemoglobina	Noun	hemoglobina f (uncountable)
iguana	Noun	iguana f (plural iguanas)
turbina	Noun	turbina f (plural turbinas)
arteria	Noun	arteria f (plural arterias)
lugar	Noun	lugar m (plural lugares)
uva	Noun	uva f (plural uvas)
hiena	Noun	hiena f (plural hienas)
vía	Noun	vía f (plural vías)
valor	Noun	valor m (plural valores)
alga	Noun	alga f (plural algas)
alanina	Noun	alanina f (uncountable)
calma	Noun	calma f (uncountable)
dó	Noun	dó m (plural dós)
dó	Noun	dó m (plural dós)
aspecto	Noun	aspecto m (plural aspectos)
fala	Noun	fala m (plural falas)
can	Noun	can m (plural cans)
can	Noun	can m (plural cans)
sopa	Noun	sopa m (plural sopas)
vista	Noun	vista f (plural vistas)
afgán	Noun	afgán m (plural afgáns)
á	Noun	á f (plural ás)
uz	Noun	uz f (plural uces)
bispel	Noun	bispel n (plural bispeis)
nebulosa	Noun	nebulosa f (plural nebulosas)
litosfera	Noun	litosfera f (plural litosferas)
galaxia	Noun	galaxia f (plural galaxias)
base	Noun	base f (plural bases)
calcio	Noun	calcio m (uncountable)
militar	Noun	militar m, f (plural militares)
pera	Noun	pera f (plural peras)
supernova	Noun	supernova f (plural supernovas)
reis	Noun	reis
pan	Noun	pan m (plural pans)
error	Noun	error m (plural errores)
tigre	Noun	tigre m (plural tigres)
lunar	Noun	lunar m (plural lunares)
pega	Noun	pega f (plural pegas)
tea	Noun	tea f (plural teas)
transversal	Noun	transversal f (plural transversais)
lente	Noun	lente f (plural lentes)
voz	Noun	voz f (plural voces)
banana	Noun	banana f (plural bananas)
illa	Noun	illa f (plural illas)
vapor	Noun	vapor m (plural vapores)
popas	Noun	popas
clima	Noun	clima m (plural climas)
las	Noun	las m pl
gamma	Noun	gamma m (plural gammas)
frontal	Noun	frontal m (plural frontais)
turista	Noun	turista m, f (plural turistas)
dama	Noun	dama f (plural damas)
cu	Noun	cu m (plural cus)
cu	Noun	cu m
kripton	Noun	kripton m (uncountable)
biosfera	Noun	biosfera f (plural biosferas)
mamut	Noun	mamut m (plural [please provide])
dito	Noun	dito m (plural ditos)
brisa	Noun	brisa f (plural brisas)
hotel	Noun	hotel m (plural hoteis)
coxa	Noun	coxa f (plural coxas)
tonsura	Noun	tonsura f (uncountable)
foto	Noun	foto f (plural fotos)
barón	Noun	barón m (plural baróns)
tundra	Noun	tundra f (plural tundras)
portugués	Noun	portugués m (plural portugeses)
prolina	Noun	prolina f (uncountable)
rata	Noun	rata f (plural ratas)
erre	Noun	erre m (plural erres)
pica	Noun	pica m (plural picas)
casa	Noun	casa f (plural casas)
flor	Noun	flor f (plural flores)
xantar	Noun	xantar m (plural xantares)
alma	Noun	alma f (plural almas)
agricultor	Noun	agricultor m (plural agricultores)
sol	Noun	sol m (plural soles)
sol	Noun	sol m (plural soles)
sol	Noun	sol m (plural soles)
faba	Noun	faba f (plural fabas)
talio	Noun	talio m (uncountable)
bala	Noun	bala f (plural balas)
silva	Noun	silva f (plural silvas)
ene	Noun	ene m (plural enes)
castor	Noun	castor m (plural castores)
ás	Noun	ás f pl
meigo	Noun	meigo m (plural meigos, feminine meiga, feminine plural meigas)
ra	Noun	ra f (plural ras)
tenis	Noun	tenis m (uncountable)
canto	Noun	canto m (uncountable)
barba	Noun	barba f (plural barbas)
xugular	Noun	xugular f (plural xugulares)
serra	Noun	serra f (plural serras)
aluminio	Noun	aluminio m (uncountable)
neutrino	Noun	neutrino m (plural neutrinos)
interior	Noun	interior m (plural interiores)
lúas	Noun	lúas
arma	Noun	arma f (plural armas)
grego	Noun	grego m (plural gregos)
lobo	Noun	lobo m (plural lobos)
GPS	Noun	GPS m (plural GPS)
tona	Noun	tona f (plural tonas)
barca	Noun	barca f (plural barcas)
pé	Noun	pé m (plural pés)
flúor	Noun	flúor m (uncountable)
balón	Noun	balón m (plural balóns)
selo	Noun	selo m (plural selos)
gas	Noun	gas m (plural gases)
perna	Noun	perna f (plural pernas)
estrada	Noun	estrada f (plural estradas)
lume	Noun	lume m (plural lumes)
día	Noun	día m (plural días)
reno	Noun	reno m (plural renos)
deus	Noun	deus m (plural deuses)
magma	Noun	magma m (plural magmas)
pirata	Noun	pirata m, f (plural piratas)
chan	Noun	chan m (plural chans)
zeta	Noun	zeta m (plural zetas)
lado	Noun	lado m (plural lados)
leu	Noun	leu m (plural lei)
pimento	Noun	pimento m (plural pimentos)
observatorio	Noun	observatorio m (plural observatorios)
tempo	Noun	tempo m (plural tempos)
delta	Noun	delta m (plural deltas)
fin	Noun	fin m, f (plural fines)
val	Noun	val m (plural vales)
virus	Noun	virus m (plural virus)
sino	Noun	sino m (plural sinos)
material	Noun	material m (plural materiais)
vespa	Noun	vespa f (plural vespas)
mango	Noun	mango m (plural mangos)
seta	Noun	seta f (plural setas)
soma	Noun	soma f (plural somas)
vaga	Noun	vaga f (plural vagas)
merenda	Noun	merenda f (plural merendas)
media	Noun	media f (plural medias)
popa	Noun	popa f (plural popas)
vela	Noun	vela f (plural velas)
vela	Noun	vela f (plural velas)
argon	Noun	argon m (uncountable)
ión	Noun	ión m (plural ións)
maga	Noun	maga f (plural magas)
inglés	Noun	inglés m (plural ingleses)
bongo	Noun	bongo m (plural bongos)
odio	Noun	odio m (plural odios)
volt	Noun	volt m (plural [please provide])
mesa	Noun	mesa f (plural mesas)
androfobia	Noun	androfobia f (plural androfobias)
total	Noun	total m (plural totais)
turba	Noun	turba f (plural turbas)
turba	Noun	turba f (plural turbas)
altar	Noun	altar m (plural altares)
mai	Noun	mai f (plural mais)
peite	Noun	peite m (plural peites)
alfa	Noun	alfa m (plural alfas)
verde	Noun	verde m (plural verdes)
lava	Noun	lava f (plural lavas)
catalán	Noun	catalán m (plural cataláns)
talo	Noun	talo m (plural talos)
sur	Noun	sur m (plural sures)
vez	Noun	vez f (plural veces)
hedra	Noun	hedra f (plural hedras)
planta	Noun	planta f (plural plantas)
autor	Noun	autor m (plural autores)
la	Noun	la m (plural las)
la	Noun	la f (uncountable)
reflexar	Noun	reflexar (first-person singular present reflexo, first-person singular preterite reflexei, past participle reflexado)
victoria	Noun	victoria f (plural victorias)
cona	Noun	cona f (plural conas)
balea	Noun	balea f (plural baleas)
columna	Noun	columna f (plural columnas)
fa	Noun	fa m (plural fas)
islandés	Noun	islandés m (plural islandeses)
para	Noun	para f (plural paras)
efe	Noun	efe m (plural efes)
sitio	Noun	sitio m (plural sitios)
polo	Noun	polo m (plural polos)
polo	Noun	polo m (plural polos)
polo	Noun	polo m (plural polos)
mono	Noun	mono m (plural monos)
temperatura	Noun	temperatura f (plural temperaturas)
oco	Noun	oco m (plural ocos)
ara	Noun	ara f (plural aras)
anatema	Noun	anatema f (plural anatemas)
antes	Noun	antes
ohm	Noun	ohm m (plural [please provide])
vulva	Noun	vulva f (plural vulvas)
mandarina	Noun	mandarina f (plural mandarinas)
filamentos	Noun	filamentos
paella	Noun	paella f (plural paellas)
plata	Noun	plata f (plural platas)
duna	Noun	duna f (plural dunas)
a	Noun	a m (plural as)
astronauta	Noun	astronauta m, f (plural astronautas)
tsar	Noun	tsar m (plural tsares)
ceo	Noun	ceo m (plural ceos)
tulla	Noun	tulla f (plural tullas)
lata	Noun	lata f (plural latas)
lata	Noun	lata f (plural latas)
meles	Noun	meles
soar	Noun	soar f (plural soares)
martes	Noun	martes m
rama	Noun	rama f (plural ramas)
peso	Noun	peso m (plural pesos)
tibia	Noun	tibia f (plural tibias)
gusto	Noun	gusto m (plural gustos)
asunto	Noun	asunto m (plural asuntos)
poeta	Noun	poeta m (plural poetas)
aorta	Noun	aorta f (plural aortas)
baile	Noun	baile m (plural bailes)
terra	Noun	terra f (plural terras)
delfín	Noun	delfín m (plural delfíns)
boca	Noun	boca f (plural bocas)
sinagoga	Noun	sinagoga f (plural sinagogas)
mudo	Noun	mudo m (plural mudos)
gol	Noun	gol m (plural goles)
usura	Noun	usura f (plural usuras)
modo	Noun	modo m (plural modos)
euro	Noun	euro m (plural euros)
son	Noun	son m (plural sons)
mica	Noun	mica f (uncountable)
titán	Noun	titán m (plural titáns)
cor	Noun	cor f (plural cores)
man	Noun	man f (plural mans)
mes	Noun	mes m (plural meses)
parentes	Noun	parentes m pl, f pl
vento	Noun	vento m (plural ventos)
pianista	Noun	pianista m, f (plural pianistas)
amor	Noun	amor m (plural amores)
bota	Noun	bota f (plural botas)
árabe	Noun	árabe m, f (plural árabes)
nena	Noun	nena f (plural nenas)
gorila	Noun	gorila m (plural gorilas)
pedofilia	Noun	pedofilia f (plural pedofilias)
prosa	Noun	prosa f (uncountable)
musa	Noun	musa f (plural musas)
te	Noun	te f (plural tes)
lei	Noun	lei f (plural leis)
lei	Noun	lei m pl
masa	Noun	masa f (plural masas)
neon	Noun	neon m (uncountable)
tolerancia	Noun	tolerancia f (plural tolerancias)
dedo	Noun	dedo m (plural dedos)
octaedros	Noun	octaedros
irlandés	Noun	irlandés m (plural irlandeses)
banda	Noun	banda f (plural bandas)
home	Noun	home m (plural homes)
gato	Noun	gato m (plural gatos)
papel	Noun	papel m (plural papeis)
asa	Noun	asa f (plural asas)
presidente	Noun	presidente m (plural presidentes, feminine presidenta, feminine plural presidentas)
vulgo	Noun	vulgo m (plural vulgos)
porto	Noun	porto m (plural portos)
lima	Noun	lima f (plural limas)
lima	Noun	lima f (plural limas)
metionina	Noun	metionina f (uncountable)
seme	Noun	seme m (plural semes)
parasol	Noun	parasol m (plural parasois)
resto	Noun	resto m (plural restos)
leite	Noun	leite m (plural leites)
tren	Noun	tren m (plural trens)
tenista	Noun	tenista m, f (plural tenistas)
nivel	Noun	nivel m (plural niveis)
sós	Noun	sós m pl
radon	Noun	radon m (uncountable)
sapo	Noun	sapo m (plural sapos)
insulto	Noun	insulto m (plural insultos)
cela	Noun	cela f (plural celas)
homofobia	Noun	homofobia f (plural homofobias)
beta	Noun	beta m (plural betas)
leis	Noun	leis f pl
monstro	Noun	monstro m (plural monstros)
troposfera	Noun	troposfera f (plural troposferas)
membrana	Noun	membrana f (plural membranas)
paz	Noun	paz f (plural paces)
urina	Noun	urina f (plural urinas)
mel	Noun	mel m (plural meles)
erro	Noun	erro m (plural erros)
etanol	Noun	etanol m (uncountable)
optimista	Noun	optimista m, f (plural optimistas)
tuba	Noun	tuba f (plural tubas)
tomate	Noun	tomate m (plural tomates)
baga	Noun	baga f (plural bagas)
filipino	Noun	filipino m (plural filipinos)
cometa	Noun	cometa m (plural cometas)
feroés	Noun	feroés m (plural feroeses)
xenon	Noun	xenon m (uncountable)
malla	Noun	malla f (plural mallas)
asexual	Noun	asexual m, f (plural asexuais)
manga	Noun	manga f (plural mangas)
manga	Noun	manga f (plural mangas)
planeta	Noun	planeta m (plural planetas)
auxilio	Noun	auxilio m (plural auxilios)
roda	Noun	roda f (plural rodas)
zona	Noun	zona f (plural zonas)
sola	Noun	sola f (plural solas)
termosfera	Noun	termosfera f (plural termosferas)
piar	Noun	piar m (plural piares)
tulipán	Noun	tulipán m (plural tulipáns)
cella	Noun	cella f (plural cellas)
prata	Noun	prata f (uncountable)
koala	Noun	koala m (plural koalas)
idea	Noun	idea f (plural ideas)
mundo	Noun	mundo m (plural mundos)
puro	Noun	puro m (plural puros)
