𐌼𐌴𐍂𐌹𐌸𐌰	Noun	𐌼𐌴𐍂𐌹𐌸𐌰 • (mēriþa) f
𐌻𐌰𐌿𐌷𐌼𐌿𐌽𐌹	Noun	𐌻𐌰𐌿𐌷𐌼𐌿𐌽𐌹 • (lauhmuni) f
𐌰𐌿𐌷𐌽𐍃	Noun	𐌰𐌿𐌷𐌽𐍃 • (auhns) m
𐍆𐍂𐌰𐌹𐍅	Noun	𐍆𐍂𐌰𐌹𐍅 • (fraiw) n
𐌲𐌿𐌼𐌰	Noun	𐌲𐌿𐌼𐌰 • (guma) m
𐌰𐍄𐌰𐌸𐌽𐌹	Noun	𐌰𐍄𐌰𐌸𐌽𐌹 • (ataþni) n
𐍆𐍂𐌰𐍃𐍄𐌹𐍃𐌹𐌱𐌾𐌰	Noun	𐍆𐍂𐌰𐍃𐍄𐌹𐍃𐌹𐌱𐌾𐌰 • (frastisibja) f
𐌰𐌽𐌳𐌰𐌿𐌲𐌹	Noun	𐌰𐌽𐌳𐌰𐌿𐌲𐌹 • (andaugi) n
𐌵𐌹𐌽𐍉	Noun	𐌵𐌹𐌽𐍉 • (qinō) f
𐌻𐌹𐌿𐌷𐌰𐌳𐌴𐌹𐌽𐍃	Noun	𐌻𐌹𐌿𐌷𐌰𐌳𐌴𐌹𐌽𐍃 • (liuhadeins) f
𐌺𐌿𐌽𐌰𐍅𐌹𐌳𐌰	Noun	𐌺𐌿𐌽𐌰𐍅𐌹𐌳𐌰 • (kunawida) f
𐌼𐌰𐌽𐍅𐌹𐌸𐌰	Noun	𐌼𐌰𐌽𐍅𐌹𐌸𐌰 • (manwiþa) f
𐌹𐌳𐍂𐌴𐌹𐌲𐌰	Noun	𐌹𐌳𐍂𐌴𐌹𐌲𐌰 • (idreiga) f
𐍅𐌿𐌻𐌻𐌰	Noun	𐍅𐌿𐌻𐌻𐌰 • (wulla) f
𐌷𐌰𐌶𐌴𐌹𐌽𐍃	Noun	𐌷𐌰𐌶𐌴𐌹𐌽𐍃 • (hazeins) f
𐌰𐌽𐌰𐌱𐌿𐍃𐌽𐍃	Noun	𐌰𐌽𐌰𐌱𐌿𐍃𐌽𐍃 • (anabusns) f
𐌱𐌰𐌽𐌳𐌾𐌰	Noun	𐌱𐌰𐌽𐌳𐌾𐌰 • (bandja) m
𐌱𐌰𐌽𐌳𐌾𐌰	Noun	𐌱𐌰𐌽𐌳𐌾𐌰 • (bandja)
𐌱𐌹𐍃𐌰𐌿𐌻𐌴𐌹𐌽𐍃	Noun	𐌱𐌹𐍃𐌰𐌿𐌻𐌴𐌹𐌽𐍃 • (bisauleins) f
𐍆𐌹𐍃𐌺𐍃	Noun	𐍆𐌹𐍃𐌺𐍃 • (fisks) m
𐌸𐌿𐍃𐌿𐌽𐌳𐌹𐍆𐌰𐌸𐍃	Noun	𐌸𐌿𐍃𐌿𐌽𐌳𐌹𐍆𐌰𐌸𐍃 • (þusundifaþs) m
𐌲𐌰𐍂𐌰𐌹𐌳𐌴𐌹𐌽𐍃	Noun	𐌲𐌰𐍂𐌰𐌹𐌳𐌴𐌹𐌽𐍃 • (garaideins) f
𐌰𐌿𐍂𐍄𐌾𐌰	Noun	𐌰𐌿𐍂𐍄𐌾𐌰 • (aurtja) m
𐌲𐌰𐌻𐌰𐌿𐌱𐌴𐌹𐌽𐍃	Noun	𐌲𐌰𐌻𐌰𐌿𐌱𐌴𐌹𐌽𐍃 • (galaubeins) f
𐌲𐌰𐌼𐌰𐌹𐌽𐌴𐌹	Noun	𐌲𐌰𐌼𐌰𐌹𐌽𐌴𐌹 • (gamainei) f
𐌱𐌰𐌽𐌳𐌹	Noun	𐌱𐌰𐌽𐌳𐌹 • (bandi) f
𐌷𐌰𐌿𐌱𐌹𐌸	Noun	𐌷𐌰𐌿𐌱𐌹𐌸 • (haubiþ) n
𐌲𐌹𐌱𐌰	Noun	𐌲𐌹𐌱𐌰 • (giba) f
𐌰𐌿𐍃𐍉	Noun	𐌰𐌿𐍃𐍉 • (ausō) n
𐌱𐌻𐍉𐌼𐌰	Noun	𐌱𐌻𐍉𐌼𐌰 • (blōma) m
𐌼𐌰𐌸𐌰	Noun	𐌼𐌰𐌸𐌰 • (maþa) m
𐌲𐌰𐌷𐌰𐌿𐍃𐌴𐌹𐌽𐍃	Noun	𐌲𐌰𐌷𐌰𐌿𐍃𐌴𐌹𐌽𐍃 • (gahauseins) f
𐌽𐌴𐌹𐌸	Noun	𐌽𐌴𐌹𐌸 • (neiþ) n
𐍃𐌹𐍀𐍉𐌽𐌴𐌹𐍃	Noun	𐍃𐌹𐍀𐍉𐌽𐌴𐌹𐍃 • (siponeis) m
𐌷𐍂𐌰𐌹𐌽𐌴𐌹𐌽𐍃	Noun	𐌷𐍂𐌰𐌹𐌽𐌴𐌹𐌽𐍃 • (hraineins) f
𐌰𐍂𐌱𐌾𐍉	Noun	𐌰𐍂𐌱𐌾𐍉 • (arbjō) f
𐌲𐌰𐍅𐌰𐍃𐌴𐌹𐌽𐍃	Noun	𐌲𐌰𐍅𐌰𐍃𐌴𐌹𐌽𐍃 • (gawaseins) f
𐌰𐍅𐌹𐍃𐍄𐍂	Noun	𐌰𐍅𐌹𐍃𐍄𐍂 • (awistr) n
𐍃𐍄𐍂𐌹𐌺𐍃	Noun	𐍃𐍄𐍂𐌹𐌺𐍃 • (striks) m
𐌿𐌱𐌹𐌶𐍅𐌰	Noun	𐌿𐌱𐌹𐌶𐍅𐌰 • (ubizwa) f
𐌰𐌹𐍂𐌿𐍃	Noun	𐌰𐌹𐍂𐌿𐍃 • (airus) m
𐌲𐌰𐍅𐌰𐌻𐌴𐌹𐌽𐍃	Noun	𐌲𐌰𐍅𐌰𐌻𐌴𐌹𐌽𐍃 • (gawaleins) f
𐍆𐌿𐌲𐌻𐍃	Noun	𐍆𐌿𐌲𐌻𐍃 • (fugls) m
𐌱𐌻𐍉𐌸	Noun	𐌱𐌻𐍉𐌸 • (blōþ) n
𐍆𐌰𐍃𐌺𐌾𐌰	Noun	𐍆𐌰𐍃𐌺𐌾𐌰 • (faskja) m
𐌲𐌰𐌼𐌰𐌹𐌽𐌳𐌿𐌸𐍃	Noun	𐌲𐌰𐌼𐌰𐌹𐌽𐌳𐌿𐌸𐍃 • (gamaindūþs) f
𐌻𐌰𐌹𐍃𐌰𐍂𐌴𐌹𐍃	Noun	𐌻𐌰𐌹𐍃𐌰𐍂𐌴𐌹𐍃 • (laisāreis) m
𐌰𐌹𐌱𐍂	Noun	𐌰𐌹𐌱𐍂 • (aibr) n
𐌿𐌽𐌷𐍂𐌰𐌹𐌽𐌹𐌸𐌰	Noun	𐌿𐌽𐌷𐍂𐌰𐌹𐌽𐌹𐌸𐌰 • (unhrainiþa) f
𐌰𐌷𐌰	Noun	𐌰𐌷𐌰 • (aha) m
𐌰𐌹𐍅𐌰𐌲𐌲𐌴𐌻𐌹𐍃𐍄𐌰	Noun	𐌰𐌹𐍅𐌰𐌲𐌲𐌴𐌻𐌹𐍃𐍄𐌰 • (aiwaggēlista) m
𐌱𐍂𐌿𐍃𐍄𐍃	Noun	𐌱𐍂𐌿𐍃𐍄𐍃 • (brusts) f
𐌺𐌰𐍂𐌰	Noun	𐌺𐌰𐍂𐌰 • (kara) f
𐌰𐌷𐌼𐌰	Noun	𐌰𐌷𐌼𐌰 • (ahma) f
𐌱𐌰𐌲𐌼𐍃	Noun	𐌱𐌰𐌲𐌼𐍃 • (bagms) m
𐌰𐌻𐌻𐌰𐍅𐌴𐍂𐌴𐌹	Noun	𐌰𐌻𐌻𐌰𐍅𐌴𐍂𐌴𐌹 • (allawērei) f
𐌷𐌽𐌰𐌹𐍅𐌴𐌹𐌽𐍃	Noun	𐌷𐌽𐌰𐌹𐍅𐌴𐌹𐌽𐍃 • (hnaiweins) f
𐌰𐌹𐌶	Noun	𐌰𐌹𐌶 • (aiz) n
𐌲𐌰𐌹𐍄𐌴𐌹𐌽	Noun	𐌲𐌰𐌹𐍄𐌴𐌹𐌽 • (gaitein) n
𐍆𐌴𐍂𐌰	Noun	𐍆𐌴𐍂𐌰 • (fēra) f
𐌷𐌹𐍅𐌹	Noun	𐌷𐌹𐍅𐌹 • (hiwi) n
𐌳𐌰𐌲𐍃	Noun	𐌳𐌰𐌲𐍃 • (dags) m
𐌸𐌹𐌿𐌱𐌹	Noun	𐌸𐌹𐌿𐌱𐌹 • (þiubi) n
𐌸𐍂𐌰𐌼𐍃𐍄𐌴𐌹	Noun	𐌸𐍂𐌰𐌼𐍃𐍄𐌴𐌹 • (þramstei) f
𐌸𐌰𐍂𐌱𐌰	Noun	𐌸𐌰𐍂𐌱𐌰 • (þarba) f
𐌺𐌰𐍃	Noun	𐌺𐌰𐍃 • (kas) n
𐍅𐍂𐌹𐌸𐌿𐍃	Noun	𐍅𐍂𐌹𐌸𐌿𐍃 • (wriþus) m
𐍃𐌺𐌰𐌻𐌺𐍃	Noun	𐍃𐌺𐌰𐌻𐌺𐍃 • (skalks) m
𐌲𐌿𐌸	Noun	𐌲𐌿𐌸 • (guþ) m
𐌿𐌽𐍅𐌹𐍄𐌹	Noun	𐌿𐌽𐍅𐌹𐍄𐌹 • (unwiti) n
𐌲𐌰𐌹𐌳𐍅	Noun	𐌲𐌰𐌹𐌳𐍅 • (gaidw) n
𐌰𐌹𐍅𐍇𐌰𐍂𐌹𐍃𐍄𐌹𐌰	Noun	𐌰𐌹𐍅𐍇𐌰𐍂𐌹𐍃𐍄𐌹𐌰 • (aiwxaristia) f
𐌷𐌻𐌰𐌼𐌼𐌰	Noun	𐌷𐌻𐌰𐌼𐌼𐌰 • (hlamma) f
𐍃𐌰𐌿𐌻𐍃	Noun	𐍃𐌰𐌿𐌻𐍃 • (sauls) f
𐌼𐌰𐍅𐌹𐌻𐍉	Noun	𐌼𐌰𐍅𐌹𐌻𐍉 • (mawilō) f
𐌲𐌰𐍆𐌴𐍄𐌴𐌹𐌽𐍃	Noun	𐌲𐌰𐍆𐌴𐍄𐌴𐌹𐌽𐍃 • (gafēteins) f
𐌻𐌹𐌸𐌿𐍃	Noun	𐌻𐌹𐌸𐌿𐍃 • (liþus) m
𐌱𐌹𐍂𐍉𐌳𐌴𐌹𐌽𐍃	Noun	𐌱𐌹𐍂𐍉𐌳𐌴𐌹𐌽𐍃 • (birōdeins) f
𐍅𐌹𐍃𐍄𐍃	Noun	𐍅𐌹𐍃𐍄𐍃 • (wists) f
𐌰𐌽𐌽𐍉	Noun	𐌰𐌽𐌽𐍉 • (annō) f
𐍅𐌴𐌹𐌽𐌰𐍄𐍂𐌹𐌿	Noun	𐍅𐌴𐌹𐌽𐌰𐍄𐍂𐌹𐌿 • (weinatriu) n
𐌰𐌷𐌰𐌺𐍃	Noun	𐌰𐌷𐌰𐌺𐍃 • (ahaks) f
𐌼𐌴𐍃	Noun	𐌼𐌴𐍃 • (mēs) n
𐌸𐌹𐌿𐌳𐌰𐌽𐌲𐌰𐍂𐌳𐌹	Noun	𐌸𐌹𐌿𐌳𐌰𐌽𐌲𐌰𐍂𐌳𐌹 • (þiudangardi) f
𐌼𐌰𐌲𐌰𐌸𐍃	Noun	𐌼𐌰𐌲𐌰𐌸𐍃 • (magaþs) f
𐌽𐌰𐍂𐌳𐌿𐍃	Noun	𐌽𐌰𐍂𐌳𐌿𐍃 • (nardus) m
𐌱𐌹𐌳𐌰	Noun	𐌱𐌹𐌳𐌰 • (bida) f
𐌽𐌰𐌹𐍄𐌴𐌹𐌽𐍃	Noun	𐌽𐌰𐌹𐍄𐌴𐌹𐌽𐍃 • (naiteins) f
𐌸𐌰𐌿𐍂𐍆𐍄𐍃	Noun	𐌸𐌰𐌿𐍂𐍆𐍄𐍃 • (þaurfts) f
𐌱𐍂𐌿𐌽𐌾𐍉	Noun	𐌱𐍂𐌿𐌽𐌾𐍉 • (brunjō) f
𐌷𐌻𐌰𐌹𐍅	Noun	𐌷𐌻𐌰𐌹𐍅 • (hlaiw) n
𐌻𐌹𐍄𐌴𐌹𐌽𐍃	Noun	𐌻𐌹𐍄𐌴𐌹𐌽𐍃 • (liteins) f
𐌰𐌹𐌸𐍃	Noun	𐌰𐌹𐌸𐍃 • (aiþs) m
𐌱𐍉𐌺𐌰	Noun	𐌱𐍉𐌺𐌰 • (bōka) f
𐌽𐌰𐍃𐌴𐌹𐌽𐍃	Noun	𐌽𐌰𐍃𐌴𐌹𐌽𐍃 • (naseins) f
𐌳𐍂𐌰𐌲𐌲𐌺	Noun	𐌳𐍂𐌰𐌲𐌲𐌺 • (draggk)
𐌲𐌿𐌳𐌾𐌹𐌽𐌰𐍃𐍃𐌿𐍃	Noun	𐌲𐌿𐌳𐌾𐌹𐌽𐌰𐍃𐍃𐌿𐍃 • (gudjinassus) m
𐍃𐌰𐌲𐌲𐍅𐍃	Noun	𐍃𐌰𐌲𐌲𐍅𐍃 • (saggws) m
𐌸𐌰𐌹𐍂𐌺𐍉	Noun	𐌸𐌰𐌹𐍂𐌺𐍉 • (þairkō) n
𐍅𐌴𐌹𐍄𐍅𐍉𐌳𐌹𐌸𐌰	Noun	𐍅𐌴𐌹𐍄𐍅𐍉𐌳𐌹𐌸𐌰 • (weitwōdiþa) f
𐌼𐌹𐌳𐌲𐌰𐍂𐌳𐌹𐍅𐌰𐌳𐌳𐌾𐌿𐍃	Noun	𐌼𐌹𐌳𐌲𐌰𐍂𐌳𐌹𐍅𐌰𐌳𐌳𐌾𐌿𐍃 • (midgardiwaddjus) m, f
𐌼𐌹𐌻𐌷𐌼𐌰	Noun	𐌼𐌹𐌻𐌷𐌼𐌰 • (milhma) m
𐌰𐌽𐌳𐌰𐍅𐌰𐌿𐍂𐌳𐌹	Noun	𐌰𐌽𐌳𐌰𐍅𐌰𐌿𐍂𐌳𐌹 • (andawaurdi) n
𐌻𐌰𐌸𐍉𐌽𐍃	Noun	𐌻𐌰𐌸𐍉𐌽𐍃 • (laþōns) f
𐍅𐍂𐌿𐌲𐌲𐍉	Noun	𐍅𐍂𐌿𐌲𐌲𐍉 • (wruggō) f
𐌰𐌹𐍅𐌰𐌲𐌲𐌴𐌻𐌹	Noun	𐌰𐌹𐍅𐌰𐌲𐌲𐌴𐌻𐌹 • (aiwaggēli) m
𐌲𐌰𐍃𐌺𐌰𐌹𐌳𐌴𐌹𐌽𐍃	Noun	𐌲𐌰𐍃𐌺𐌰𐌹𐌳𐌴𐌹𐌽𐍃 • (gaskaideins) f
𐍅𐌰𐌲𐌲𐍃	Noun	𐍅𐌰𐌲𐌲𐍃 • (waggs) m
𐍆𐍉𐍄𐌿𐌱𐌰𐌽𐌳𐌹	Noun	𐍆𐍉𐍄𐌿𐌱𐌰𐌽𐌳𐌹 • (fōtubandi) f
𐍄𐌰𐌹𐌷𐍃𐍅𐌰	Noun	𐍄𐌰𐌹𐌷𐍃𐍅𐌰 • (taihswa) f
𐌻𐌹𐌿𐌲𐌰	Noun	𐌻𐌹𐌿𐌲𐌰 • (liuga) f
𐌷𐌰𐌿𐌽𐌴𐌹𐌽𐍃	Noun	𐌷𐌰𐌿𐌽𐌴𐌹𐌽𐍃 • (hauneins) f
𐍆𐌰𐌿𐍂𐌰𐌲𐌰𐌲𐌲𐌾𐌰	Noun	𐍆𐌰𐌿𐍂𐌰𐌲𐌰𐌲𐌲𐌾𐌰 • (fauragaggja) m
𐍅𐌰𐌹𐍂𐌸𐌹𐌳𐌰	Noun	𐍅𐌰𐌹𐍂𐌸𐌹𐌳𐌰 • (wairþida) f
𐌰𐍈𐌰	Noun	𐌰𐍈𐌰 • (aƕa) f
𐌷𐌰𐌿𐍂𐌳𐍃	Noun	𐌷𐌰𐌿𐍂𐌳𐍃 • (haurds) f
𐍆𐌰𐌹𐍂𐍈𐌿𐍃	Noun	𐍆𐌰𐌹𐍂𐍈𐌿𐍃 • (fairƕus) m
𐍀𐌰𐍀𐌰	Noun	𐍀𐌰𐍀𐌰 • (papa) m
𐌲𐌰𐍆𐍂𐌴𐌹𐌳𐌴𐌹𐌽𐍃	Noun	𐌲𐌰𐍆𐍂𐌴𐌹𐌳𐌴𐌹𐌽𐍃 • (gafreideins) f
𐍃𐍅𐌹𐌺𐌽𐌹𐌸𐌰	Noun	𐍃𐍅𐌹𐌺𐌽𐌹𐌸𐌰 • (swikniþa) f
𐍀𐌰𐌹𐌽𐍄𐌴𐌺𐌿𐍃𐍄𐌴	Noun	𐍀𐌰𐌹𐌽𐍄𐌴𐌺𐌿𐍃𐍄𐌴 • (paintēkustē) f
𐍆𐍂𐌰𐌱𐌰𐌿𐌷𐍄𐌰𐌱𐍉𐌺𐌰	Noun	𐍆𐍂𐌰𐌱𐌰𐌿𐌷𐍄𐌰𐌱𐍉𐌺𐌰 • (frabauhtabōka) f
𐍆𐍂𐌹𐌾𐍉𐌽𐌳𐍃	Noun	𐍆𐍂𐌹𐌾𐍉𐌽𐌳𐍃 • (frijōnds) m
𐍄𐍅𐌴𐌹𐍆𐌻𐌴𐌹𐌽𐍃	Noun	𐍄𐍅𐌴𐌹𐍆𐌻𐌴𐌹𐌽𐍃 • (tweifleins) f
𐌷𐌽𐌿𐌸𐍉	Noun	𐌷𐌽𐌿𐌸𐍉 • (hnuþō) f
𐍃𐍄𐌹𐌿𐍂	Noun	𐍃𐍄𐌹𐌿𐍂 • (stiur) m
𐌰𐌹𐍀𐌹𐍃𐍄𐌰𐌿𐌻𐌴	Noun	𐌰𐌹𐍀𐌹𐍃𐍄𐌰𐌿𐌻𐌴 • (aipistaulē) f
𐌷𐌿𐌻𐌿𐌽𐌳𐌹	Noun	𐌷𐌿𐌻𐌿𐌽𐌳𐌹 • (hulundi) f
𐌽𐌰𐍃𐌾𐌰𐌽𐌳𐍃	Noun	𐌽𐌰𐍃𐌾𐌰𐌽𐌳𐍃 • (nasjands) m
𐌷𐌿𐌽𐍃𐌻	Noun	𐌷𐌿𐌽𐍃𐌻 • (hunsl) n
𐌷𐌰𐌿𐍃𐌴𐌹𐌽𐍃	Noun	𐌷𐌰𐌿𐍃𐌴𐌹𐌽𐍃 • (hauseins) f
𐌵𐌰𐌹𐍂𐌿	Noun	𐌵𐌰𐌹𐍂𐌿 • (qairu) n
𐍃𐌿𐌻𐌾𐌰	Noun	𐍃𐌿𐌻𐌾𐌰 • (sulja) f
𐍂𐌰𐌱𐌱𐌴𐌹	Noun	𐍂𐌰𐌱𐌱𐌴𐌹 • (rabbei) m
𐍆𐌰𐌸𐌰	Noun	𐍆𐌰𐌸𐌰 • (faþa) f
𐌽𐌰𐌿𐌳𐌹𐌸𐌰𐌿𐍂𐍆𐍄𐍃	Noun	𐌽𐌰𐌿𐌳𐌹𐌸𐌰𐌿𐍂𐍆𐍄𐍃 • (naudiþaurfts) f
𐌰𐌹𐍀𐌹𐍃𐍄𐌿𐌻𐌰	Noun	𐌰𐌹𐍀𐌹𐍃𐍄𐌿𐌻𐌰 • (aipistula) m
𐌰𐌹𐍅𐌻𐌰𐌿𐌲𐌹𐌰	Noun	𐌰𐌹𐍅𐌻𐌰𐌿𐌲𐌹𐌰 • (aiwlaugia) m
𐍂𐌿𐌽𐌰	Noun	𐍂𐌿𐌽𐌰 • (rūna) f
𐌰𐍄𐌹𐍃𐌺	Noun	𐌰𐍄𐌹𐍃𐌺 • (atisk) n
𐌰𐌻𐌰𐌼𐌰𐌽𐍃	Noun	𐌰𐌻𐌰𐌼𐌰𐌽𐍃 • (alamans) m
𐍄𐌰𐌻𐌶𐌴𐌹𐌽𐍃	Noun	𐍄𐌰𐌻𐌶𐌴𐌹𐌽𐍃 • (talzeins) f
𐍆𐌰𐌹𐍂𐌲𐌿𐌽𐌹	Noun	𐍆𐌰𐌹𐍂𐌲𐌿𐌽𐌹 • (fairguni) n
𐌰𐌹𐍂𐌶𐌴𐌹	Noun	𐌰𐌹𐍂𐌶𐌴𐌹 • (airzei) f
𐍃𐌺𐌰𐌽𐌳𐌰	Noun	𐍃𐌺𐌰𐌽𐌳𐌰 • (skanda) f
𐌰𐍃𐌹𐌻𐌿𐍃	Noun	𐌰𐍃𐌹𐌻𐌿𐍃 • (asilus) m
𐌰𐌹𐍂𐌺𐌽𐌹𐌸𐌰	Noun	𐌰𐌹𐍂𐌺𐌽𐌹𐌸𐌰 • (airkniþa) f
𐌿𐌽𐌺𐌰𐌿𐍂𐌴𐌹𐌽𐍃	Noun	𐌿𐌽𐌺𐌰𐌿𐍂𐌴𐌹𐌽𐍃 • (unkaureins) f
𐌱𐌰𐌽𐌳𐍅𐌰	Noun	𐌱𐌰𐌽𐌳𐍅𐌰 • (bandwa) f
𐌼𐌴𐌻	Noun	𐌼𐌴𐌻 • (mēl) n
𐌳𐌹𐌰𐌱𐌿𐌻𐌰	Noun	𐌳𐌹𐌰𐌱𐌿𐌻𐌰 • (diabula) f
𐍅𐌰𐌿𐍂𐍃𐍄𐍅𐌾𐌰	Noun	𐍅𐌰𐌿𐍂𐍃𐍄𐍅𐌾𐌰 • (waurstwja) m
𐌲𐌰𐌱𐌴𐌹	Noun	𐌲𐌰𐌱𐌴𐌹 • (gabei) f
𐌼𐌰𐍂𐌴𐌹	Noun	𐌼𐌰𐍂𐌴𐌹 • (marei) f
𐌿𐌽𐍆𐍂𐌴𐌹𐌳𐌴𐌹𐌽𐍃	Noun	𐌿𐌽𐍆𐍂𐌴𐌹𐌳𐌴𐌹𐌽𐍃 • (unfreideins) f
𐌲𐌰𐍃𐌰𐍄𐌴𐌹𐌽𐍃	Noun	𐌲𐌰𐍃𐌰𐍄𐌴𐌹𐌽𐍃 • (gasateins) f
𐌼𐌹𐍄𐍉𐌽	Noun	𐌼𐌹𐍄𐍉𐌽 • (mitōn)
𐌷𐌰𐌿𐍂𐌽𐌾𐌰	Noun	𐌷𐌰𐌿𐍂𐌽𐌾𐌰 • (haurnja) m
𐍅𐌰𐌽𐌳𐌿𐍃	Noun	𐍅𐌰𐌽𐌳𐌿𐍃 • (wandus) m
𐍃𐌿𐌽𐌿𐍃	Noun	𐍃𐌿𐌽𐌿𐍃 • (sunus) m
𐌲𐌰𐌼𐌰𐌹𐌽𐌸𐍃	Noun	𐌲𐌰𐌼𐌰𐌹𐌽𐌸𐍃 • (gamainþs) f
𐍃𐌰𐌻𐌹𐌸𐍅𐍉𐍃	Noun	𐍃𐌰𐌻𐌹𐌸𐍅𐍉𐍃 • (saliþwōs) f pl
𐍅𐌰𐌿𐍂𐌳𐌰𐌾𐌹𐌿𐌺𐌰	Noun	𐍅𐌰𐌿𐍂𐌳𐌰𐌾𐌹𐌿𐌺𐌰 • (waurdajiuka) f
𐌿𐍆𐌰𐍂𐌼𐌴𐌻𐌴𐌹𐌽𐍃	Noun	𐌿𐍆𐌰𐍂𐌼𐌴𐌻𐌴𐌹𐌽𐍃 • (ufarmēleins) f
𐌱𐌹𐌱𐌰𐌿𐍂𐌲𐌴𐌹𐌽𐍃	Noun	𐌱𐌹𐌱𐌰𐌿𐍂𐌲𐌴𐌹𐌽𐍃 • (bibaurgeins) f
𐌰𐌹𐌸𐌴𐌹	Noun	𐌰𐌹𐌸𐌴𐌹 • (aiþei) f
𐌷𐌰𐍂𐌾𐌹𐍃	Noun	𐌷𐌰𐍂𐌾𐌹𐍃 • (harjis) m
𐍅𐌴𐌹𐌽𐌰𐌱𐌰𐍃𐌹	Noun	𐍅𐌴𐌹𐌽𐌰𐌱𐌰𐍃𐌹 • (weinabasi) n
𐌲𐌰𐌻𐌹𐌿𐌲𐌰𐌱𐍂𐍉𐌸𐌰𐍂	Noun	𐌲𐌰𐌻𐌹𐌿𐌲𐌰𐌱𐍂𐍉𐌸𐌰𐍂 • (galiugabrōþar) m
𐌲𐌰𐌲𐍂𐌴𐍆𐍄𐍃	Noun	𐌲𐌰𐌲𐍂𐌴𐍆𐍄𐍃 • (gagrēfts) f
𐍂𐌰𐌶𐌽	Noun	𐍂𐌰𐌶𐌽 • (razn) n
𐌳𐍂𐌿𐌽𐌾𐌿𐍃	Noun	𐌳𐍂𐌿𐌽𐌾𐌿𐍃 • (drunjus) m
𐌰𐌿𐍂𐍄𐌹𐌲𐌰𐍂𐌳𐍃	Noun	𐌰𐌿𐍂𐍄𐌹𐌲𐌰𐍂𐌳𐍃 • (aurtigards) m
𐍄𐌹𐌼𐍂𐌴𐌹𐌽𐍃	Noun	𐍄𐌹𐌼𐍂𐌴𐌹𐌽𐍃 • (timreins) f
𐍃𐌺𐌰𐌳𐌿𐍃	Noun	𐍃𐌺𐌰𐌳𐌿𐍃 • (skadus) m
𐌿𐌽𐍃𐍅𐌴𐍂𐌹𐌸𐌰	Noun	𐌿𐌽𐍃𐍅𐌴𐍂𐌹𐌸𐌰 • (unswēriþa) f
𐌱𐌹𐌷𐌰𐌹𐍄𐌾𐌰	Noun	𐌱𐌹𐌷𐌰𐌹𐍄𐌾𐌰 • (bihaitja) m
𐌷𐌿𐍀𐍃	Noun	𐌷𐌿𐍀𐍃 • (hups) m
𐍃𐌰𐌿𐍂𐌹𐌽𐌹	Noun	𐍃𐌰𐌿𐍂𐌹𐌽𐌹 • (Saurini) f
𐍆𐍂𐌹𐌰𐌸𐍅𐌰	Noun	𐍆𐍂𐌹𐌰𐌸𐍅𐌰 • (friaþwa) f
𐍅𐌹𐍄𐍉𐌳𐌰𐌻𐌰𐌹𐍃𐌰𐍂𐌴𐌹𐍃	Noun	𐍅𐌹𐍄𐍉𐌳𐌰𐌻𐌰𐌹𐍃𐌰𐍂𐌴𐌹𐍃 • (witōdalaisāreis) m
𐌻𐌰𐌹𐌺𐍃	Noun	𐌻𐌰𐌹𐌺𐍃 • (laiks) m
𐌿𐌽𐌷𐌿𐌻𐌸𐌰	Noun	𐌿𐌽𐌷𐌿𐌻𐌸𐌰 • (unhulþa) m
𐌷𐌰𐌽𐌳𐌿𐍃	Noun	𐌷𐌰𐌽𐌳𐌿𐍃 • (handus) f
𐍃𐍄𐌹𐍅𐌹𐍄𐌹	Noun	𐍃𐍄𐌹𐍅𐌹𐍄𐌹 • (stiwiti) n
𐌽𐌹𐌸𐌾𐌹𐍃	Noun	𐌽𐌹𐌸𐌾𐌹𐍃 • (niþjis) m
𐍃𐍅𐌿𐌼𐍆𐍃𐌻	Noun	𐍃𐍅𐌿𐌼𐍆𐍃𐌻 • (swumfsl) n
𐌲𐌰𐍅𐌰𐍂𐌲𐌴𐌹𐌽𐍃	Noun	𐌲𐌰𐍅𐌰𐍂𐌲𐌴𐌹𐌽𐍃 • (gawargeins) f
𐌼𐌰𐌿𐍂𐌸𐍂	Noun	𐌼𐌰𐌿𐍂𐌸𐍂 • (maurþr) n
𐌲𐌹𐌻𐌸𐌰	Noun	𐌲𐌹𐌻𐌸𐌰 • (gilþa) f
𐌷𐌰𐌿𐌷𐌹𐌸𐌰	Noun	𐌷𐌰𐌿𐌷𐌹𐌸𐌰 • (hauhiþa) f
𐌱𐌰𐌽𐌳𐍅𐍉	Noun	𐌱𐌰𐌽𐌳𐍅𐍉 • (bandwō) f
𐌳𐌰𐌿𐍀𐌴𐌹𐌽𐍃	Noun	𐌳𐌰𐌿𐍀𐌴𐌹𐌽𐍃 • (daupeins) f
𐌷𐌰𐌿𐌽𐌹𐌸𐌰	Noun	𐌷𐌰𐌿𐌽𐌹𐌸𐌰 • (hauniþa) f
𐍅𐌿𐌻𐍅𐌰	Noun	𐍅𐌿𐌻𐍅𐌰 • (wulwa) f
𐍃𐌰𐌿𐌸𐍃	Noun	𐍃𐌰𐌿𐌸𐍃 • (sauþs) m
𐌻𐌰𐌿𐍆𐍃	Noun	𐌻𐌰𐌿𐍆𐍃 • (laufs) m
𐌿𐌽𐌻𐌿𐍃𐍄𐌿𐍃	Noun	𐌿𐌽𐌻𐌿𐍃𐍄𐌿𐍃 • (unlustus) m
𐌳𐍂𐌰𐌿𐌷𐍄𐌹𐌽𐌰𐍃𐍃𐌿𐍃	Noun	𐌳𐍂𐌰𐌿𐌷𐍄𐌹𐌽𐌰𐍃𐍃𐌿𐍃 • (drauhtinassus) m
𐌲𐌹𐌻𐍃𐍄𐍂𐌰𐌼𐌴𐌻𐌴𐌹𐌽𐍃	Noun	𐌲𐌹𐌻𐍃𐍄𐍂𐌰𐌼𐌴𐌻𐌴𐌹𐌽𐍃 • (gilstramēleins) f
𐍅𐌴𐌹𐌽	Noun	𐍅𐌴𐌹𐌽 • (wein) n
𐍆𐍂𐌰𐌿𐌾𐌰	Noun	𐍆𐍂𐌰𐌿𐌾𐌰 • (frauja) m
𐌳𐌿𐌻𐌸𐍃	Noun	𐌳𐌿𐌻𐌸𐍃 • (dulþs) f
𐌸𐌹𐍅𐌹	Noun	𐌸𐌹𐍅𐌹 • (þiwi) f
𐍃𐌽𐌰𐌹𐍅𐍃	Noun	𐍃𐌽𐌰𐌹𐍅𐍃 • (snaiws) m
𐌰𐌽𐌳𐍅𐌰𐌹𐍂𐌸𐌹	Noun	𐌰𐌽𐌳𐍅𐌰𐌹𐍂𐌸𐌹 • (andwairþi) n
𐌰𐌿𐌷𐌾𐍉𐌳𐌿𐍃	Noun	𐌰𐌿𐌷𐌾𐍉𐌳𐌿𐍃 • (auhjōdus) m
𐌰𐌹𐍀𐌹𐍃𐌺𐌰𐌿𐍀𐌴𐌹	Noun	𐌰𐌹𐍀𐌹𐍃𐌺𐌰𐌿𐍀𐌴𐌹 • (aipiskaupei) f
𐌷𐌰𐌺𐌿𐌻𐍃	Noun	𐌷𐌰𐌺𐌿𐌻𐍃 • (hakuls) m
𐍆𐍂𐌰𐍅𐌰𐌿𐍂𐌷𐍄𐍃	Noun	𐍆𐍂𐌰𐍅𐌰𐌿𐍂𐌷𐍄𐍃 • (frawaurhts) f
𐌲𐌰𐍅𐌰𐌹𐍂𐌸𐌹	Noun	𐌲𐌰𐍅𐌰𐌹𐍂𐌸𐌹 • (gawairþi) n
𐌼𐌹𐌻𐌹𐌸	Noun	𐌼𐌹𐌻𐌹𐌸 • (miliþ) n
𐌰𐍅𐌰	Noun	𐌰𐍅𐌰 • (awa) m
𐍃𐍄𐌰𐌹𐍂𐌽𐍉	Noun	𐍃𐍄𐌰𐌹𐍂𐌽𐍉 • (stairnō) f
𐍆𐍂𐌰𐌸𐌹	Noun	𐍆𐍂𐌰𐌸𐌹 • (fraþi) n
𐌷𐌹𐌻𐌼𐍃	Noun	𐌷𐌹𐌻𐌼𐍃 • (hilms) m
𐌰𐍆𐍃𐍄𐌰𐍃𐍃	Noun	𐌰𐍆𐍃𐍄𐌰𐍃𐍃 • (afstass) f
𐍅𐌴𐌹𐌷𐍃	Noun	𐍅𐌴𐌹𐌷𐍃 • (weihs) n
𐍀𐌿𐌽𐌳	Noun	𐍀𐌿𐌽𐌳 • (pund) n
𐌳𐌰𐌿𐌸𐌿𐍃	Noun	𐌳𐌰𐌿𐌸𐌿𐍃 • (dauþus) m
𐌻𐌰𐌹𐍃𐍄𐍃	Noun	𐌻𐌰𐌹𐍃𐍄𐍃 • (laists) m
𐍃𐍀𐌹𐌻𐌳𐌰	Noun	𐍃𐍀𐌹𐌻𐌳𐌰 • (spilda) f
𐌿𐌽𐌳𐌰𐌿𐍂𐌽𐌹𐌼𐌰𐍄𐍃	Noun	𐌿𐌽𐌳𐌰𐌿𐍂𐌽𐌹𐌼𐌰𐍄𐍃 • (undaurnimats) m
𐌵𐍂𐌰𐌼𐌼𐌹𐌸𐌰	Noun	𐌵𐍂𐌰𐌼𐌼𐌹𐌸𐌰 • (qrammiþa) f
𐍆𐌰𐌳𐍂𐌴𐌹𐌽𐍃	Noun	𐍆𐌰𐌳𐍂𐌴𐌹𐌽𐍃 • (fadreins) f
𐍃𐌰𐌺𐌺𐌿𐍃	Noun	𐍃𐌰𐌺𐌺𐌿𐍃 • (sakkus) m
𐌴𐌹𐍃𐌰𐍂𐌽𐌰𐌱𐌰𐌽𐌳𐌹	Noun	𐌴𐌹𐍃𐌰𐍂𐌽𐌰𐌱𐌰𐌽𐌳𐌹 • (eisarnabandi) f
𐍃𐌽𐌿𐍄𐍂𐌴𐌹	Noun	𐍃𐌽𐌿𐍄𐍂𐌴𐌹 • (snutrei) f
𐌲𐌿𐍄𐌸𐌹𐌿𐌳𐌰	Noun	𐌲𐌿𐍄𐌸𐌹𐌿𐌳𐌰 • (gutþiuda) f
𐌼𐌹𐌳𐌿𐌼𐌰	Noun	𐌼𐌹𐌳𐌿𐌼𐌰 • (miduma) f
𐌰𐌲𐌲𐍅𐌹𐌸𐌰	Noun	𐌰𐌲𐌲𐍅𐌹𐌸𐌰 • (aggwiþa) f
𐌷𐌿𐌽𐌳	Noun	𐌷𐌿𐌽𐌳 • (hund) n
𐌷𐌿𐌽𐌳	Noun	𐌷𐌿𐌽𐌳 • (hund)
𐌺𐌰𐌻𐌱𐍉	Noun	𐌺𐌰𐌻𐌱𐍉 • (kalbō) f
𐌰𐌹𐌽𐌰𐌼𐌿𐌽𐌳𐌹𐌸𐌰	Noun	𐌰𐌹𐌽𐌰𐌼𐌿𐌽𐌳𐌹𐌸𐌰 • (ainamundiþa) f
𐌳𐌰𐌿𐌱𐌹𐌸𐌰	Noun	𐌳𐌰𐌿𐌱𐌹𐌸𐌰 • (daubiþa) f
𐌰𐍂𐌼𐍃	Noun	𐌰𐍂𐌼𐍃 • (arms) m
𐍅𐍂𐌰𐌺𐌾𐌰	Noun	𐍅𐍂𐌰𐌺𐌾𐌰 • (wrakja) f
𐌰𐌿𐍂𐌰𐌻𐌹	Noun	𐌰𐌿𐍂𐌰𐌻𐌹 • (aurāli) n
𐌱𐌰𐌿𐍂𐌲𐍃𐍅𐌰𐌳𐌳𐌾𐌿𐍃	Noun	𐌱𐌰𐌿𐍂𐌲𐍃𐍅𐌰𐌳𐌳𐌾𐌿𐍃 • (baurgswaddjus) f
𐌼𐌰𐌲𐌿𐍃	Noun	𐌼𐌰𐌲𐌿𐍃 • (magus) m
𐌱𐌰𐌳𐌹	Noun	𐌱𐌰𐌳𐌹 • (badi) n
𐌼𐌴𐌺𐌴𐌹𐍃	Noun	𐌼𐌴𐌺𐌴𐌹𐍃 • (mēkeis) m
𐌸𐌰𐌿𐍂𐌽𐌿𐍃	Noun	𐌸𐌰𐌿𐍂𐌽𐌿𐍃 • (þaurnus) m
𐌳𐌰𐌿𐍂𐌰𐍅𐌰𐍂𐌳𐍃	Noun	𐌳𐌰𐌿𐍂𐌰𐍅𐌰𐍂𐌳𐍃 • (daurawards) m
𐌸𐌹𐌿𐍆𐍃	Noun	𐌸𐌹𐌿𐍆𐍃 • (þiufs) m
𐌷𐌴𐌹𐍄𐍉	Noun	𐌷𐌴𐌹𐍄𐍉 • (heitō) f
𐍅𐌰𐍄𐍉	Noun	𐍅𐌰𐍄𐍉 • (watō) n
𐌰𐌽𐌰𐌽𐌹𐌿𐌾𐌹𐌸𐌰	Noun	𐌰𐌽𐌰𐌽𐌹𐌿𐌾𐌹𐌸𐌰 • (ananiujiþa) f
𐌰𐍃𐌹𐌻𐌿𐌵𐌰𐌹𐍂𐌽𐌿𐍃	Noun	𐌰𐍃𐌹𐌻𐌿𐌵𐌰𐌹𐍂𐌽𐌿𐍃 • (asiluqairnus) f
𐍀𐌰𐌿𐍂𐍀𐌰𐌿𐍂𐌰	Noun	𐍀𐌰𐌿𐍂𐍀𐌰𐌿𐍂𐌰 • (paurpaura) f
𐌾𐌿𐌺𐌿𐌶𐌹	Noun	𐌾𐌿𐌺𐌿𐌶𐌹 • (jukuzi) f
𐌰𐌻𐌻𐍅𐌰𐌻𐌳𐌰𐌽𐌳𐍃	Noun	𐌰𐌻𐌻𐍅𐌰𐌻𐌳𐌰𐌽𐌳𐍃 • (allwaldands) m
𐌰𐌻𐌴𐍅	Noun	𐌰𐌻𐌴𐍅 • (alēw) n
𐌼𐌴𐌽𐌰	Noun	𐌼𐌴𐌽𐌰 • (mēna) m
𐌷𐌰𐌿𐌷𐌷𐌰𐌹𐍂𐍄𐌴𐌹	Noun	𐌷𐌰𐌿𐌷𐌷𐌰𐌹𐍂𐍄𐌴𐌹 • (hauhhairtei) f
𐍃𐍀𐌰𐌹𐌺𐌿𐌻𐌰𐍄𐌿𐍂	Noun	𐍃𐍀𐌰𐌹𐌺𐌿𐌻𐌰𐍄𐌿𐍂 • (spaikulatur) m
𐍂𐌴𐌹𐌺𐍃	Noun	𐍂𐌴𐌹𐌺𐍃 • (reiks) m
𐌰𐌿𐍂𐌺𐌾𐌿𐍃	Noun	𐌰𐌿𐍂𐌺𐌾𐌿𐍃 • (aurkjus) m
𐍅𐌰𐌹𐌳𐌴𐌳𐌾𐌰	Noun	𐍅𐌰𐌹𐌳𐌴𐌳𐌾𐌰 • (waidēdja) m
𐍅𐌰𐌼𐌱𐌰	Noun	𐍅𐌰𐌼𐌱𐌰 • (wamba) f
𐌰𐍂𐌱𐌰𐌹𐌸𐍃	Noun	𐌰𐍂𐌱𐌰𐌹𐌸𐍃 • (arbaiþs) f
𐌰𐌲𐌻𐍉	Noun	𐌰𐌲𐌻𐍉 • (aglō) f
𐍂𐌰𐍃𐍄𐌰	Noun	𐍂𐌰𐍃𐍄𐌰 • (rasta) f
𐌲𐍂𐍉𐌱𐌰	Noun	𐌲𐍂𐍉𐌱𐌰 • (grōba) f
𐌰𐌽𐌳𐌱𐌰𐌷𐍄𐍃	Noun	𐌰𐌽𐌳𐌱𐌰𐌷𐍄𐍃 • (andbahts) m
𐍅𐌰𐌳𐌹	Noun	𐍅𐌰𐌳𐌹 • (wadi) n
𐍅𐌰𐌽𐌹𐌽𐌰𐍃𐍃𐌿𐍃	Noun	𐍅𐌰𐌽𐌹𐌽𐌰𐍃𐍃𐌿𐍃 • (waninassus) m
𐍆𐍂𐌴𐌹𐌷𐌰𐌻𐍃	Noun	𐍆𐍂𐌴𐌹𐌷𐌰𐌻𐍃 • (freihals) m
𐍅𐍉𐌺𐍂𐍃	Noun	𐍅𐍉𐌺𐍂𐍃 • (wōkrs) m
𐌰𐍀𐌰𐌿𐍃𐍄𐌰𐌿𐌻𐌿𐍃	Noun	𐌰𐍀𐌰𐌿𐍃𐍄𐌰𐌿𐌻𐌿𐍃 • (apaustaulus) m
𐌼𐌰𐍂𐌶𐌴𐌹𐌽𐍃	Noun	𐌼𐌰𐍂𐌶𐌴𐌹𐌽𐍃 • (marzeins) f
𐌻𐌿𐍆𐍄𐌿𐍃	Noun	𐌻𐌿𐍆𐍄𐌿𐍃 • (luftus) m
𐌽𐌰𐌿𐌳𐌹𐌱𐌰𐌽𐌳𐌹	Noun	𐌽𐌰𐌿𐌳𐌹𐌱𐌰𐌽𐌳𐌹 • (naudibandi) f
𐌻𐌹𐌿𐌷𐌰𐌸	Noun	𐌻𐌹𐌿𐌷𐌰𐌸 • (liuhaþ) n
𐍅𐌹𐍄𐍉𐌸	Noun	𐍅𐌹𐍄𐍉𐌸 • (witōþ) n
𐌰𐌻𐌳𐍃	Noun	𐌰𐌻𐌳𐍃 • (alds) f
𐌰𐍆𐌳𐍉𐌼𐌴𐌹𐌽𐍃	Noun	𐌰𐍆𐌳𐍉𐌼𐌴𐌹𐌽𐍃 • (afdōmeins) f
𐌱𐌰𐌻𐍅𐌴𐌹𐌽𐍃	Noun	𐌱𐌰𐌻𐍅𐌴𐌹𐌽𐍃 • (balweins) f
𐍃𐌼𐌰𐍂𐌽𐌰	Noun	𐍃𐌼𐌰𐍂𐌽𐌰 • (smarna) f
𐍃𐌺𐌿𐌻𐌰	Noun	𐍃𐌺𐌿𐌻𐌰 • (skula) m
𐍃𐌹𐌳𐌿𐍃	Noun	𐍃𐌹𐌳𐌿𐍃 • (sidus) m
𐌰𐌹𐍂𐌹𐌶𐌰	Noun	𐌰𐌹𐍂𐌹𐌶𐌰 • (airiza) m
𐍅𐌰𐌹𐍀𐍃	Noun	𐍅𐌰𐌹𐍀𐍃 • (waips) m
𐍅𐌹𐌲𐍃	Noun	𐍅𐌹𐌲𐍃 • (wigs) m
𐍃𐌰𐌱𐌱𐌰𐍄𐍉	Noun	𐍃𐌰𐌱𐌱𐌰𐍄𐍉 • (sabbatō) m
𐌸𐌿𐌷𐍄𐌿𐍃	Noun	𐌸𐌿𐌷𐍄𐌿𐍃 • (þuhtus) m
𐍅𐌹𐍄𐍉𐌳𐌰𐍆𐌰𐍃𐍄𐌴𐌹𐍃	Noun	𐍅𐌹𐍄𐍉𐌳𐌰𐍆𐌰𐍃𐍄𐌴𐌹𐍃 • (witōdafasteis) m
𐌳𐌰𐌿𐍂	Noun	𐌳𐌰𐌿𐍂 • (daur) n
𐍄𐌰𐌿𐌹	Noun	𐍄𐌰𐌿𐌹 • (taui) n
𐍃𐌹𐍄𐌻𐍃	Noun	𐍃𐌹𐍄𐌻𐍃 • (sitls) m
𐌲𐌰𐌻𐌲𐌰	Noun	𐌲𐌰𐌻𐌲𐌰 • (galga) m
𐌰𐌹𐌶𐌰𐍃𐌼𐌹𐌸𐌰	Noun	𐌰𐌹𐌶𐌰𐍃𐌼𐌹𐌸𐌰 • (aizasmiþa) m
𐌰𐍄𐍄𐌰	Noun	𐌰𐍄𐍄𐌰 • (atta) m
𐌱𐍂𐌿𐌽𐌽𐌰	Noun	𐌱𐍂𐌿𐌽𐌽𐌰 • (brunna) m
𐌻𐌴𐌹𐌺	Noun	𐌻𐌴𐌹𐌺 • (leik) n
𐍅𐌰𐌹𐌷𐍄𐍃	Noun	𐍅𐌰𐌹𐌷𐍄𐍃 • (waihts) f
𐌰𐌼𐍃	Noun	𐌰𐌼𐍃 • (ams) m
𐍃𐌰𐌹𐍅𐌰𐌻𐌰	Noun	𐍃𐌰𐌹𐍅𐌰𐌻𐌰 • (saiwala) f
𐌷𐌻𐌴𐌹𐌸𐍂𐌰	Noun	𐌷𐌻𐌴𐌹𐌸𐍂𐌰 • (hleiþra) f
𐌰𐌿𐌷𐍃𐌰	Noun	𐌰𐌿𐌷𐍃𐌰 • (auhsa) m
𐌻𐌰𐌲𐌲𐌴𐌹	Noun	𐌻𐌰𐌲𐌲𐌴𐌹 • (laggei) f
𐌰𐍅𐌴𐌸𐌹	Noun	𐌰𐍅𐌴𐌸𐌹 • (awēþi) n
𐌰𐌹𐍈𐌰𐍄𐌿𐌽𐌳𐌹	Noun	𐌰𐌹𐍈𐌰𐍄𐌿𐌽𐌳𐌹 • (aiƕatundi) f
𐍆𐍉𐌳𐍂	Noun	𐍆𐍉𐌳𐍂 • (fōdr) n
𐌰𐌿𐌸𐌹𐌳𐌰	Noun	𐌰𐌿𐌸𐌹𐌳𐌰 • (auþida) f
𐍃𐍅𐌴𐌲𐌽𐌹𐌸𐌰	Noun	𐍃𐍅𐌴𐌲𐌽𐌹𐌸𐌰 • (swēgniþa) f
𐍃𐌰𐌿𐍂𐌲𐌰	Noun	𐍃𐌰𐌿𐍂𐌲𐌰 • (saurga) f
𐌼𐌿𐌽𐍃	Noun	𐌼𐌿𐌽𐍃 • (muns) m
𐌼𐌰𐍅𐌹	Noun	𐌼𐌰𐍅𐌹 • (mawi) f
𐌼𐌰𐌹𐌷𐍃𐍄𐌿𐍃	Noun	𐌼𐌰𐌹𐌷𐍃𐍄𐌿𐍃 • (maihstus) m
𐍅𐌹𐌽𐍄𐍂𐌿𐍃	Noun	𐍅𐌹𐌽𐍄𐍂𐌿𐍃 • (wintrus) m
𐌳𐌹𐌰𐌱𐌿𐌻𐌿𐍃	Noun	𐌳𐌹𐌰𐌱𐌿𐌻𐌿𐍃 • (diabulus) m
akēt	Noun	akēt • (akēt) m
𐌲𐌰𐌹𐍄𐍃	Noun	𐌲𐌰𐌹𐍄𐍃 • (gaits) f
𐌵𐌰𐌹𐍂𐍂𐌴𐌹	Noun	𐌵𐌰𐌹𐍂𐍂𐌴𐌹 • (qairrei) f
𐍄𐌰𐌲𐌻	Noun	𐍄𐌰𐌲𐌻 • (tagl) n
𐌼𐌰𐌹𐌼𐌱𐍂𐌰𐌽𐌰	Noun	𐌼𐌰𐌹𐌼𐌱𐍂𐌰𐌽𐌰 • (maimbrana) m
𐍃𐍄𐌿𐌱𐌾𐌿𐍃	Noun	𐍃𐍄𐌿𐌱𐌾𐌿𐍃 • (stubjus) m
𐌹𐌱𐌽𐌰𐍃𐍃𐌿𐍃	Noun	𐌹𐌱𐌽𐌰𐍃𐍃𐌿𐍃 • (ibnassus) m
𐌷𐌻𐌰𐌹𐍅𐌰𐍃𐌽𐌰	Noun	𐌷𐌻𐌰𐌹𐍅𐌰𐍃𐌽𐌰 • (hlaiwasna) f
𐌷𐌰𐌹𐍄𐌹	Noun	𐌷𐌰𐌹𐍄𐌹 • (haiti) f
𐌲𐌰𐌼𐌴𐌻𐌴𐌹𐌽𐍃	Noun	𐌲𐌰𐌼𐌴𐌻𐌴𐌹𐌽𐍃 • (gamēleins) f
𐌳𐌰𐌹𐌼𐍉𐌽𐌰𐍂𐌴𐌹𐍃	Noun	𐌳𐌰𐌹𐌼𐍉𐌽𐌰𐍂𐌴𐌹𐍃 • (daimōnāreis) m
𐌽𐌰𐌷𐍄𐍃	Noun	𐌽𐌰𐌷𐍄𐍃 • (nahts) f
𐌷𐌻𐌹𐍆𐍄𐌿𐍃	Noun	𐌷𐌻𐌹𐍆𐍄𐌿𐍃 • (hliftus) m
𐌺𐌴𐌻𐌹𐌺𐌽	Noun	𐌺𐌴𐌻𐌹𐌺𐌽 • (kēlikn) n
𐍅𐌴𐌹𐌽𐌰𐍄𐌰𐌹𐌽𐍃	Noun	𐍅𐌴𐌹𐌽𐌰𐍄𐌰𐌹𐌽𐍃 • (weinatains) m
𐍃𐍄𐍉𐌻𐍃	Noun	𐍃𐍄𐍉𐌻𐍃 • (stōls) m
𐍃𐌻𐌰𐌷𐍃	Noun	𐍃𐌻𐌰𐌷𐍃 • (slahs) m
𐌼𐌴𐍂𐌴𐌹𐌽𐍃	Noun	𐌼𐌴𐍂𐌴𐌹𐌽𐍃 • (mēreins) f
𐌲𐌰𐍅𐌹	Noun	𐌲𐌰𐍅𐌹 • (gawi) n
𐌼𐌹𐌻𐌿𐌺𐍃	Noun	𐌼𐌹𐌻𐌿𐌺𐍃 • (miluks) f
𐌲𐌰𐍅𐌹𐍃𐍃	Noun	𐌲𐌰𐍅𐌹𐍃𐍃 • (gawiss) f
𐍅𐌰𐌿𐍂𐌼𐍃	Noun	𐍅𐌰𐌿𐍂𐌼𐍃 • (waurms) m
𐌰𐌿𐌷𐍃𐌿𐍃	Noun	𐌰𐌿𐌷𐍃𐌿𐍃 • (auhsus) m
𐍀𐌴𐌹𐌺𐌰𐌱𐌰𐌲𐌼𐍃	Noun	𐍀𐌴𐌹𐌺𐌰𐌱𐌰𐌲𐌼𐍃 • (peikabagms) m
𐍃𐌹𐌲𐌹𐍃𐌻𐌰𐌿𐌽	Noun	𐍃𐌹𐌲𐌹𐍃𐌻𐌰𐌿𐌽 • (sigislaun) n
𐌰𐍂𐌱𐌹	Noun	𐌰𐍂𐌱𐌹 • (arbi) n
𐌸𐌹𐌿𐌼𐌰𐌲𐌿𐍃	Noun	𐌸𐌹𐌿𐌼𐌰𐌲𐌿𐍃 • (þiumagus) m
𐍅𐌰𐌹𐍂𐌸	Noun	𐍅𐌰𐌹𐍂𐌸 • (wairþ) n
𐌹𐌽𐌽𐌹𐌿𐌾𐌹𐌸𐌰	Noun	𐌹𐌽𐌽𐌹𐌿𐌾𐌹𐌸𐌰 • (inniujiþa) f
𐌰𐌽𐌳𐌰𐍃𐍄𐌰𐌿𐌰	Noun	𐌰𐌽𐌳𐌰𐍃𐍄𐌰𐌿𐌰 • (andastaua) m
𐍅𐌰𐌿𐍂𐌳	Noun	𐍅𐌰𐌿𐍂𐌳 • (waurd) n
𐌸𐍂𐌰𐍆𐍃𐍄𐌴𐌹𐌽𐍃	Noun	𐌸𐍂𐌰𐍆𐍃𐍄𐌴𐌹𐌽𐍃 • (þrafsteins) f
𐌰𐍂𐌼𐌰𐌷𐌰𐌹𐍂𐍄𐌴𐌹	Noun	𐌰𐍂𐌼𐌰𐌷𐌰𐌹𐍂𐍄𐌴𐌹 • (armahairtei) f
𐌽𐌰𐌿𐌸𐍃	Noun	𐌽𐌰𐌿𐌸𐍃 • (nauþs) f
𐍅𐌴𐌲𐍃	Noun	𐍅𐌴𐌲𐍃 • (wēgs) m
𐌰𐌽𐌳𐌰𐌽𐌰𐌷𐍄𐌹	Noun	𐌰𐌽𐌳𐌰𐌽𐌰𐌷𐍄𐌹 • (andanahti) f
𐌽𐌹𐌿𐌾𐌹𐌸𐌰	Noun	𐌽𐌹𐌿𐌾𐌹𐌸𐌰 • (niujiþa) f
𐌰𐌺𐍂𐌰𐌽	Noun	𐌰𐌺𐍂𐌰𐌽 • (akran) n
𐌻𐌹𐌲𐍂𐍃	Noun	𐌻𐌹𐌲𐍂𐍃 • (ligrs) m
𐍆𐍂𐌹𐌾𐍉𐌽𐍃	Noun	𐍆𐍂𐌹𐌾𐍉𐌽𐍃 • (frijōns) f
𐌳𐌰𐌿𐍂𐌰𐍅𐌰𐍂𐌳𐍉	Noun	𐌳𐌰𐌿𐍂𐌰𐍅𐌰𐍂𐌳𐍉 • (daurawardō) f
𐌷𐌹𐌼𐌹𐌽𐍃	Noun	𐌷𐌹𐌼𐌹𐌽𐍃 • (himins) m
𐌷𐌰𐌿𐌷𐌴𐌹	Noun	𐌷𐌰𐌿𐌷𐌴𐌹 • (hauhei) f
𐍃𐍉𐌺𐌴𐌹𐌽𐍃	Noun	𐍃𐍉𐌺𐌴𐌹𐌽𐍃 • (sōkeins) f
𐍆𐌹𐌾𐌰𐌸𐍅𐌰	Noun	𐍆𐌹𐌾𐌰𐌸𐍅𐌰 • (fijaþwa) f
𐍅𐌰𐌿𐍂𐍃𐍄𐍅	Noun	𐍅𐌰𐌿𐍂𐍃𐍄𐍅 • (waurstw) n
𐌰𐍂𐌱𐌾𐌰	Noun	𐌰𐍂𐌱𐌾𐌰 • (arbja) m
𐌰𐍂𐌱𐌾𐌰	Noun	𐌰𐍂𐌱𐌾𐌰 • (arbja)
𐌰𐌻𐌾𐌰𐌽	Noun	𐌰𐌻𐌾𐌰𐌽 • (aljan) n
𐌲𐌰𐍂𐌰𐌹𐌷𐍄𐌴𐌹𐌽𐍃	Noun	𐌲𐌰𐍂𐌰𐌹𐌷𐍄𐌴𐌹𐌽𐍃 • (garaihteins) f
𐌲𐌰𐍂𐌰𐌹𐌷𐍄𐌴𐌹𐌽𐍃	Noun	𐌲𐌰𐍂𐌰𐌹𐌷𐍄𐌴𐌹𐌽𐍃 • (garaihteins)
𐍂𐌹𐌿𐍂𐌴𐌹	Noun	𐍂𐌹𐌿𐍂𐌴𐌹 • (riurei) f
𐌿𐍃𐍆𐍉𐌳𐌴𐌹𐌽𐍃	Noun	𐌿𐍃𐍆𐍉𐌳𐌴𐌹𐌽𐍃 • (usfōdeins) f
𐌸𐌹𐌿𐌳𐌹𐌽𐌰𐍃𐍃𐌿𐍃	Noun	𐌸𐌹𐌿𐌳𐌹𐌽𐌰𐍃𐍃𐌿𐍃 • (þiudinassus) m
𐍃𐌰𐌹𐍅𐍃	Noun	𐍃𐌰𐌹𐍅𐍃 • (saiws) m
𐌺𐌽𐌹𐌿	Noun	𐌺𐌽𐌹𐌿 • (kniu) n
𐌰𐍆𐌰𐍂𐌰	Noun	𐌰𐍆𐌰𐍂𐌰 • (afara) m
𐌼𐌰𐌽𐌰𐍃𐌴𐌸𐍃	Noun	𐌼𐌰𐌽𐌰𐍃𐌴𐌸𐍃 • (manasēþs) f
𐍃𐍀𐌹𐌻𐌻	Noun	𐍃𐍀𐌹𐌻𐌻 • (spill) n
𐌷𐌻𐌰𐌹𐍆𐍃	Noun	𐌷𐌻𐌰𐌹𐍆𐍃 • (hlaifs) m
𐌽𐌹𐌿𐌷𐍃𐌴𐌹𐌽𐍃	Noun	𐌽𐌹𐌿𐌷𐍃𐌴𐌹𐌽𐍃 • (niuhseins) f
𐍃𐌹𐌺𐌻𐍃	Noun	𐍃𐌹𐌺𐌻𐍃 • (sikls) m
𐌲𐌰𐌼𐌰𐌹𐌽𐌾𐌰	Noun	𐌲𐌰𐌼𐌰𐌹𐌽𐌾𐌰 • (gamainja) m
𐌰𐌷𐌰𐌽𐌰	Noun	𐌰𐌷𐌰𐌽𐌰 • (ahana) f
𐍅𐌰𐌳𐌾𐌰𐌱𐍉𐌺𐍉𐍃	Noun	𐍅𐌰𐌳𐌾𐌰𐌱𐍉𐌺𐍉𐍃 • (wadjabōkōs) f pl
𐌲𐌰𐍂𐌳𐍃	Noun	𐌲𐌰𐍂𐌳𐍃 • (gards) m
𐍂𐌹𐌵𐌹𐍃	Noun	𐍂𐌹𐌵𐌹𐍃 • (riqis) n
𐍃𐍄𐌰𐌹𐌲𐌰	Noun	𐍃𐍄𐌰𐌹𐌲𐌰 • (staiga) f
𐌲𐌰𐍂𐌰𐌹𐌷𐍄𐌴𐌹	Noun	𐌲𐌰𐍂𐌰𐌹𐌷𐍄𐌴𐌹 • (garaihtei) f
𐌲𐌰𐌱𐌿𐌽𐌳𐌹	Noun	𐌲𐌰𐌱𐌿𐌽𐌳𐌹 • (gabundi) f
𐌹𐌿𐌳𐌰𐌹𐌿𐍃	Noun	𐌹𐌿𐌳𐌰𐌹𐌿𐍃 • (Iudaius) m
𐌰𐌹𐍅𐌰𐌲𐌲𐌴𐌻𐌾𐍉	Noun	𐌰𐌹𐍅𐌰𐌲𐌲𐌴𐌻𐌾𐍉 • (aiwaggēljō) f
𐌰𐍂𐌺𐌰𐌲𐌲𐌹𐌻𐌿𐍃	Noun	𐌰𐍂𐌺𐌰𐌲𐌲𐌹𐌻𐌿𐍃 • (arkaggilus) m
𐍆𐌹𐌾𐌰𐌽𐌳𐍃	Noun	𐍆𐌹𐌾𐌰𐌽𐌳𐍃 • (fijands) m
𐌼𐌹𐌶𐌳𐍉	Noun	𐌼𐌹𐌶𐌳𐍉 • (mizdō) f
𐌷𐌰𐌹𐌳𐌿𐍃	Noun	𐌷𐌰𐌹𐌳𐌿𐍃 • (haidus) m
𐍃𐌰𐌻𐌱𐍉𐌽𐍃	Noun	𐍃𐌰𐌻𐌱𐍉𐌽𐍃 • (salbōns) f
𐌿𐌽𐍃𐌿𐍄𐌹	Noun	𐌿𐌽𐍃𐌿𐍄𐌹 • (unsuti) n
𐌻𐌰𐌿𐌽	Noun	𐌻𐌰𐌿𐌽 • (laun) n
𐌷𐌰𐍄𐌹𐍃	Noun	𐌷𐌰𐍄𐌹𐍃 • (hatis) n
𐍃𐌿𐌽𐌾𐍉𐌽𐍃	Noun	𐍃𐌿𐌽𐌾𐍉𐌽𐍃 • (sunjōns) f
𐍅𐌹𐌽𐌳𐍃	Noun	𐍅𐌹𐌽𐌳𐍃 • (winds) m
𐌱𐍂𐌿𐌸𐍃	Noun	𐌱𐍂𐌿𐌸𐍃 • (brūþs) f
𐌷𐌻𐌿𐍄𐍂𐌹𐌸𐌰	Noun	𐌷𐌻𐌿𐍄𐍂𐌹𐌸𐌰 • (hlūtriþa) f
𐌷𐍂𐌿𐌲𐌲𐌰	Noun	𐌷𐍂𐌿𐌲𐌲𐌰 • (hrugga) f
𐌷𐌰𐌹𐌸𐌽𐍉	Noun	𐌷𐌰𐌹𐌸𐌽𐍉 • (haiþnō) f
𐌲𐌰𐌷𐍂𐌰𐌹𐌽𐌴𐌹𐌽𐍃	Noun	𐌲𐌰𐌷𐍂𐌰𐌹𐌽𐌴𐌹𐌽𐍃 • (gahraineins) f
𐌲𐌿𐌳𐌷𐌿𐍃	Noun	𐌲𐌿𐌳𐌷𐌿𐍃 • (gudhus) n
𐌼𐌰𐌲𐌰𐌸𐌴𐌹	Noun	𐌼𐌰𐌲𐌰𐌸𐌴𐌹 • (magaþei) f
𐌸𐌹𐌿𐌳𐌰𐌽𐍃	Noun	𐌸𐌹𐌿𐌳𐌰𐌽𐍃 • (þiudans) m
𐍄𐌿𐌲𐌲𐍉	Noun	𐍄𐌿𐌲𐌲𐍉 • (tuggō) f
𐌿𐌽𐌲𐌰𐌻𐌰𐌿𐌱𐌴𐌹𐌽𐍃	Noun	𐌿𐌽𐌲𐌰𐌻𐌰𐌿𐌱𐌴𐌹𐌽𐍃 • (ungalaubeins) f
𐍃𐍄𐌰𐌿𐌰	Noun	𐍃𐍄𐌰𐌿𐌰 • (staua) f
𐍃𐍄𐌰𐌿𐌰	Noun	𐍃𐍄𐌰𐌿𐌰 • (staua) m
𐌲𐍂𐌴𐌳𐌿𐍃	Noun	𐌲𐍂𐌴𐌳𐌿𐍃 • (grēdus) m
𐌿𐌽𐌱𐌹𐌰𐍂𐌹	Noun	𐌿𐌽𐌱𐌹𐌰𐍂𐌹 • (unbiari) n
𐍅𐌰𐌻𐌿𐍃	Noun	𐍅𐌰𐌻𐌿𐍃 • (walus) m
𐍅𐌴𐌹𐌽𐌰𐌲𐌰𐍂𐌳𐍃	Noun	𐍅𐌴𐌹𐌽𐌰𐌲𐌰𐍂𐌳𐍃 • (weinagards) m
𐍃𐌰𐌻𐌳𐍂𐌰	Noun	𐍃𐌰𐌻𐌳𐍂𐌰 • (saldra) f
𐌺𐌰𐍂𐌺𐌰𐍂𐌰	Noun	𐌺𐌰𐍂𐌺𐌰𐍂𐌰 • (karkara) f
𐍅𐌰𐌹𐌷𐍃𐍄𐌰	Noun	𐍅𐌰𐌹𐌷𐍃𐍄𐌰 • (waihsta) m
ᚱᚨᚾᛃᚨ	Noun	ᚱᚨᚾᛃᚨ • (ranja) m
𐌼𐌹𐌳𐌾𐌿𐌽𐌲𐌰𐍂𐌳𐍃	Noun	𐌼𐌹𐌳𐌾𐌿𐌽𐌲𐌰𐍂𐌳𐍃 • (midjungards) m
𐍀𐌰𐍂𐌰𐌺𐌻𐌴𐍄𐌿𐍃	Noun	𐍀𐌰𐍂𐌰𐌺𐌻𐌴𐍄𐌿𐍃 • (paraklētus) m
𐌽𐌰𐌵𐌰𐌳𐌴𐌹	Noun	𐌽𐌰𐌵𐌰𐌳𐌴𐌹 • (naqadei) f
𐍅𐌹𐍀𐌾𐌰	Noun	𐍅𐌹𐍀𐌾𐌰 • (wipja) f
𐌰𐍆𐌼𐌰𐍂𐌶𐌴𐌹𐌽𐍃	Noun	𐌰𐍆𐌼𐌰𐍂𐌶𐌴𐌹𐌽𐍃 • (afmarzeins) f
𐍀𐌰𐌿𐍂𐍀𐌿𐍂𐌰	Noun	𐍀𐌰𐌿𐍂𐍀𐌿𐍂𐌰 • (paurpura) f
𐌰𐌹𐌺𐌺𐌻𐌴𐍃𐌾𐍉	Noun	𐌰𐌹𐌺𐌺𐌻𐌴𐍃𐌾𐍉 • (aikklēsjō) f
𐍈𐌴𐌹𐌻𐌰	Noun	𐍈𐌴𐌹𐌻𐌰 • (ƕeila) f
𐌻𐌹𐌱𐌰𐌹𐌽𐍃	Noun	𐌻𐌹𐌱𐌰𐌹𐌽𐍃 • (libains) f
𐍆𐍂𐌰𐍃𐍄𐍃	Noun	𐍆𐍂𐌰𐍃𐍄𐍃 • (frasts) m
𐌱𐌹𐌳𐌰𐌲𐍅𐌰	Noun	𐌱𐌹𐌳𐌰𐌲𐍅𐌰 • (bidagwa) m
𐍄𐌿𐌽𐌸𐌿𐍃	Noun	𐍄𐌿𐌽𐌸𐌿𐍃 • (tunþus) m
𐍅𐌰𐌿𐍂𐍄𐍃	Noun	𐍅𐌰𐌿𐍂𐍄𐍃 • (waurts) f
𐌺𐌰𐌹𐍃𐌰𐍂	Noun	𐌺𐌰𐌹𐍃𐌰𐍂 • (kaisar) m
𐌺𐌰𐍄𐌹𐌻𐍃	Noun	𐌺𐌰𐍄𐌹𐌻𐍃 • (katils) f
𐌰𐌹𐍂𐌸𐌰	Noun	𐌰𐌹𐍂𐌸𐌰 • (airþa) f
𐍃𐌺𐌹𐌻𐌳𐌿𐍃	Noun	𐍃𐌺𐌹𐌻𐌳𐌿𐍃 • (skildus) m
𐌿𐍆𐌷𐌰𐌿𐍃𐌴𐌹𐌽𐍃	Noun	𐌿𐍆𐌷𐌰𐌿𐍃𐌴𐌹𐌽𐍃 • (ufhauseins) f
𐌷𐌰𐌻𐌻𐌿𐍃	Noun	𐌷𐌰𐌻𐌻𐌿𐍃 • (hallus) m
𐍅𐌴𐌹𐌽𐌳𐍂𐌿𐌲𐌺𐌾𐌰	Noun	𐍅𐌴𐌹𐌽𐌳𐍂𐌿𐌲𐌺𐌾𐌰 • (weindrugkja) m
𐌽𐌴𐍈𐌿𐌽𐌳𐌾𐌰	Noun	𐌽𐌴𐍈𐌿𐌽𐌳𐌾𐌰 • (nēƕundja) m
𐍃𐌺𐌹𐌻𐌻𐌹𐌲𐌲𐍃	Noun	𐍃𐌺𐌹𐌻𐌻𐌹𐌲𐌲𐍃 • (skilliggs) m
𐌱𐌰𐌹𐍂𐌲𐌰𐌷𐌴𐌹	Noun	𐌱𐌰𐌹𐍂𐌲𐌰𐌷𐌴𐌹 • (bairgahei) f
𐌰𐍀𐌰𐌿𐍃𐍄𐌿𐌻𐌿𐍃	Noun	𐌰𐍀𐌰𐌿𐍃𐍄𐌿𐌻𐌿𐍃 • (apaustulus) m
𐍅𐌹𐌻𐌾𐌰𐌽	Noun	𐍅𐌹𐌻𐌾𐌰𐌽 • (wiljan)
𐍅𐌰𐌹𐍂𐌳𐌿𐍃	Noun	𐍅𐌰𐌹𐍂𐌳𐌿𐍃 • (wairdus) m
𐌲𐌰𐌼𐌹𐍄𐍉𐌽𐍃	Noun	𐌲𐌰𐌼𐌹𐍄𐍉𐌽𐍃 • (gamitōns) f
𐍅𐌰𐌿𐍂𐍃𐍄𐍅𐌰	Noun	𐍅𐌰𐌿𐍂𐍃𐍄𐍅𐌰 • (waurstwa) m
𐍅𐌰𐌿𐍂𐍃𐍄𐍅𐌰	Noun	𐍅𐌰𐌿𐍂𐍃𐍄𐍅𐌰 • (waurstwa)
𐌰𐌹𐌷𐍄𐍂𐍉𐌽𐍃	Noun	𐌰𐌹𐌷𐍄𐍂𐍉𐌽𐍃 • (aihtrōns) f
𐌻𐌴𐌹𐌸𐌿	Noun	𐌻𐌴𐌹𐌸𐌿 • (leiþu) n
𐍃𐍄𐌰𐌸𐍃	Noun	𐍃𐍄𐌰𐌸𐍃 • (staþs) m
𐌹𐌿𐍃𐌹𐌻𐌰	Noun	𐌹𐌿𐍃𐌹𐌻𐌰 • (iusila) f
𐌳𐌰𐌹𐌻𐌰	Noun	𐌳𐌰𐌹𐌻𐌰 • (daila) f
𐌽𐌰𐍄𐌹	Noun	𐌽𐌰𐍄𐌹 • (nati) n
𐌳𐍉𐌼𐍃	Noun	𐌳𐍉𐌼𐍃 • (dōms) m
𐌰𐍃𐍄𐍃	Noun	𐌰𐍃𐍄𐍃 • (asts) m
𐌳𐌹𐌰𐌺𐌰𐌿𐌽𐌿𐍃	Noun	𐌳𐌹𐌰𐌺𐌰𐌿𐌽𐌿𐍃 • (diakaunus) m
𐌿𐍆𐌷𐌽𐌰𐌹𐍅𐌴𐌹𐌽𐍃	Noun	𐌿𐍆𐌷𐌽𐌰𐌹𐍅𐌴𐌹𐌽𐍃 • (ufhnaiweins) f
𐌱𐍂𐌰𐌺𐌾𐌰	Noun	𐌱𐍂𐌰𐌺𐌾𐌰 • (brakja) f
𐌰𐍆𐌳𐍂𐌿𐌲𐌺𐌾𐌰	Noun	𐌰𐍆𐌳𐍂𐌿𐌲𐌺𐌾𐌰 • (afdrugkja) m
𐌱𐌰𐌽𐌾𐌰	Noun	𐌱𐌰𐌽𐌾𐌰 • (banja) f
𐍆𐍂𐌰𐌹𐍃𐍄𐌿𐌱𐌽𐌹	Noun	𐍆𐍂𐌰𐌹𐍃𐍄𐌿𐌱𐌽𐌹 • (fraistubni) f
𐌾𐌹𐌿𐌺𐌰	Noun	𐌾𐌹𐌿𐌺𐌰 • (jiuka) f
𐌰𐍂𐌺𐌰	Noun	𐌰𐍂𐌺𐌰 • (arka) f
𐌰𐌾𐌿𐌺𐌳𐌿𐌸𐍃	Noun	𐌰𐌾𐌿𐌺𐌳𐌿𐌸𐍃 • (ajukdūþs) f
𐌱𐌰𐌽𐍃𐍄𐍃	Noun	𐌱𐌰𐌽𐍃𐍄𐍃 • (bansts) m
𐌻𐌰𐌹𐌱𐌰	Noun	𐌻𐌰𐌹𐌱𐌰 • (laiba) f
𐌵𐌴𐌽𐍃	Noun	𐌵𐌴𐌽𐍃 • (qēns) f
𐌰𐌹𐍅𐌹𐍃𐌺𐌹	Noun	𐌰𐌹𐍅𐌹𐍃𐌺𐌹 • (aiwiski) n
𐌰𐌹𐍂𐌶𐌹𐌸𐌰	Noun	𐌰𐌹𐍂𐌶𐌹𐌸𐌰 • (airziþa) f
𐌰𐌺𐍂𐍃	Noun	𐌰𐌺𐍂𐍃 • (akrs) m
𐍅𐌰𐌷𐍃𐍄𐌿𐍃	Noun	𐍅𐌰𐌷𐍃𐍄𐌿𐍃 • (wahstus) m
𐍃𐌰𐌿𐌸𐌰	Noun	𐍃𐌰𐌿𐌸𐌰 • (sauþa) f
𐌷𐌰𐌿𐍂𐌹	Noun	𐌷𐌰𐌿𐍂𐌹 • (hauri) n
𐌼𐍉𐍄𐌰𐍂𐌴𐌹𐍃	Noun	𐌼𐍉𐍄𐌰𐍂𐌴𐌹𐍃 • (mōtāreis) m
𐌱𐌻𐌴𐌹𐌸𐌴𐌹	Noun	𐌱𐌻𐌴𐌹𐌸𐌴𐌹 • (bleiþei) f
𐌰𐌹𐌽𐍆𐌰𐌻𐌸𐌴𐌹	Noun	𐌰𐌹𐌽𐍆𐌰𐌻𐌸𐌴𐌹 • (ainfalþei) f
𐍆𐌰𐌹𐌷𐌿	Noun	𐍆𐌰𐌹𐌷𐌿 • (faihu) n
𐌹𐌿𐌳𐌰𐌹𐌰𐌻𐌰𐌽𐌳	Noun	𐌹𐌿𐌳𐌰𐌹𐌰𐌻𐌰𐌽𐌳 • (Iudaialand) n
𐍃𐌰𐌱𐌰𐌽	Noun	𐍃𐌰𐌱𐌰𐌽 • (saban) n
𐌻𐌰𐌸𐍉𐌽	Noun	𐌻𐌰𐌸𐍉𐌽 • (laþōn)
𐌰𐌲𐌹𐍃	Noun	𐌰𐌲𐌹𐍃 • (agis) n
𐌲𐌰𐍆𐍂𐌹𐌸𐍉𐌽𐍃	Noun	𐌲𐌰𐍆𐍂𐌹𐌸𐍉𐌽𐍃 • (gafriþōns) f
𐍅𐌹𐌽𐌽𐌰	Noun	𐍅𐌹𐌽𐌽𐌰 • (winna) f
𐌲𐌰𐌻𐌹𐌿𐌲	Noun	𐌲𐌰𐌻𐌹𐌿𐌲 • (galiug) n
𐌸𐍅𐌰𐍃𐍄𐌹𐌸𐌰	Noun	𐌸𐍅𐌰𐍃𐍄𐌹𐌸𐌰 • (þwastiþa) f
𐌲𐌰𐍃𐍄𐍃	Noun	𐌲𐌰𐍃𐍄𐍃 • (gasts) m
𐌿𐍆𐌰𐍂𐍂𐌰𐌽𐌽𐌴𐌹𐌽𐍃	Noun	𐌿𐍆𐌰𐍂𐍂𐌰𐌽𐌽𐌴𐌹𐌽𐍃 • (ufarranneins) f
𐌳𐌰𐌿𐌷𐍄𐌰𐍂	Noun	𐌳𐌰𐌿𐌷𐍄𐌰𐍂 • (dauhtar) f
𐌰𐍂𐌼𐌰𐌷𐌰𐌹𐍂𐍄𐌹𐌸𐌰	Noun	𐌰𐍂𐌼𐌰𐌷𐌰𐌹𐍂𐍄𐌹𐌸𐌰 • (armahairtiþa) f
𐌳𐌰𐌿𐌸𐌴𐌹𐌽𐍃	Noun	𐌳𐌰𐌿𐌸𐌴𐌹𐌽𐍃 • (dauþeins) f
𐌸𐌰𐌿𐍂𐍃𐍄𐌴𐌹	Noun	𐌸𐌰𐌿𐍂𐍃𐍄𐌴𐌹 • (þaurstei) f
𐌿𐌻𐌱𐌰𐌽𐌳𐌿𐍃	Noun	𐌿𐌻𐌱𐌰𐌽𐌳𐌿𐍃 • (ulbandus) m
𐍄𐍂𐌹𐌿	Noun	𐍄𐍂𐌹𐌿 • (triu) n
𐍈𐍉𐍆𐍄𐌿𐌻𐌹	Noun	𐍈𐍉𐍆𐍄𐌿𐌻𐌹 • (ƕōftuli) f
𐌻𐌰𐌿𐌳𐌹	Noun	𐌻𐌰𐌿𐌳𐌹 • (laudi) f
𐍂𐌰𐌲𐌹𐌽𐌴𐌹𐍃	Noun	𐍂𐌰𐌲𐌹𐌽𐌴𐌹𐍃 • (ragineis) m
𐌲𐌰𐌻𐌹𐌿𐌲𐌰𐍇𐍂𐌹𐍃𐍄𐌿𐍃	Noun	𐌲𐌰𐌻𐌹𐌿𐌲𐌰𐍇𐍂𐌹𐍃𐍄𐌿𐍃 • (galiugaxristus) m
𐌰𐍂𐍈𐌰𐌶𐌽𐌰	Noun	𐌰𐍂𐍈𐌰𐌶𐌽𐌰 • (arƕazna) f
𐌼𐌰𐍄𐌹𐌱𐌰𐌻𐌲𐍃	Noun	𐌼𐌰𐍄𐌹𐌱𐌰𐌻𐌲𐍃 • (matibalgs) m
𐌼𐌰𐍂𐌹𐍃𐌰𐌹𐍅𐍃	Noun	𐌼𐌰𐍂𐌹𐍃𐌰𐌹𐍅𐍃 • (marisaiws) m
𐍃𐌺𐌰𐌿𐍂𐍀𐌾𐍉	Noun	𐍃𐌺𐌰𐌿𐍂𐍀𐌾𐍉 • (skaurpjō) f
𐌸𐌿𐍃𐌿𐌽𐌳𐌹	Noun	𐌸𐌿𐍃𐌿𐌽𐌳𐌹 • (þūsundi) f
𐍅𐌿𐌻𐍆𐍃	Noun	𐍅𐌿𐌻𐍆𐍃 • (wulfs) m
𐌲𐌰𐌱𐌻𐌴𐌹𐌸𐌴𐌹𐌽𐍃	Noun	𐌲𐌰𐌱𐌻𐌴𐌹𐌸𐌴𐌹𐌽𐍃 • (gableiþeins) f
𐍅𐌰𐌹𐍂	Noun	𐍅𐌰𐌹𐍂 • (wair) m
𐌼𐌰𐌽𐌰𐍃𐌴𐌳𐍃	Noun	𐌼𐌰𐌽𐌰𐍃𐌴𐌳𐍃 • (manasēds) f
𐌰𐌻𐌰𐌱𐍂𐌿𐌽𐍃𐍄𐍃	Noun	𐌰𐌻𐌰𐌱𐍂𐌿𐌽𐍃𐍄𐍃 • (alabrunsts) f
𐍀𐍂𐌰𐌿𐍆𐌴𐍄𐌴𐍃	Noun	𐍀𐍂𐌰𐌿𐍆𐌴𐍄𐌴𐍃 • (praufētēs) m
𐌷𐌰𐌻𐌾𐌰	Noun	𐌷𐌰𐌻𐌾𐌰 • (halja) f
𐌺𐌰𐌹𐍃𐌰𐍂𐌰𐌲𐌹𐌻𐌳	Noun	𐌺𐌰𐌹𐍃𐌰𐍂𐌰𐌲𐌹𐌻𐌳 • (kaisaragild) n
𐌲𐌰𐌱𐍂𐌿𐌺𐌰	Noun	𐌲𐌰𐌱𐍂𐌿𐌺𐌰 • (gabruka) f
𐌰𐍆𐌰𐍂𐌳𐌰𐌲𐍃	Noun	𐌰𐍆𐌰𐍂𐌳𐌰𐌲𐍃 • (afardags) m
𐍄𐌰𐌲𐍂	Noun	𐍄𐌰𐌲𐍂 • (tagr) n
𐌰𐌲𐌻𐌰𐌹𐍄𐌹𐍅𐌰𐌿𐍂𐌳𐌴𐌹	Noun	𐌰𐌲𐌻𐌰𐌹𐍄𐌹𐍅𐌰𐌿𐍂𐌳𐌴𐌹 • (aglaitiwaurdei) f
𐌲𐍉𐌻𐌴𐌹𐌽𐍃	Noun	𐌲𐍉𐌻𐌴𐌹𐌽𐍃 • (gōleins) f
𐍃𐍅𐌹𐌺𐌽𐌴𐌹𐌽𐍃	Noun	𐍃𐍅𐌹𐌺𐌽𐌴𐌹𐌽𐍃 • (swikneins) f
𐍅𐌿𐌻𐌻𐌰𐍂𐌴𐌹𐍃	Noun	𐍅𐌿𐌻𐌻𐌰𐍂𐌴𐌹𐍃 • (wullāreis) m
𐌰𐌽𐌰𐌻𐌰𐌿𐌲𐌽𐌴𐌹	Noun	𐌰𐌽𐌰𐌻𐌰𐌿𐌲𐌽𐌴𐌹 • (analaugnei) f
𐌰𐌻𐌴𐌹𐌽𐌰	Noun	𐌰𐌻𐌴𐌹𐌽𐌰 • (aleina) f
𐌱𐌰𐍂𐌼𐍃	Noun	𐌱𐌰𐍂𐌼𐍃 • (barms) m
𐌲𐍂𐌰𐍃	Noun	𐌲𐍂𐌰𐍃 • (gras) n
𐍅𐌻𐌹𐍄𐍃	Noun	𐍅𐌻𐌹𐍄𐍃 • (wlits) m
𐍅𐌿𐌽𐌳𐌿𐍆𐌽𐌹	Noun	𐍅𐌿𐌽𐌳𐌿𐍆𐌽𐌹 • (wundufni) f
𐌰𐍆𐍄𐍂𐌰𐌰𐌽𐌰𐍃𐍄𐍉𐌳𐌴𐌹𐌽𐍃	Noun	𐌰𐍆𐍄𐍂𐌰𐌰𐌽𐌰𐍃𐍄𐍉𐌳𐌴𐌹𐌽𐍃 • (aftraanastōdeins) f
𐍃𐌴𐌹𐌸𐌿	Noun	𐍃𐌴𐌹𐌸𐌿 • (seiþu) n
𐌼𐌴𐌻𐌰	Noun	𐌼𐌴𐌻𐌰 • (mēla) f
𐌼𐌴𐌻𐌰	Noun	𐌼𐌴𐌻𐌰 • (mēla)
-𐌹𐌳𐌰	Noun	-𐌹𐌳𐌰 • (-ida)
𐌱𐌰𐍂𐌽	Noun	𐌱𐌰𐍂𐌽 • (barn) n
𐌰𐍂𐌱𐌹𐌽𐌿𐌼𐌾𐌰	Noun	𐌰𐍂𐌱𐌹𐌽𐌿𐌼𐌾𐌰 • (arbinumja) m
𐌻𐌴𐌺𐌹𐌽𐌰𐍃𐍃𐌿𐍃	Noun	𐌻𐌴𐌺𐌹𐌽𐌰𐍃𐍃𐌿𐍃 • (lēkinassus) m
𐌻𐌿𐌱𐌾𐌰𐌻𐌴𐌹𐍃𐌴𐌹	Noun	𐌻𐌿𐌱𐌾𐌰𐌻𐌴𐌹𐍃𐌴𐌹 • (lubjaleisei) f
𐍅𐌹𐍃	Noun	𐍅𐌹𐍃 • (wis) n
𐌰𐌲𐌻𐌰𐌹𐍄𐌹	Noun	𐌰𐌲𐌻𐌰𐌹𐍄𐌹 • (aglaiti) n
𐍆𐌰𐌷𐌴𐌸𐍃	Noun	𐍆𐌰𐌷𐌴𐌸𐍃 • (fahēþs) f
𐍃𐌰𐌿𐌹𐌻	Noun	𐍃𐌰𐌿𐌹𐌻 • (sauil) n
𐌰𐌺𐌴𐌹𐍄	Noun	𐌰𐌺𐌴𐌹𐍄 • (akeit) n
𐍆𐌰𐌹𐌷𐌿𐍆𐍂𐌹𐌺𐌴𐌹	Noun	𐍆𐌰𐌹𐌷𐌿𐍆𐍂𐌹𐌺𐌴𐌹 • (faihufrikei) f
𐌻𐌿𐌺𐌰𐍂𐌽	Noun	𐌻𐌿𐌺𐌰𐍂𐌽 • (lukarn) n
𐌳𐌰𐌿𐍂𐍉𐌽𐍃	Noun	𐌳𐌰𐌿𐍂𐍉𐌽𐍃 • (daurōns) f pl
𐍆𐌰𐌷𐌴𐌳𐍃	Noun	𐍆𐌰𐌷𐌴𐌳𐍃 • (fahēds) f
𐍃𐌺𐌴𐌹𐌼𐌰	Noun	𐍃𐌺𐌴𐌹𐌼𐌰 • (skeima) m
𐌷𐌰𐌽𐌰	Noun	𐌷𐌰𐌽𐌰 • (hana) m
𐌰𐍆𐌻𐌴𐍄	Noun	𐌰𐍆𐌻𐌴𐍄 • (aflēt) n
𐍅𐌰𐌹𐌷𐍄	Noun	𐍅𐌰𐌹𐌷𐍄 • (waiht) n
𐍅𐌰𐌹𐌷𐍄	Noun	𐍅𐌰𐌹𐌷𐍄 • (waiht)
𐌷𐌰𐌹𐌸𐌹	Noun	𐌷𐌰𐌹𐌸𐌹 • (haiþi) f
𐌰𐌲𐌲𐌹𐌻𐌿𐍃	Noun	𐌰𐌲𐌲𐌹𐌻𐌿𐍃 • (aggilus) m
𐍆𐌰𐌿𐌷𐍉	Noun	𐍆𐌰𐌿𐌷𐍉 • (fauhō) f
𐌳𐍂𐌰𐌲𐌺	Noun	𐌳𐍂𐌰𐌲𐌺 • (dragk) n
𐌻𐌿𐍃𐍄𐌿𐍃	Noun	𐌻𐌿𐍃𐍄𐌿𐍃 • (lustus) m
𐍆𐍉𐌽	Noun	𐍆𐍉𐌽 • (fōn) n
𐌼𐌴𐍂𐌾𐌰𐌽𐌳𐍃	Noun	𐌼𐌴𐍂𐌾𐌰𐌽𐌳𐍃 • (mērjands) m
𐌷𐌰𐍅𐌹	Noun	𐌷𐌰𐍅𐌹 • (hawi) n
𐍃𐌺𐌴𐍂𐌴𐌹𐌽𐍃	Noun	𐍃𐌺𐌴𐍂𐌴𐌹𐌽𐍃 • (skēreins) f
𐌷𐌿𐌻𐌹𐍃𐍄𐍂	Noun	𐌷𐌿𐌻𐌹𐍃𐍄𐍂 • (hulistr) n
𐌺𐌰𐌿𐍂𐌹𐌸𐌰	Noun	𐌺𐌰𐌿𐍂𐌹𐌸𐌰 • (kauriþa) f
𐌲𐌰𐍆𐍂𐌹𐌾𐍉𐌽𐍃	Noun	𐌲𐌰𐍆𐍂𐌹𐌾𐍉𐌽𐍃 • (gafrijōns) f
𐍃𐍅𐌹𐌲𐌽𐌹𐌸𐌰	Noun	𐍃𐍅𐌹𐌲𐌽𐌹𐌸𐌰 • (swigniþa) f
𐌱𐌹𐍃𐌹𐍄𐌰𐌽𐌳𐍃	Noun	𐌱𐌹𐍃𐌹𐍄𐌰𐌽𐌳𐍃 • (bisitands) m
𐌿𐍃𐍆𐌿𐌻𐌻𐌴𐌹𐌽𐍃	Noun	𐌿𐍃𐍆𐌿𐌻𐌻𐌴𐌹𐌽𐍃 • (usfulleins) f
𐍆𐍂𐌰𐌲𐌹𐍆𐍄𐍃	Noun	𐍆𐍂𐌰𐌲𐌹𐍆𐍄𐍃 • (fragifts) f
𐌿𐌽𐌺𐌾𐌰	Noun	𐌿𐌽𐌺𐌾𐌰 • (unkja) m
𐍃𐌹𐌲𐌹𐍃	Noun	𐍃𐌹𐌲𐌹𐍃 • (sigis) n
𐌴𐌹𐍃𐌰𐍂𐌽	Noun	𐌴𐌹𐍃𐌰𐍂𐌽 • (eisarn) n
𐌼𐌰𐌽𐌽𐌹𐍃𐌺𐍉𐌳𐌿𐍃	Noun	𐌼𐌰𐌽𐌽𐌹𐍃𐌺𐍉𐌳𐌿𐍃 • (manniskōdus) m
𐍆𐍂𐍉𐌳𐌴𐌹	Noun	𐍆𐍂𐍉𐌳𐌴𐌹 • (frōdei) f
𐌿𐍃𐍃𐌰𐍄𐌴𐌹𐌽𐍃	Noun	𐌿𐍃𐍃𐌰𐍄𐌴𐌹𐌽𐍃 • (ussateins) f
𐌷𐌰𐌿𐌷𐌴𐌹𐌽𐍃	Noun	𐌷𐌰𐌿𐌷𐌴𐌹𐌽𐍃 • (hauheins) f
𐌲𐌰𐍂𐌰𐌹𐌷𐍄𐌹𐌸𐌰	Noun	𐌲𐌰𐍂𐌰𐌹𐌷𐍄𐌹𐌸𐌰 • (garaihtiþa) f
𐍂𐌰𐌶𐌳𐌰	Noun	𐍂𐌰𐌶𐌳𐌰 • (razda) f
𐌰𐍆𐌴𐍄𐌾𐌰	Noun	𐌰𐍆𐌴𐍄𐌾𐌰 • (afētja) m
𐍅𐌴𐌹𐌷𐌹𐌸𐌰	Noun	𐍅𐌴𐌹𐌷𐌹𐌸𐌰 • (weihiþa) f
𐌲𐌰𐌱𐌰𐌹𐍂𐌷𐍄𐌴𐌹𐌽𐍃	Noun	𐌲𐌰𐌱𐌰𐌹𐍂𐌷𐍄𐌴𐌹𐌽𐍃 • (gabairhteins) f
𐌲𐌰𐌳𐍂𐌰𐌿𐌷𐍄𐍃	Noun	𐌲𐌰𐌳𐍂𐌰𐌿𐌷𐍄𐍃 • (gadrauhts) m
𐍃𐌹𐌻𐌿𐌱𐍂	Noun	𐍃𐌹𐌻𐌿𐌱𐍂 • (silubr) n
𐌰𐌲𐌻𐌰𐌹𐍄𐌴𐌹	Noun	𐌰𐌲𐌻𐌰𐌹𐍄𐌴𐌹 • (aglaitei) f
𐌺𐌰𐌿𐍂𐌽	Noun	𐌺𐌰𐌿𐍂𐌽 • (kaurn) n
𐌷𐌿𐌷𐍂𐌿𐍃	Noun	𐌷𐌿𐌷𐍂𐌿𐍃 • (huhrus) m
𐌷𐌰𐌹𐍂𐍄𐍉	Noun	𐌷𐌰𐌹𐍂𐍄𐍉 • (hairtō) n
𐌰𐌲𐌲𐌴𐌻𐌿𐍃	Noun	𐌰𐌲𐌲𐌴𐌻𐌿𐍃 • (aggēlus) m
𐌾𐌴𐍂	Noun	𐌾𐌴𐍂 • (jēr) n
𐍄𐌹𐌼𐍂𐌾𐌰	Noun	𐍄𐌹𐌼𐍂𐌾𐌰 • (timrja) m
𐌻𐌹𐌿𐌸𐍃	Noun	𐌻𐌹𐌿𐌸𐍃 • (liuþs) m
𐌷𐌰𐌹𐍃	Noun	𐌷𐌰𐌹𐍃 • (hais) n
𐍅𐌰𐍂𐌲𐌹𐌸𐌰	Noun	𐍅𐌰𐍂𐌲𐌹𐌸𐌰 • (wargiþa) f
𐌿𐍃𐍄𐌰𐌹𐌺𐌽𐌴𐌹𐌽𐍃	Noun	𐌿𐍃𐍄𐌰𐌹𐌺𐌽𐌴𐌹𐌽𐍃 • (ustaikneins) f
𐌰𐌱𐌰	Noun	𐌰𐌱𐌰 • (aba) m
𐌱𐌰𐍂𐌽𐌹𐌻𐍉	Noun	𐌱𐌰𐍂𐌽𐌹𐌻𐍉 • (barnilō) n
𐍃𐌺𐌴𐌹𐍂𐌴𐌹𐌽𐍃	Noun	𐍃𐌺𐌴𐌹𐍂𐌴𐌹𐌽𐍃 • (skeireins) f
𐌲𐌿𐌻𐌸	Noun	𐌲𐌿𐌻𐌸 • (gulþ) n
𐌺𐌹𐌽𐌳𐌹𐌽𐍃	Noun	𐌺𐌹𐌽𐌳𐌹𐌽𐍃 • (kindins) m
𐍅𐍂𐌰𐌺𐌰	Noun	𐍅𐍂𐌰𐌺𐌰 • (wraka) f
𐍆𐍂𐌿𐌼𐌰𐌱𐌰𐌿𐍂	Noun	𐍆𐍂𐌿𐌼𐌰𐌱𐌰𐌿𐍂 • (frumabaur) m
𐍄𐌰𐌹𐌽𐍃	Noun	𐍄𐌰𐌹𐌽𐍃 • (tains) m
𐌷𐌰𐌹𐍂𐌿𐍃	Noun	𐌷𐌰𐌹𐍂𐌿𐍃 • (hairus) m
𐌰𐌻𐌴𐍅𐌰𐌱𐌰𐌲𐌼𐍃	Noun	𐌰𐌻𐌴𐍅𐌰𐌱𐌰𐌲𐌼𐍃 • (alēwabagms) m
𐌳𐌹𐌿𐍃	Noun	𐌳𐌹𐌿𐍃 • (dius) n
𐍃𐍄𐍉𐌼𐌰	Noun	𐍃𐍄𐍉𐌼𐌰 • (stōma) m
𐍅𐌹𐌳𐌿𐍅𐍉	Noun	𐍅𐌹𐌳𐌿𐍅𐍉 • (widuwō) f
𐌳𐌰𐌿𐌽𐍃	Noun	𐌳𐌰𐌿𐌽𐍃 • (dauns) f
𐌰𐌽𐌳𐌴𐌹𐍃	Noun	𐌰𐌽𐌳𐌴𐌹𐍃 • (andeis) m
𐍃𐍉𐌺𐌰𐍂𐌴𐌹𐍃	Noun	𐍃𐍉𐌺𐌰𐍂𐌴𐌹𐍃 • (sōkāreis) m
𐌹𐌽𐌼𐌰𐌹𐌳𐌴𐌹𐌽𐍃	Noun	𐌹𐌽𐌼𐌰𐌹𐌳𐌴𐌹𐌽𐍃 • (inmaideins) f
𐌰𐍆𐌲𐍂𐌿𐌽𐌳𐌹𐌸𐌰	Noun	𐌰𐍆𐌲𐍂𐌿𐌽𐌳𐌹𐌸𐌰 • (afgrundiþa) f
𐌼𐌹𐍄𐍉𐌽𐍃	Noun	𐌼𐌹𐍄𐍉𐌽𐍃 • (mitōns) f
𐌸𐌹𐌿𐍃	Noun	𐌸𐌹𐌿𐍃 • (þius) m
𐍆𐌹𐌻𐌿𐍃𐌽𐌰	Noun	𐍆𐌹𐌻𐌿𐍃𐌽𐌰 • (filusna) f
𐍆𐌻𐍉𐌳𐌿𐍃	Noun	𐍆𐌻𐍉𐌳𐌿𐍃 • (flōdus) m
𐌼𐌰𐌸𐌻	Noun	𐌼𐌰𐌸𐌻 • (maþl) n
𐌲𐌰𐌼𐌰𐌿𐌳𐌴𐌹𐌽𐍃	Noun	𐌲𐌰𐌼𐌰𐌿𐌳𐌴𐌹𐌽𐍃 • (gamaudeins) f
𐍆𐌰𐌽𐌹	Noun	𐍆𐌰𐌽𐌹 • (fani) n
𐌻𐌰𐌲𐌲𐌰𐌼𐍉𐌳𐌴𐌹	Noun	𐌻𐌰𐌲𐌲𐌰𐌼𐍉𐌳𐌴𐌹 • (laggamōdei) f
𐍆𐍉𐍄𐌿𐍃	Noun	𐍆𐍉𐍄𐌿𐍃 • (fōtus) m
𐍂𐌴𐌹𐌺𐌹	Noun	𐍂𐌴𐌹𐌺𐌹 • (reiki) n
𐌻𐌴𐌺𐌴𐌹𐍃	Noun	𐌻𐌴𐌺𐌴𐌹𐍃 • (lēkeis) m
𐌼𐌰𐍂𐌹𐌺𐍂𐌴𐌹𐍄𐌿𐍃	Noun	𐌼𐌰𐍂𐌹𐌺𐍂𐌴𐌹𐍄𐌿𐍃 • (marikreitus) m
𐌷𐍉𐍂𐍃	Noun	𐌷𐍉𐍂𐍃 • (hōrs) m
𐌼𐌹𐌻𐌳𐌹𐌸𐌰	Noun	𐌼𐌹𐌻𐌳𐌹𐌸𐌰 • (mildiþa) f
𐌼𐌿𐌽𐌸𐍃	Noun	𐌼𐌿𐌽𐌸𐍃 • (munþs) m
𐌰𐌽𐌳𐌱𐌰𐌷𐍄𐌹	Noun	𐌰𐌽𐌳𐌱𐌰𐌷𐍄𐌹 • (andbahti) n
𐌳𐍅𐌰𐌻𐌹𐌸𐌰	Noun	𐌳𐍅𐌰𐌻𐌹𐌸𐌰 • (dwaliþa) f
𐌼𐌰𐌽𐌰𐌲𐌴𐌹	Noun	𐌼𐌰𐌽𐌰𐌲𐌴𐌹 • (managei) f
𐍃𐍅𐌹𐌺𐌽𐌴𐌹	Noun	𐍃𐍅𐌹𐌺𐌽𐌴𐌹 • (swiknei) f
𐌺𐌽𐍉𐌸𐍃	Noun	𐌺𐌽𐍉𐌸𐍃 • (knōþs) f
𐌲𐌰𐌱𐌰𐌿𐍂𐌾𐍉𐌸𐌿𐍃	Noun	𐌲𐌰𐌱𐌰𐌿𐍂𐌾𐍉𐌸𐌿𐍃 • (gabaurjōþus) m
𐌸𐌿𐍄𐌷𐌰𐌿𐍂𐌽	Noun	𐌸𐌿𐍄𐌷𐌰𐌿𐍂𐌽 • (þuthaurn) n
𐌰𐌽𐌰𐌼𐌰𐌷𐍄𐍃	Noun	𐌰𐌽𐌰𐌼𐌰𐌷𐍄𐍃 • (anamahts) f
𐌻𐌰𐌼𐌱	Noun	𐌻𐌰𐌼𐌱 • (lamb) n
𐍃𐍅𐌽𐌰𐌲𐍉𐌲𐌰𐍆𐌰𐌸𐍃	Noun	𐍃𐍅𐌽𐌰𐌲𐍉𐌲𐌰𐍆𐌰𐌸𐍃 • (swnagōgafaþs) m
𐌹𐌽𐍅𐌹𐌽𐌳𐌹𐌸𐌰	Noun	𐌹𐌽𐍅𐌹𐌽𐌳𐌹𐌸𐌰 • (inwindiþa) f
𐍆𐌰𐌹𐌷𐌿𐌲𐌴𐌹𐍂𐍉	Noun	𐍆𐌰𐌹𐌷𐌿𐌲𐌴𐌹𐍂𐍉 • (faihugeirō) f
𐌰𐌹𐍀𐌹𐍃𐌺𐌰𐌿𐍀𐌿𐍃	Noun	𐌰𐌹𐍀𐌹𐍃𐌺𐌰𐌿𐍀𐌿𐍃 • (aipiskaupus) m
𐌳𐌹𐌿𐍀𐌹𐌸𐌰	Noun	𐌳𐌹𐌿𐍀𐌹𐌸𐌰 • (diupiþa) f
𐍃𐌺𐌰𐍄𐍄𐌾𐌰	Noun	𐍃𐌺𐌰𐍄𐍄𐌾𐌰 • (skattja) m
𐌲𐌰𐌿𐍂𐌹𐌸𐌰	Noun	𐌲𐌰𐌿𐍂𐌹𐌸𐌰 • (gauriþa) f
𐌰𐌷𐌼𐌰𐍄𐌴𐌹𐌽𐍃	Noun	𐌰𐌷𐌼𐌰𐍄𐌴𐌹𐌽𐍃 • (ahmateins) f
𐌾𐌿𐌽𐌳𐌰	Noun	𐌾𐌿𐌽𐌳𐌰 • (junda) f
𐍅𐌹𐌽𐌽𐍉	Noun	𐍅𐌹𐌽𐌽𐍉 • (winnō) f
𐌲𐌰𐌹𐌰𐌹𐌽𐌽𐌰	Noun	𐌲𐌰𐌹𐌰𐌹𐌽𐌽𐌰 • (gaiainna) m
𐌰𐌽𐌰𐌼𐌹𐌽𐌳𐍃	Noun	𐌰𐌽𐌰𐌼𐌹𐌽𐌳𐍃 • (anaminds) f
𐌿𐍃𐌱𐌻𐍉𐍄𐌴𐌹𐌽𐍃	Noun	𐌿𐍃𐌱𐌻𐍉𐍄𐌴𐌹𐌽𐍃 • (usblōteins) f
𐌰𐍂𐌼𐌰𐌹𐍉	Noun	𐌰𐍂𐌼𐌰𐌹𐍉 • (armaiō) f
𐌷𐌰𐌻𐌱𐌰	Noun	𐌷𐌰𐌻𐌱𐌰 • (halba) f
𐌰𐍅𐍉	Noun	𐌰𐍅𐍉 • (awō) f
𐍆𐌰𐌳𐍂𐌴𐌹𐌽	Noun	𐍆𐌰𐌳𐍂𐌴𐌹𐌽 • (fadrein) n
𐌱𐌰𐌻𐍃𐌰𐌽	Noun	𐌱𐌰𐌻𐍃𐌰𐌽 • (balsan) n
𐌷𐌰𐌿𐍂𐌽	Noun	𐌷𐌰𐌿𐍂𐌽 • (haurn) n
𐍀𐌰𐌹𐌳𐌰	Noun	𐍀𐌰𐌹𐌳𐌰 • (paida) f
𐌻𐌴𐌹𐌽	Noun	𐌻𐌴𐌹𐌽 • (lein) n
𐌲𐌰𐌱𐌹𐌽𐌳𐌹	Noun	𐌲𐌰𐌱𐌹𐌽𐌳𐌹 • (gabindi) f
𐌺𐌹𐌽𐍄𐌿𐍃	Noun	𐌺𐌹𐌽𐍄𐌿𐍃 • (kintus) m
𐌳𐌿𐌻𐌲𐌰𐌷𐌰𐌹𐍄𐌾𐌰	Noun	𐌳𐌿𐌻𐌲𐌰𐌷𐌰𐌹𐍄𐌾𐌰 • (dulgahaitja) m
𐍅𐌰𐌾𐌰𐌼𐌴𐍂𐌴𐌹𐌽𐍃	Noun	𐍅𐌰𐌾𐌰𐌼𐌴𐍂𐌴𐌹𐌽𐍃 • (wajamēreins) f
𐍀𐌻𐌰𐍀𐌾𐌰	Noun	𐍀𐌻𐌰𐍀𐌾𐌰 • (plapja) f
𐍃𐌻𐌴𐌹𐌸𐌰	Noun	𐍃𐌻𐌴𐌹𐌸𐌰 • (sleiþa) f
𐌷𐌰𐌹𐍂𐌳𐌴𐌹𐍃	Noun	𐌷𐌰𐌹𐍂𐌳𐌴𐌹𐍃 • (hairdeis) m
𐌰𐌵𐌹𐌶𐌹	Noun	𐌰𐌵𐌹𐌶𐌹 • (aqizi) n
𐌳𐌹𐌰𐌱𐌰𐌿𐌻𐌿𐍃	Noun	𐌳𐌹𐌰𐌱𐌰𐌿𐌻𐌿𐍃 • (diabaulus) m
𐍃𐍄𐌹𐌺𐌻𐍃	Noun	𐍃𐍄𐌹𐌺𐌻𐍃 • (stikls) m
𐌼𐌰𐍂𐌺𐌰	Noun	𐌼𐌰𐍂𐌺𐌰 • (marka) f
𐌻𐌹𐍃𐍄𐍃	Noun	𐌻𐌹𐍃𐍄𐍃 • (lists) f
𐍅𐌴𐍀𐌽	Noun	𐍅𐌴𐍀𐌽 • (wēpn) n
𐍀𐌰𐍂𐌰𐍃𐌺𐌰𐌹𐍅𐌴	Noun	𐍀𐌰𐍂𐌰𐍃𐌺𐌰𐌹𐍅𐌴 • (paraskaiwē)
𐌳𐌰𐌻	Noun	𐌳𐌰𐌻 • (dal) n
𐌱𐍉𐍄𐌰	Noun	𐌱𐍉𐍄𐌰 • (bōta) f
𐌱𐌰𐌹𐍂𐌰𐌱𐌰𐌲𐌼𐍃	Noun	𐌱𐌰𐌹𐍂𐌰𐌱𐌰𐌲𐌼𐍃 • (bairabagms) m
𐍅𐌰𐍃𐍄𐌹	Noun	𐍅𐌰𐍃𐍄𐌹 • (wasti) f
𐍃𐌰𐌿𐍂	Noun	𐍃𐌰𐌿𐍂 • (Saur) m
𐌷𐌰𐌹𐍂𐌳𐌰	Noun	𐌷𐌰𐌹𐍂𐌳𐌰 • (hairda) f
𐌰𐍆𐌻𐌰𐌲𐌴𐌹𐌽𐍃	Noun	𐌰𐍆𐌻𐌰𐌲𐌴𐌹𐌽𐍃 • (aflageins) f
𐌷𐍉𐍂𐌹𐌽𐌰𐍃𐍃𐌿𐍃	Noun	𐌷𐍉𐍂𐌹𐌽𐌰𐍃𐍃𐌿𐍃 • (hōrinassus) m
𐌷𐌿𐌽𐌳𐍃	Noun	𐌷𐌿𐌽𐌳𐍃 • (hunds) m
𐌲𐌰𐌻𐌹𐌿𐌲𐌰𐍀𐍂𐌰𐌿𐍆𐌴𐍄𐌿𐍃	Noun	𐌲𐌰𐌻𐌹𐌿𐌲𐌰𐍀𐍂𐌰𐌿𐍆𐌴𐍄𐌿𐍃 • (galiugapraufētus) m
𐌳𐌰𐌹𐌻𐍃	Noun	𐌳𐌰𐌹𐌻𐍃 • (dails) f
𐍃𐌿𐌽𐌽𐍉	Noun	𐍃𐌿𐌽𐌽𐍉 • (sunnō) f
𐌽𐌴𐌸𐌻𐌰	Noun	𐌽𐌴𐌸𐌻𐌰 • (nēþla) f
𐌳𐌿𐌻𐌲	Noun	𐌳𐌿𐌻𐌲 • (dulg) n
𐌲𐌰𐍅𐌰𐌽𐌳𐌴𐌹𐌽𐍃	Noun	𐌲𐌰𐍅𐌰𐌽𐌳𐌴𐌹𐌽𐍃 • (gawandeins) f
𐌿𐍃𐌻𐌿𐌽𐌴𐌹𐌽𐍃	Noun	𐌿𐍃𐌻𐌿𐌽𐌴𐌹𐌽𐍃 • (usluneins) f
𐍆𐌰𐌿𐍂𐌰𐍄𐌰𐌽𐌹	Noun	𐍆𐌰𐌿𐍂𐌰𐍄𐌰𐌽𐌹 • (fauratani) n
𐍃𐍅𐌽𐌰𐌲𐍉𐌲𐌴	Noun	𐍃𐍅𐌽𐌰𐌲𐍉𐌲𐌴 • (swnagōgē) f
𐌿𐍆𐍃𐍅𐌰𐌻𐌻𐌴𐌹𐌽𐍃	Noun	𐌿𐍆𐍃𐍅𐌰𐌻𐌻𐌴𐌹𐌽𐍃 • (ufswalleins) f
𐌰𐍆𐌲𐌿𐌳𐌴𐌹	Noun	𐌰𐍆𐌲𐌿𐌳𐌴𐌹 • (afgudei) f
𐌰𐌽𐌰𐌺𐌿𐌽𐌽𐌰𐌹𐌽𐍃	Noun	𐌰𐌽𐌰𐌺𐌿𐌽𐌽𐌰𐌹𐌽𐍃 • (anakunnains) f
𐌼𐌴𐌲𐍃	Noun	𐌼𐌴𐌲𐍃 • (mēgs) m
𐍅𐍂𐌰𐍄𐍉𐌳𐌿𐍃	Noun	𐍅𐍂𐌰𐍄𐍉𐌳𐌿𐍃 • (wratōdus) m
𐌿𐌽𐍃𐌴𐌻𐌴𐌹	Noun	𐌿𐌽𐍃𐌴𐌻𐌴𐌹 • (unsēlei) f
𐍃𐌻𐌰𐌷𐌰𐌻𐍃	Noun	𐍃𐌻𐌰𐌷𐌰𐌻𐍃 • (slahals) m
𐍃𐌹𐌿𐌽𐍃	Noun	𐍃𐌹𐌿𐌽𐍃 • (siuns) f
𐍃𐌰𐌽𐌳𐌰	Noun	𐍃𐌰𐌽𐌳𐌰 • (sanda) f
𐌱𐍂𐌰𐌹𐌳𐌴𐌹	Noun	𐌱𐍂𐌰𐌹𐌳𐌴𐌹 • (braidei) f
𐌺𐌰𐌻𐌺𐌹𐌽𐌰𐍃𐍃𐌿𐍃	Noun	𐌺𐌰𐌻𐌺𐌹𐌽𐌰𐍃𐍃𐌿𐍃 • (kalkinassus) m
𐌲𐌰𐌿𐌽𐍉𐌸𐌿𐍃	Noun	𐌲𐌰𐌿𐌽𐍉𐌸𐌿𐍃 • (gaunōþus) m
𐍆𐍉𐌳𐌴𐌹𐌽𐍃	Noun	𐍆𐍉𐌳𐌴𐌹𐌽𐍃 • (fōdeins) f
𐍃𐌿𐌽𐌾𐌰	Noun	𐍃𐌿𐌽𐌾𐌰 • (sunja) f
𐌷𐌰𐌽𐍃𐌰	Noun	𐌷𐌰𐌽𐍃𐌰 • (hansa) f
𐍃𐌺𐌹𐍀	Noun	𐍃𐌺𐌹𐍀 • (skip) n
𐌻𐌹𐌿𐍄𐌴𐌹	Noun	𐌻𐌹𐌿𐍄𐌴𐌹 • (liutei) f
𐌲𐌹𐌻𐌳	Noun	𐌲𐌹𐌻𐌳 • (gild) n
𐌳𐍂𐌰𐌺𐌼𐌰	Noun	𐌳𐍂𐌰𐌺𐌼𐌰 • (drakma) m
𐌲𐌰𐍂𐌿𐌽𐍃	Noun	𐌲𐌰𐍂𐌿𐌽𐍃 • (garuns) f
𐌺𐌿𐍃𐍄𐌿𐍃	Noun	𐌺𐌿𐍃𐍄𐌿𐍃 • (kustus) m
𐌰𐌽𐍃	Noun	𐌰𐌽𐍃 • (ans) m
𐍃𐌺𐌰𐌻𐌺𐌹𐌽𐌰𐍃𐍃𐌿𐍃	Noun	𐍃𐌺𐌰𐌻𐌺𐌹𐌽𐌰𐍃𐍃𐌿𐍃 • (skalkinassus) m
𐌲𐍂𐌰𐌱𐌰	Noun	𐌲𐍂𐌰𐌱𐌰 • (graba) f
𐌰𐌽𐍃𐍄𐍃	Noun	𐌰𐌽𐍃𐍄𐍃 • (ansts) f
𐌾𐌿𐌺	Noun	𐌾𐌿𐌺 • (juk) n
𐌰𐌹𐍅𐍃	Noun	𐌰𐌹𐍅𐍃 • (aiws) m
𐌷𐌴𐌹𐍅𐌰𐍆𐍂𐌰𐌿𐌾𐌰	Noun	𐌷𐌴𐌹𐍅𐌰𐍆𐍂𐌰𐌿𐌾𐌰 • (heiwafrauja) m
𐌷𐌿𐌽𐍃𐌻𐌰𐍃𐍄𐌰𐌸𐍃	Noun	𐌷𐌿𐌽𐍃𐌻𐌰𐍃𐍄𐌰𐌸𐍃 • (hunslastaþs) m
𐌳𐌿𐌱𐍉	Noun	𐌳𐌿𐌱𐍉 • (dūbō) f
𐍃𐌴𐌻𐌴𐌹	Noun	𐍃𐌴𐌻𐌴𐌹 • (sēlei) f
𐌻𐌿𐌳𐌾𐌰	Noun	𐌻𐌿𐌳𐌾𐌰 • (ludja) f
𐌱𐌰𐍂𐌱𐌰𐍂𐌿𐍃	Noun	𐌱𐌰𐍂𐌱𐌰𐍂𐌿𐍃 • (barbarus) m
𐍃𐍄𐌹𐌱𐌽𐌰	Noun	𐍃𐍄𐌹𐌱𐌽𐌰 • (stibna) f
𐌸𐍅𐌼𐌹𐌰𐌼𐌰	Noun	𐌸𐍅𐌼𐌹𐌰𐌼𐌰 • (þwmiama) m
𐌿𐍃𐍅𐌰𐌻𐍄𐌴𐌹𐌽𐍃	Noun	𐌿𐍃𐍅𐌰𐌻𐍄𐌴𐌹𐌽𐍃 • (uswalteins) f
𐌿𐍃𐍅𐌰𐌿𐍂𐍀𐌰	Noun	𐌿𐍃𐍅𐌰𐌿𐍂𐍀𐌰 • (uswaurpa) f
𐌻𐌰𐌽𐌳	Noun	𐌻𐌰𐌽𐌳 • (land) n
𐍃𐍄𐌰𐌹𐌽𐍃	Noun	𐍃𐍄𐌰𐌹𐌽𐍃 • (stains) m
𐌱𐌰𐌻𐌲𐍃	Noun	𐌱𐌰𐌻𐌲𐍃 • (balgs) m
𐌳𐌿𐌻𐌲𐍃	Noun	𐌳𐌿𐌻𐌲𐍃 • (dulgs) m
𐌳𐍂𐌰𐌿𐌷𐍄𐌹𐍅𐌹𐍄𐍉𐌸	Noun	𐌳𐍂𐌰𐌿𐌷𐍄𐌹𐍅𐌹𐍄𐍉𐌸 • (drauhtiwitōþ) m
𐌸𐌹𐌿𐌸𐌴𐌹𐌽𐍃	Noun	𐌸𐌹𐌿𐌸𐌴𐌹𐌽𐍃 • (þiuþeins) f
𐌺𐍂𐌴𐌺𐍃	Noun	𐌺𐍂𐌴𐌺𐍃 • (krēks) m
𐍃𐍅𐌴𐌹𐌽	Noun	𐍃𐍅𐌴𐌹𐌽 • (swein) n
𐍆𐍂𐌿𐌼	Noun	𐍆𐍂𐌿𐌼 • (frum) n
𐍅𐌹𐌽𐌾𐌰	Noun	𐍅𐌹𐌽𐌾𐌰 • (winja) f
𐍃𐌺𐌰𐍄𐍄𐍃	Noun	𐍃𐌺𐌰𐍄𐍄𐍃 • (skatts) m
𐌰𐌹𐌽𐌰𐌱𐌰𐌿𐍂	Noun	𐌰𐌹𐌽𐌰𐌱𐌰𐌿𐍂 • (ainabaur) m
𐌰𐌽𐌰𐌻𐌰𐌲𐌴𐌹𐌽𐍃	Noun	𐌰𐌽𐌰𐌻𐌰𐌲𐌴𐌹𐌽𐍃 • (analageins) f
𐍃𐍄𐌰𐌿𐌰𐍃𐍄𐍉𐌻𐍃	Noun	𐍃𐍄𐌰𐌿𐌰𐍃𐍄𐍉𐌻𐍃 • (stauastōls) m
𐌰𐍂𐌰	Noun	𐌰𐍂𐌰 • (ara) m
𐍃𐌼𐌰𐌺𐌺𐌰	Noun	𐍃𐌼𐌰𐌺𐌺𐌰 • (smakka) m
𐌻𐌰𐌹𐍃𐌴𐌹𐌽𐍃	Noun	𐌻𐌰𐌹𐍃𐌴𐌹𐌽𐍃 • (laiseins) f
𐌲𐌰𐍄𐌹𐌼𐍂𐌴𐌹𐌽𐍃	Noun	𐌲𐌰𐍄𐌹𐌼𐍂𐌴𐌹𐌽𐍃 • (gatimreins) f
𐌱𐌰𐌹𐍄𐍂𐌴𐌹	Noun	𐌱𐌰𐌹𐍄𐍂𐌴𐌹 • (baitrei) f
𐍂𐌰𐌿𐍃	Noun	𐍂𐌰𐌿𐍃 • (raus) n
𐌳𐍂𐌰𐌿𐌷𐍃𐌽𐌰	Noun	𐌳𐍂𐌰𐌿𐌷𐍃𐌽𐌰 • (drauhsna) f
𐌿𐍃𐍅𐌰𐌽𐌳𐌹	Noun	𐌿𐍃𐍅𐌰𐌽𐌳𐌹 • (uswandi) f
𐍆𐌰𐌹𐍂𐌶𐌽𐌰	Noun	𐍆𐌰𐌹𐍂𐌶𐌽𐌰 • (fairzna) f
𐌻𐌹𐌿𐌸𐌰𐍂𐌴𐌹𐍃	Noun	𐌻𐌹𐌿𐌸𐌰𐍂𐌴𐌹𐍃 • (liuþāreis) m
𐍅𐌰𐌲𐌲𐌰𐍂𐌴𐌹𐍃	Noun	𐍅𐌰𐌲𐌲𐌰𐍂𐌴𐌹𐍃 • (waggāreis) m
𐍆𐍂𐌰𐌸𐌾𐌰𐌼𐌰𐍂𐌶𐌴𐌹𐌽𐍃	Noun	𐍆𐍂𐌰𐌸𐌾𐌰𐌼𐌰𐍂𐌶𐌴𐌹𐌽𐍃 • (fraþjamarzeins) f
𐌼𐌹𐍄𐌰𐌳𐍃	Noun	𐌼𐌹𐍄𐌰𐌳𐍃 • (mitads) f
𐍆𐌰𐌿𐍂𐌳𐍉𐌼𐌴𐌹𐌽𐍃	Noun	𐍆𐌰𐌿𐍂𐌳𐍉𐌼𐌴𐌹𐌽𐍃 • (faurdōmeins) f
𐌰𐌹𐌷𐍄𐍃	Noun	𐌰𐌹𐌷𐍄𐍃 • (aihts) f
𐌰𐌲𐌻𐌹𐌸𐌰	Noun	𐌰𐌲𐌻𐌹𐌸𐌰 • (agliþa) f
𐌼𐌰𐍄𐍃	Noun	𐌼𐌰𐍄𐍃 • (mats) m
𐌵𐌹𐌸𐌿𐍃	Noun	𐌵𐌹𐌸𐌿𐍃 • (qiþus) m
𐌰𐍀𐌰𐌿𐍃𐍄𐌰𐌿𐌻𐌴𐌹	Noun	𐌰𐍀𐌰𐌿𐍃𐍄𐌰𐌿𐌻𐌴𐌹 • (apaustaulei) f
𐌰𐌽𐌳𐌷𐌿𐌻𐌴𐌹𐌽𐍃	Noun	𐌰𐌽𐌳𐌷𐌿𐌻𐌴𐌹𐌽𐍃 • (andhuleins) f
𐍃𐌺𐌰𐌻𐌾𐌰	Noun	𐍃𐌺𐌰𐌻𐌾𐌰 • (skalja) f
𐌱𐌰𐌿𐍂𐌲𐍃	Noun	𐌱𐌰𐌿𐍂𐌲𐍃 • (baurgs) f
𐌱𐌰𐌿𐍂𐌲𐌾𐌰	Noun	𐌱𐌰𐌿𐍂𐌲𐌾𐌰 • (baurgja) m
𐍆𐍂𐌹𐌾𐍉𐌽𐌳𐌹	Noun	𐍆𐍂𐌹𐌾𐍉𐌽𐌳𐌹 • (frijōndi) f
𐌳𐌰𐌿𐍂𐌰𐍅𐌰𐍂𐌳𐌰	Noun	𐌳𐌰𐌿𐍂𐌰𐍅𐌰𐍂𐌳𐌰 • (daurawarda) f
𐍆𐌰𐌹𐍂𐌽𐌹𐌸𐌰	Noun	𐍆𐌰𐌹𐍂𐌽𐌹𐌸𐌰 • (fairniþa) f
𐌲𐌰𐍃𐌺𐌰𐌳𐍅𐌴𐌹𐌽𐍃	Noun	𐌲𐌰𐍃𐌺𐌰𐌳𐍅𐌴𐌹𐌽𐍃 • (gaskadweins) f
𐌿𐍃𐌸𐍂𐍉𐌸𐌴𐌹𐌽𐍃	Noun	𐌿𐍃𐌸𐍂𐍉𐌸𐌴𐌹𐌽𐍃 • (usþrōþeins) f
𐌰𐌽𐌰𐍃𐍄𐍉𐌳𐌴𐌹𐌽𐍃	Noun	𐌰𐌽𐌰𐍃𐍄𐍉𐌳𐌴𐌹𐌽𐍃 • (anastōdeins) f
𐌰𐌿𐌲𐌰𐌳𐌰𐌿𐍂𐍉	Noun	𐌰𐌿𐌲𐌰𐌳𐌰𐌿𐍂𐍉 • (augadaurō) n
𐍅𐌰𐌹𐌻𐌰𐌼𐌴𐍂𐌴𐌹𐌽𐍃	Noun	𐍅𐌰𐌹𐌻𐌰𐌼𐌴𐍂𐌴𐌹𐌽𐍃 • (wailamēreins) f
𐍆𐌰𐌹𐍂𐌹𐌽𐌰	Noun	𐍆𐌰𐌹𐍂𐌹𐌽𐌰 • (fairina) f
𐍆𐌹𐍃𐌺𐌾𐌰	Noun	𐍆𐌹𐍃𐌺𐌾𐌰 • (fiskja) m
𐌼𐌰𐌽𐌽𐌰	Noun	𐌼𐌰𐌽𐌽𐌰 • (manna) m
𐍆𐍂𐌰𐌿𐌾𐌹𐌽𐌰𐍃𐍃𐌿𐍃	Noun	𐍆𐍂𐌰𐌿𐌾𐌹𐌽𐌰𐍃𐍃𐌿𐍃 • (fraujinassus) m
𐌱𐌰𐌹𐍂𐌷𐍄𐌴𐌹	Noun	𐌱𐌰𐌹𐍂𐌷𐍄𐌴𐌹 • (bairhtei) f
𐌰𐍃𐌰𐌽𐍃	Noun	𐌰𐍃𐌰𐌽𐍃 • (asans) f
𐍄𐌿𐌻𐌲𐌹𐌸𐌰	Noun	𐍄𐌿𐌻𐌲𐌹𐌸𐌰 • (tulgiþa) f
𐌷𐍂𐌰𐌹𐍅𐌰𐌳𐌿𐌱𐍉	Noun	𐌷𐍂𐌰𐌹𐍅𐌰𐌳𐌿𐌱𐍉 • (hraiwadubō) f
𐍅𐌹𐌸𐍂𐌿𐍃	Noun	𐍅𐌹𐌸𐍂𐌿𐍃 • (wiþrus) m
𐌲𐌰𐌿𐍂𐌴𐌹	Noun	𐌲𐌰𐌿𐍂𐌴𐌹 • (gaurei) f
𐍅𐌿𐌽𐌽𐍃	Noun	𐍅𐌿𐌽𐌽𐍃 • (wunns) f
𐌸𐌹𐌿𐌳𐌰	Noun	𐌸𐌹𐌿𐌳𐌰 • (þiuda) f
𐌼𐌹𐍄𐌰𐌸𐍃	Noun	𐌼𐌹𐍄𐌰𐌸𐍃 • (mitaþs) f
𐌳𐍂𐌿𐍃	Noun	𐌳𐍂𐌿𐍃 • (drus) m
𐌹𐌽𐌹𐌻𐍉	Noun	𐌹𐌽𐌹𐌻𐍉 • (inilō) f
𐍅𐌰𐌿𐍂𐍃𐍄𐍅𐌴𐌹	Noun	𐍅𐌰𐌿𐍂𐍃𐍄𐍅𐌴𐌹 • (waurstwei) f
𐍃𐌼𐌰𐌹𐍂𐌸𐍂	Noun	𐍃𐌼𐌰𐌹𐍂𐌸𐍂 • (smairþr) n
𐌿𐍃𐌻𐌰𐌿𐍃𐌴𐌹𐌽𐍃	Noun	𐌿𐍃𐌻𐌰𐌿𐍃𐌴𐌹𐌽𐍃 • (uslauseins) f
𐍃𐌺𐌿𐍆𐍄	Noun	𐍃𐌺𐌿𐍆𐍄 • (skuft) n
𐌵𐌹𐍃𐍄𐌴𐌹𐌽𐍃	Noun	𐌵𐌹𐍃𐍄𐌴𐌹𐌽𐍃 • (qisteins) f
𐌰𐌹𐌲𐌹𐌽	Noun	𐌰𐌹𐌲𐌹𐌽 • (aigin) n
𐌳𐌹𐌿𐍀𐌴𐌹	Noun	𐌳𐌹𐌿𐍀𐌴𐌹 • (diupei) f
𐌼𐌿𐌻𐌳𐌰	Noun	𐌼𐌿𐌻𐌳𐌰 • (mulda) f
𐌺𐌹𐌽𐌽𐌿𐍃	Noun	𐌺𐌹𐌽𐌽𐌿𐍃 • (kinnus) f
𐌸𐌻𐌰𐌿𐌷𐍃	Noun	𐌸𐌻𐌰𐌿𐌷𐍃 • (þlauhs) m
𐌰𐌷𐍃	Noun	𐌰𐌷𐍃 • (ahs) n
𐍆𐌰𐌳𐌰𐍂	Noun	𐍆𐌰𐌳𐌰𐍂 • (fadar) m
𐌺𐌰𐍅𐍄𐍃𐌾𐍉	Noun	𐌺𐌰𐍅𐍄𐍃𐌾𐍉 • (kawtsjō) f
𐍄𐌰𐌹𐍄𐍂𐌰𐍂𐌺𐌴𐍃	Noun	𐍄𐌰𐌹𐍄𐍂𐌰𐍂𐌺𐌴𐍃 • (taitrarkēs) m
𐍃𐌿𐌽𐌾𐍉𐌽	Noun	𐍃𐌿𐌽𐌾𐍉𐌽 • (sunjōn)
𐍀𐌿𐌲𐌲𐍃	Noun	𐍀𐌿𐌲𐌲𐍃 • (puggs) m
𐌿𐌽𐌳𐌹𐍅𐌰𐌽𐌴𐌹	Noun	𐌿𐌽𐌳𐌹𐍅𐌰𐌽𐌴𐌹 • (undiwanei) f
𐌰𐌻𐌷𐍃	Noun	𐌰𐌻𐌷𐍃 • (alhs) f
𐍈𐍉𐍄𐌰	Noun	𐍈𐍉𐍄𐌰 • (ƕōta) f
𐍅𐌰𐌻𐌳𐌿𐍆𐌽𐌹	Noun	𐍅𐌰𐌻𐌳𐌿𐍆𐌽𐌹 • (waldufni) n
𐌱𐍂𐍉𐌸𐌰𐍂	Noun	𐌱𐍂𐍉𐌸𐌰𐍂 • (brōþar) m
𐌰𐌶𐌲𐍉	Noun	𐌰𐌶𐌲𐍉 • (azgō) f
𐍆𐌴𐍂𐌾𐌰	Noun	𐍆𐌴𐍂𐌾𐌰 • (fērja) m
𐌲𐍂𐌿𐌽𐌳𐌿𐍅𐌰𐌳𐌳𐌾𐌿𐍃	Noun	𐌲𐍂𐌿𐌽𐌳𐌿𐍅𐌰𐌳𐌳𐌾𐌿𐍃 • (grunduwaddjus) f
𐍃𐌼𐌰𐌺𐌺𐌰𐌱𐌰𐌲𐌼𐍃	Noun	𐍃𐌼𐌰𐌺𐌺𐌰𐌱𐌰𐌲𐌼𐍃 • (smakkabagms) m
𐌼𐌰𐌷𐍄𐍃	Noun	𐌼𐌰𐌷𐍄𐍃 • (mahts) f
𐍆𐌿𐌻𐌰	Noun	𐍆𐌿𐌻𐌰 • (fula) m
𐌱𐍂𐌿𐌸𐍆𐌰𐌸𐍃	Noun	𐌱𐍂𐌿𐌸𐍆𐌰𐌸𐍃 • (brūþfaþs) m
𐍃𐌹𐌽𐌰𐍀𐌹𐍃	Noun	𐍃𐌹𐌽𐌰𐍀𐌹𐍃 • (sinapis) ?
𐍃𐌰𐌻𐍄	Noun	𐍃𐌰𐌻𐍄 • (salt) n
𐌽𐌰𐌼𐍉	Noun	𐌽𐌰𐌼𐍉 • (namō) n
𐌲𐌰𐌹𐍂𐌳𐌰	Noun	𐌲𐌰𐌹𐍂𐌳𐌰 • (gairda) f
𐌻𐌿𐌺𐌰𐍂𐌽𐌰𐍃𐍄𐌰𐌸𐌰	Noun	𐌻𐌿𐌺𐌰𐍂𐌽𐌰𐍃𐍄𐌰𐌸𐌰 • (lukarnastaþa) m
𐍃𐍅𐌹𐍃𐍄𐌰𐍂	Noun	𐍃𐍅𐌹𐍃𐍄𐌰𐍂 • (swistar) f
𐍆𐌹𐌲𐌲𐍂𐍃	Noun	𐍆𐌹𐌲𐌲𐍂𐍃 • (figgrs) m
𐌿𐍆𐌰𐍂𐌷𐌰𐌿𐍃𐌴𐌹𐌽𐍃	Noun	𐌿𐍆𐌰𐍂𐌷𐌰𐌿𐍃𐌴𐌹𐌽𐍃 • (ufarhauseins) f
𐌷𐌰𐌹𐌼𐍃	Noun	𐌷𐌰𐌹𐌼𐍃 • (haims) f
𐌿𐌽𐌸𐌹𐌿𐌳𐌰	Noun	𐌿𐌽𐌸𐌹𐌿𐌳𐌰 • (unþiuda) f
𐌿𐍆𐌰𐍂𐌰𐍃𐍃𐌿𐍃	Noun	𐌿𐍆𐌰𐍂𐌰𐍃𐍃𐌿𐍃 • (ufarassus) m
𐍃𐌺𐌿𐍂𐌰	Noun	𐍃𐌺𐌿𐍂𐌰 • (skura) f
𐌲𐌰𐌸𐍂𐌰𐍆𐍃𐍄𐌴𐌹𐌽𐍃	Noun	𐌲𐌰𐌸𐍂𐌰𐍆𐍃𐍄𐌴𐌹𐌽𐍃 • (gaþrafsteins) f
𐍃𐍅𐌴𐍂𐌹𐌸𐌰	Noun	𐍃𐍅𐌴𐍂𐌹𐌸𐌰 • (swēriþa) f
𐌼𐌴𐌽𐍉𐌸𐍃	Noun	𐌼𐌴𐌽𐍉𐌸𐍃 • (mēnōþs) m
𐌺𐌿𐌽𐌹	Noun	𐌺𐌿𐌽𐌹 • (kuni) n
𐌲𐌰𐌱𐌹𐌽𐌳𐌰	Noun	𐌲𐌰𐌱𐌹𐌽𐌳𐌰 • (gabinda) f
𐍅𐌹𐌻𐌾𐌰	Noun	𐍅𐌹𐌻𐌾𐌰 • (wilja) m
𐍃𐌹𐌱𐌾𐌰	Noun	𐍃𐌹𐌱𐌾𐌰 • (sibja) f
𐍄𐌴𐍅𐌰	Noun	𐍄𐌴𐍅𐌰 • (tēwa) f
𐍆𐍂𐌹𐌾𐌰𐌸𐍅𐌰	Noun	𐍆𐍂𐌹𐌾𐌰𐌸𐍅𐌰 • (frijaþwa) f
𐍅𐌴𐌹𐍄𐍅𐍉𐌳𐌴𐌹𐌽𐍃	Noun	𐍅𐌴𐌹𐍄𐍅𐍉𐌳𐌴𐌹𐌽𐍃 • (weitwōdeins) f
𐌰𐌱𐌱𐌰	Noun	𐌰𐌱𐌱𐌰 • (abba) m
𐍃𐌺𐌿𐌲𐌲𐍅𐌰	Noun	𐍃𐌺𐌿𐌲𐌲𐍅𐌰 • (skuggwa) m
𐌰𐍃𐍃𐌰𐍂𐌾𐌿𐍃	Noun	𐌰𐍃𐍃𐌰𐍂𐌾𐌿𐍃 • (assarjus) m
𐌽𐌰𐌷𐍄𐌰𐌼𐌰𐍄𐍃	Noun	𐌽𐌰𐌷𐍄𐌰𐌼𐌰𐍄𐍃 • (nahtamats) m
𐌲𐌰𐌵𐌿𐌼𐌸𐍃	Noun	𐌲𐌰𐌵𐌿𐌼𐌸𐍃 • (gaqumþs) f
𐌱𐌰𐌿𐍂	Noun	𐌱𐌰𐌿𐍂 • (baur) m
𐌽𐌰𐌿𐍃	Noun	𐌽𐌰𐌿𐍃 • (naus) m
𐌷𐌿𐌲𐍃	Noun	𐌷𐌿𐌲𐍃 • (hugs) m
𐌼𐍉𐍄𐌰𐍃𐍄𐌰𐌸𐍃	Noun	𐌼𐍉𐍄𐌰𐍃𐍄𐌰𐌸𐍃 • (mōtastaþs) m
𐌱𐌻𐍉𐍄𐌹𐌽𐌰𐍃𐍃𐌿𐍃	Noun	𐌱𐌻𐍉𐍄𐌹𐌽𐌰𐍃𐍃𐌿𐍃 • (blōtinassus) m
𐌷𐌿𐌽𐌳𐌰𐍆𐌰𐌸𐍃	Noun	𐌷𐌿𐌽𐌳𐌰𐍆𐌰𐌸𐍃 • (hundafaþs) m
𐍅𐌿𐌻𐌸𐌿𐍃	Noun	𐍅𐌿𐌻𐌸𐌿𐍃 • (wulþus) m
𐌲𐌰𐌻𐌹𐌲𐍂𐌹	Noun	𐌲𐌰𐌻𐌹𐌲𐍂𐌹 • (galigri) n
𐌰𐌿𐌲𐍉	Noun	𐌰𐌿𐌲𐍉 • (augō) n
𐌺𐌰𐌿𐍂𐌽𐍉	Noun	𐌺𐌰𐌿𐍂𐌽𐍉 • (kaurnō) n
𐌺𐌿𐌱𐌹𐍄𐌿𐍃	Noun	𐌺𐌿𐌱𐌹𐍄𐌿𐍃 • (kubitus) m
𐌰𐌽𐌰𐌵𐌹𐍃𐍃	Noun	𐌰𐌽𐌰𐌵𐌹𐍃𐍃 • (anaqiss) f
𐌷𐌰𐌻𐍃	Noun	𐌷𐌰𐌻𐍃 • (hals) m
𐌱𐍉𐌺𐌰𐍂𐌴𐌹𐍃	Noun	𐌱𐍉𐌺𐌰𐍂𐌴𐌹𐍃 • (bōkāreis) m
𐌹𐌳𐍅𐌴𐌹𐍄	Noun	𐌹𐌳𐍅𐌴𐌹𐍄 • (idweit) n
𐌲𐌰𐍃𐌺𐌰𐍆𐍄𐍃	Noun	𐌲𐌰𐍃𐌺𐌰𐍆𐍄𐍃 • (gaskafts) f
𐌲𐌿𐌳𐌾𐌰	Noun	𐌲𐌿𐌳𐌾𐌰 • (gudja) m
𐍃𐌹𐌲𐌻𐌾𐍉	Noun	𐍃𐌹𐌲𐌻𐌾𐍉 • (sigljō) n
𐍃𐌻𐌰𐌿𐌷𐍄𐍃	Noun	𐍃𐌻𐌰𐌿𐌷𐍄𐍃 • (slauhts) f
𐍆𐌰𐌿𐍂𐌻𐌰𐌲𐌴𐌹𐌽𐍃	Noun	𐍆𐌰𐌿𐍂𐌻𐌰𐌲𐌴𐌹𐌽𐍃 • (faurlageins) f
𐌿𐌽𐍂𐌹𐌿𐍂𐌴𐌹	Noun	𐌿𐌽𐍂𐌹𐌿𐍂𐌴𐌹 • (unriurei) f
𐌼𐍉𐍄𐌰	Noun	𐌼𐍉𐍄𐌰 • (mōta) f
