मत्त	Adjective	मत्त • (matt) (Urdu spelling مت‏)
गीला	Adjective	गीला • (gīlā) (Urdu spelling گیلا‏)
फीका	Adjective	फीका • (phīkā)
अकाल	Adjective	अकाल • (akāl) (Urdu spelling اکال‏)
अमरीकी	Adjective	अमरीकी • (amrīkī)
अकेला	Adjective	अकेला • (akelā) (Urdu spelling اکیلا‏)
अकर्मक	Adjective	अकर्मक • (akarmak)
गंजा	Adjective	गंजा • (gañjā)
होनहार	Adjective	होनहार • (honhār) (Urdu spelling هونہار‏)
महंगा	Adjective	महंगा • (mahaṅgā) (Urdu spelling مہنگا‏)
प्राकृतिक	Adjective	प्राकृतिक • (prākŕtik) (Urdu spelling پراکرتک‏)
कृत	Adjective	कृत • (kŕt)
सस्ता	Adjective	सस्ता • (sastā) (Urdu spelling سستا‏)
दाहिना	Adjective	दाहिना • (dāhinā)
सत्य	Adjective	सत्य • (satya) (Urdu spelling ستیہ‏)
भारा	Adjective	भारा • (bhārā)
गूंगा	Adjective	गूंगा • (gūṅgā)
प्रवीण	Adjective	प्रवीण • (pravīṇ) (Urdu spelling پروين‏)
अर्ध	Adjective	अर्ध • (ardh)
ऊंचा	Adjective	ऊंचा • (ūñcā) (Urdu spelling اونچا‏)
वीर	Adjective	वीर • (vīr)
कैसा	Adjective	कैसा • (kaisā)
असत्य	Adjective	असत्य • (asatya)
पास	Adjective	पास • (pās)
विधायक	Adjective	विधायक • (vidhāyak)
साधारण	Adjective	साधारण • (sādhāraṇ) (Urdu spelling سادھارن‏)
अछूत	Adjective	अछूत • (achūt)
हल्का	Adjective	हल्का • (halkā)
प्रसन्न	Adjective	प्रसन्न • (prasann) (Urdu spelling پرسنن‏)
बहुत-सारा	Adjective	बहुत-सारा • (bahut-sārā)
उतना	Adjective	उतना • (utnā) (Urdu spelling اتنا‏)
ख़राब	Adjective	ख़राब • (xarāb) (Urdu spelling خراب‏)
वैवाहिक	Adjective	वैवाहिक • (vaivāhik)
ठंडा	Adjective	ठंडा • (ṭhaṇḑā)
बुनियादी	Adjective	बुनियादी • (buniyādī)
शेष	Adjective	शेष • (śeṣ)
संस्कृत	Adjective	संस्कृत • (sanskŕt)
पतला	Adjective	पतला • (patlā)
कृष्ण	Adjective	कृष्ण • (kŕṣṇ) (Urdu spelling کرشن‏)
बेतुका	Adjective	बेतुका • (betukā)
गुप्त	Adjective	गुप्त • (gupt) (Urdu spelling گپت‏)
पढ़ा लिखा	Adjective	पढ़ा लिखा • (paṛhā likhā)
आस्तिक	Adjective	आस्तिक • (āstik)
मस्ताना	Adjective	मस्ताना • (mastānā)
अंग्रेज़	Adjective	अंग्रेज़ • (ãṅgrez) (Urdu spelling انگریز‏)
सत्ताधारी	Adjective	सत्ताधारी • (sattādhārī)
गायक	Adjective	गायक • (gāyak) (Urdu spelling گایک‏)
पूर्वज	Adjective	पूर्वज • (pūrvaj)
पीला	Adjective	पीला • (pīlā) (Urdu spelling پیلا‏)
अंधा	Adjective	अंधा • (andhā) (Urdu spelling اندھا‏)
गाढ़ा	Adjective	गाढ़ा • (gāṛhā) (Urdu spelling گاڑھا‏)
नव	Adjective	नव • (nav)
खट्टा	Adjective	खट्टा • (khaṭṭā)
सुहावना	Adjective	सुहावना • (suhāvnā)
उलटा	Adjective	उलटा • (ulṭā)
बहरा	Adjective	बहरा • (bahrā)
स्वादिष्ठ	Adjective	स्वादिष्ठ • (svādishṭh) (Urdu spelling سوادشٹ‏)
दुर्बल	Adjective	दुर्बल • (durbal) (Urdu spelling دربل‏)
खनिज	Adjective	खनिज • (khanij)
उग्र	Adjective	उग्र • (ugra)
दीवाना	Adjective	दीवाना • (dīvānā)
दुबला	Adjective	दुबला • (dublā) (Urdu spelling دبلا‏)
जैसा	Adjective	जैसा • (jaisā)
पिछड़ा	Adjective	पिछड़ा • (pichṛā)
शून्य	Adjective	शून्य • (śūnya) (Urdu spelling شونیہ‏)
हलका	Adjective	हलका • (halkā)
समतल	Adjective	समतल • (samtal)
मुश्किल	Adjective	मुश्किल • (muśkil) (Urdu spelling مشکل‏)
भला	Adjective	भला • (bhalā) (Urdu spelling بهلا‏)
रजत	Adjective	रजत • (rajat) (Urdu spelling رجت‏)
जनरल	Adjective	जनरल • (janral)
मूर्ख	Adjective	मूर्ख • (mūrkh) (Urdu spelling مورکھ‏)
सूखा	Adjective	सूखा • (sūkhā) (Urdu spelling سوکھا‏)
उच्च	Adjective	उच्च • (ucc)
अक्षत	Adjective	अक्षत • (akṣat) (Urdu spelling اکشت‏)
नंगा	Adjective	नंगा • (naṅgā) (Urdu spelling ننگا‏)
उलझा	Adjective	उलझा • (uljhā)
निहत्था	Adjective	निहत्था • (nihatthā)
प्यासा	Adjective	प्यासा • (pyāsā) (Urdu spelling پياسا‏)
लंबा	Adjective	लंबा • (lãmbā) (Urdu spelling لمبا‏)
कौनसा	Adjective	कौनसा • (kaunsā) (Urdu spelling کونسا‏)
गोरा	Adjective	गोरा • (gorā) (Urdu spelling گورا‏)
सड़ा	Adjective	सड़ा • (saṛā)
केवल	Adjective	केवल • (keval) (Urdu spelling کیول‏)
सुवर्ण	Adjective	सुवर्ण • (suvarṇ)
चौड़ा	Adjective	चौड़ा • (cauṛā) (Urdu spelling چوڑا‏)
बिचारा	Adjective	बिचारा • (bicārā) (Urdu spelling بچارا‏)
पहला	Adjective	पहला • (pehlā) (Urdu spelling پہلا‏)
चमकीला	Adjective	चमकीला • (camkīlā) (Urdu spelling چمکیلا‏)
रचित	Adjective	रचित • (racit)
मूल	Adjective	मूल • (mūl)
पिछला	Adjective	पिछला • (pichlā) (Urdu spelling پچھلا‏)
दीर्घ	Adjective	दीर्घ • (dīrgh) (Urdu spelling دیرگھ‏)tr=dīrgh|
अच्छा	Adjective	अच्छा • (acchā) (Urdu spelling اچھا‏)
बधिर	Adjective	बधिर • (badhir)
पेय	Adjective	पेय • (peya)
पृथु	Adjective	पृथु • (pŕthu)
गहरा	Adjective	गहरा • (gahrā) (Urdu spelling گہرا‏)
ऐसा	Adjective	ऐसा • (aisā) (Urdu spelling ایسا‏)
अंधेरा	Adjective	अंधेरा • (andherā) (Urdu spelling اندھیرا‏)
फ़रक़	Adjective	फ़रक़ • (farq)
महँगा	Adjective	महँगा • (mahãgā) (Urdu spelling مہنگا‏)
दृश्य	Adjective	दृश्य • (dŕśya)
इक्का	Adjective	इक्का • (ikkā)
असहाय	Adjective	असहाय • (ashāy)
कारौ	Adjective	कारौ • (kārau)
दक्षिण	Adjective	दक्षिण • (dakṣiṇa) (Urdu spelling دکشن‏)
कामुक	Adjective	कामुक • (kāmuk) (Urdu spelling کامك‏)
इकलौता	Adjective	इकलौता • (iklautā)
पूरा	Adjective	पूरा • (pūrā)
पण्डित	Adjective	पण्डित • (paṇḍit)
सुनहरा	Adjective	सुनहरा • (sunahrā)
थोड़ा	Adjective	थोड़ा • (thoṛā) (Urdu spelling تھوڑا‏)
अगला	Adjective	अगला • (aglā) (Urdu spelling اگلا‏)
बदमाश	Adjective	बदमाश • (badmāś)
छोटा	Adjective	छोटा • (choṭā) (Urdu spelling چھوٹا‏)
विशाल	Adjective	विशाल • (viśāl)
विशेष	Adjective	विशेष • (viśeș) (Urdu spelling وشیش‏)
मान	Adjective	मान • (mān) (Urdu spelling مان‏)
सूना	Adjective	सूना • (sūnā)
चालू	Adjective	चालू • (cālū)
नीला	Adjective	नीला • (nīlā) (Urdu spelling نیلا‏)
प्रमुख	Adjective	प्रमुख • (pramukh) (Urdu spelling پرمکھ‏)
निंदासा	Adjective	निंदासा • (nĩndāsā) (Urdu spelling ننداسا‏)
भोला	Adjective	भोला • (bholā)
हरा	Adjective	हरा • (harā) (Urdu spelling ہرا‏)
इकट्ठा	Adjective	इकट्ठा • (ikaṭṭhā)
स्पष्ट	Adjective	स्पष्ट • (spaṣṭ)
ख़ूबसूरत	Adjective	ख़ूबसूरत • (xūbsūrat) (Urdu spelling خوبصورت‏)
नर	Adjective	नर • (nar) (Urdu spelling نر‏)
खड़ा	Adjective	खड़ा • (khaṛā) (Urdu spelling کھڑا‏)
पर	Adjective	पर • (par) (Urdu spelling پر‏)
द्रुत	Adjective	द्रुत • (drut)
प्रथम	Adjective	प्रथम • (pratham)
आर्य	Adjective	आर्य • (ārya) (Urdu spelling آریہ‏)
अक़्लमंद	Adjective	अक़्लमंद • (aql-mand)
छिछला	Adjective	छिछला • (chichlā)
पुराना	Adjective	पुराना • (purānā)
दरिद्र	Adjective	दरिद्र • (daridra)
अरब	Adjective	अरब • (arab)
ग़रीब	Adjective	ग़रीब • (ġarīb) (Urdu spelling غریب‏)
चिकना	Adjective	चिकना • (ciknā)
ताज़ा	Adjective	ताज़ा • (tāzā)
पसंदीदा	Adjective	पसंदीदा • (pasandīdā) (Urdu spelling پسنديدہ‏)
जवान	Adjective	जवान • (javān) (Urdu spelling جوان‏)
मौन	Adjective	मौन • (maun) (Urdu spelling مون‏)
अभय	Adjective	अभय • (abhay) (Urdu spelling ابھی‏)
किशोरा	Adjective	किशोरा • (kiśorā) (Urdu spelling کشورا‏)
इतना	Adjective	इतना • (itnā) (Urdu spelling اتنا‏)
सकर्मक	Adjective	सकर्मक • (sakarmak)
लँगड़ा	Adjective	लँगड़ा • (lãgṛā)
निर्घोष	Adjective	निर्घोष • (nirghoṣ)
पोपला	Adjective	पोपला • (poplā)
पौना	Adjective	पौना • (paunā)
प्रधान	Adjective	प्रधान • (pradhān)
अधर्म	Adjective	अधर्म • (adharm)
काला	Adjective	काला • (kālā) (Urdu spelling کالا‏)
शैतानी	Adjective	शैतानी • (śaitānī) (Urdu spelling شیطانی‏)
आवारा	Adjective	आवारा • (āvārā) (Urdu spelling آوارہ‏)
चीनी	Adjective	चीनी • (cīnī) (Urdu spelling چینی‏)
राजपूत	Adjective	राजपूत • (rājpūt)
अनुनासिक	Adjective	अनुनासिक • (anunāsik)
लम्बा	Adjective	लम्बा • (lambā) (Urdu spelling لمبا‏)
सुनिश्चित	Adjective	सुनिश्चित • (suniścit)
सिद्ध	Adjective	सिद्ध • (siddh)
सुन्दर	Adjective	सुन्दर • (sundar) (comparative सुन्दरतर, superlative सुन्दरतम, Urdu spelling سندر‏)
गुरु	Adjective	गुरु • (guru)
दूसरा	Adjective	दूसरा • (dūsrā) (Urdu spelling دوسرا‏)
उष्ण	Adjective	उष्ण • (uṣṇa) (Urdu spelling اشن‏)
खारा	Adjective	खारा • (khārā)
पैदा	Adjective	पैदा • (paidā)
जीवित	Adjective	जीवित • (jīvit) (Urdu spelling جيوت‏)
अनोखा	Adjective	अनोखा • (anokhā)
जमा	Adjective	जमा • (jamā)
भूरा	Adjective	भूरा • (bhūrā) (Urdu spelling بھورا‏)
माली	Adjective	माली • (mālī)
व्याख्याता	Adjective	व्याख्याता • (vyākhyātā)
अभाव	Adjective	अभाव • (abhāv) (Urdu spelling ابھاو‏)
बड़ा	Adjective	बड़ा • (baṛā) (Urdu spelling بڑا‏)
तीखा	Adjective	तीखा • (tīkhā) (Urdu spelling تیکھا‏)
टेढ़ा	Adjective	टेढ़ा • (ṭeṛhā)
अक्षय	Adjective	अक्षय • (akṣay)
प्राप्त	Adjective	प्राप्त • (prāpt)
झूठा	Adjective	झूठा • (jhūṭhā) (Urdu spelling جھوٹھا‏)
छुपा	Adjective	छुपा • (chupā) (Urdu spelling چھپا‏)
बूढ़ा	Adjective	बूढ़ा • (būṛhā) (Urdu spelling بوڑھا‏)
मूक	Adjective	मूक • (mūk)
सहस्र	Adjective	सहस्र • (sahasr) (Urdu spelling سہسر‏)
सगा	Adjective	सगा • (sagā)
नष्ट	Adjective	नष्ट • (naṣṭ) (Urdu spelling نشٹ‏)
नया	Adjective	नया • (nayā) (Urdu spelling نیا‏)
मोटा	Adjective	मोटा • (moṭā) (Urdu spelling موٹا‏)
इश्क़िया	Adjective	इश्क़िया • (ishqiyā) (Urdu spelling عشقیہ‏)
भूखा	Adjective	भूखा • (bhūkhā)
अंग्रेज़ी	Adjective	अंग्रेज़ी • (ãṅgrezī) (Urdu spelling انگریزی‏)
बर्फ़ानी	Adjective	बर्फ़ानी • (barfānī)
