hnyttinn	Adjective	hnyttinn (comparative hnyttnari, superlative hnyttnastur)
æðrulaus	Adjective	æðrulaus (comparative æðrulausari, superlative æðrulausastur)
séríslenskur	Adjective	séríslenskur (not comparable)
blóðugur	Adjective	blóðugur (comparative blóðugri, superlative blóðugastur)
helgur	Adjective	helgur (comparative helgari, superlative helgastur)
dauður	Adjective	dauður (comparative dauðari, superlative dauðastur)
dýrslegur	Adjective	dýrslegur (comparative dýrslegri, superlative dýrslegastur)
þrár	Adjective	þrár (comparative þrárri, superlative þráastur)
þrár	Adjective	þrár (comparative þrárri, superlative þráastur)
sérstakur	Adjective	sérstakur
tignarlegur	Adjective	tignarlegur (comparative tignarlegri, superlative tignarlegastur)
átjándi	Adjective	átjándi
stífur	Adjective	stífur (comparative stífari, superlative stífastur)
venjulegur	Adjective	venjulegur (comparative venjulegri, superlative venjulegastur)
trúlegur	Adjective	trúlegur (comparative trúlegri, superlative trúlegastur)
fínn	Adjective	fínn (comparative fínni, superlative fínastur)
vinsæll	Adjective	vinsæll (comparative vinsælli, superlative vinsælastur)
samnefndur	Adjective	samnefndur (not comparable)
hreinskilinn	Adjective	hreinskilinn (comparative hreinskilnari, superlative hreinskilnastur)
móður	Adjective	móður (comparative móðari, superlative móðastur)
móður	Adjective	móður (comparative móðari, superlative móðastur)
göfuglyndur	Adjective	göfuglyndur (comparative göfuglyndari, superlative göfuglyndastur)
ger	Adjective	ger (not comparable)
ger	Adjective	ger (comparative gerari, superlative gerastur)
jafnlangur	Adjective	jafnlangur (not comparable)
alúðlegur	Adjective	alúðlegur (comparative alúðlegri, superlative alúðlegastur)
kuldalegur	Adjective	kuldalegur (comparative kuldalegri, superlative kuldalegastur)
lóðréttur	Adjective	lóðréttur (comparative lóðréttari, superlative lóðréttastur)
frekur	Adjective	frekur (comparative frekari, superlative frekastur)
glúrinn	Adjective	glúrinn (comparative glúrnari, superlative glúrnastur)
saddur	Adjective	saddur (comparative saddari, superlative saddastur)
drjúgur	Adjective	drjúgur (comparative drýgri, superlative drýgstur)
æðóttur	Adjective	æðóttur (comparative æðóttari, superlative æðóttastur)
vergur	Adjective	vergur (comparative vergari, superlative vergastur)
tíður	Adjective	tíður (comparative tíðari, superlative tíðastur)
tyrkneskur	Adjective	tyrkneskur
óreglulegur	Adjective	óreglulegur (comparative óreglulegri, superlative óreglulegastur)
amerískur	Adjective	amerískur (comparative amerískari, superlative amerískastur)
teinóttur	Adjective	teinóttur (comparative teinóttari, superlative teinóttastur)
djöfull	Adjective	djöfull m (genitive singular djöfuls, nominative plural djöflar)
fagurblár	Adjective	fagurblár
ábatasamur	Adjective	ábatasamur (comparative ábatasamari, superlative ábatasamastur)
óður	Adjective	óður (comparative óðari, superlative óðastur)
huggulegur	Adjective	huggulegur (comparative huggulegri, superlative huggulegastur)
giftur	Adjective	giftur
mögulegur	Adjective	mögulegur
ærulaus	Adjective	ærulaus (comparative ærulausari, superlative ærulausastur)
hógvær	Adjective	hógvær (comparative hógværari, superlative hógværastur)
breskur	Adjective	breskur
óljúgfróður	Adjective	óljúgfróður (comparative óljúgfróðari, superlative óljúgfróðastur)
hættulegur	Adjective	hættulegur (comparative hættulegri, superlative hættulegastur)
ópersónulegur	Adjective	ópersónulegur
ör	Adjective	ör (comparative örari, superlative örastur)
gramur	Adjective	gramur (comparative gramari, superlative gramastur)
helvískur	Adjective	helvískur (comparative helvískari, superlative helvískastur)
stjarfur	Adjective	stjarfur (comparative stjarfari, superlative stjarfastur)
glöggur	Adjective	glöggur (comparative gleggri or glöggari, superlative gleggstur or glöggastur)
kyssilegur	Adjective	kyssilegur (comparative kyssilegri, superlative kyssilegastur)
frísneskur	Adjective	frísneskur
úfinn	Adjective	úfinn (comparative úfnari, superlative úfnastur)
þjáður	Adjective	þjáður (comparative þjáðari, superlative þjáðastur)
fríður	Adjective	fríður (comparative fríðari, superlative fríðastur)
sloj	Adjective	sloj (invariable)
gagnlegur	Adjective	gagnlegur (comparative gagnlegri, superlative gagnlegastur)
þannig	Adjective	þannig (invariable)
innleysanlegur	Adjective	innleysanlegur (not comparable)
skarpur	Adjective	skarpur (comparative skarpari, superlative skarpastur)
ólöglegur	Adjective	ólöglegur (comparative ólöglegri, superlative ólöglegastur)
þéttur	Adjective	þéttur (comparative þéttari, superlative þéttastur)
níundi	Adjective	níundi
láréttur	Adjective	láréttur (comparative láréttari, superlative láréttastur)
sterkur	Adjective	sterkur (comparative sterkari, superlative sterkastur)
sáttur	Adjective	sáttur (comparative sáttari, superlative sáttastur)
þreklegur	Adjective	þreklegur (comparative þreklegri, superlative þreklegastur)
kasheitur	Adjective	kasheitur
magur	Adjective	magur (comparative magrari, superlative magrastur)
tyrkískur	Adjective	tyrkískur
gulur	Adjective	gulur (comparative gulari, superlative gulastur)
andmáll	Adjective	andmáll (comparative andmálli, superlative andmálastur)
óinnleysanlegur	Adjective	óinnleysanlegur (not comparable)
ötull	Adjective	ötull (comparative ötulli, superlative ötulastur)
skoskur	Adjective	skoskur (comparative skoskari, superlative skoskastur)
tæknilegur	Adjective	tæknilegur (comparative tæknilegri, superlative tæknilegastur)
gestrisinn	Adjective	gestrisinn (comparative gestrisnari, superlative gestrisnastur)
tuttugasti	Adjective	tuttugasti
þolinmóður	Adjective	þolinmóður (comparative þolimóðari, superlative þolinmóðastur)
mannlegur	Adjective	mannlegur (comparative mannlegri, superlative mannlegastur)
hagnýtur	Adjective	hagnýtur (comparative hagnýtari, superlative hagnýtastur)
sár	Adjective	sár (comparative sárari, superlative sárastur)
lifandi	Adjective	lifandi (invariable)
fús	Adjective	fús (comparative fúsari, superlative fúsastur)
dapur	Adjective	dapur (comparative daprari, superlative daprastur)
leyfilegur	Adjective	leyfilegur (comparative leyfilegri, superlative leyfilegastur)
þreytandi	Adjective	þreytandi (not comparable)
vestari	Adjective	vestari (comparative, superlative vestastur)
ægilegur	Adjective	ægilegur (comparative ægilegri, superlative ægilegastur)
lélegur	Adjective	lélegur (comparative lélegri, superlative lélegastur)
ómögulegur	Adjective	ómögulegur (comparative ómögulegri, superlative ómögulegastur)
söguríkur	Adjective	söguríkur (comparative söguríkari, superlative söguríkastur)
tannlaus	Adjective	tannlaus (comparative tannlausari, superlative tannlausastur)
furðulegur	Adjective	furðulegur (comparative furðulegri, superlative furðulegastur)
ólmur	Adjective	ólmur (comparative ólmari, superlative ólmastur)
hugsanlegur	Adjective	hugsanlegur
reykvískur	Adjective	reykvískur (comparative reykvískari, superlative reykvískastur)
stutt	Adjective	stutt
brúnn	Adjective	brúnn (comparative brúnni, superlative brúnastur)
líkamlegur	Adjective	líkamlegur (comparative líkamlegri, superlative líkamlegastur)
skjótur	Adjective	skjótur (comparative skjótari, superlative skjótastur)
skýr	Adjective	skýr (comparative skýrari, superlative skýrastur)
ótrúr	Adjective	ótrúr (comparative ótrúrri, superlative otrúastur)
æsilegur	Adjective	æsilegur (comparative æsilegri, superlative æsilegastur)
lúterskur	Adjective	lúterskur (comparative lúterskari, superlative lúterskastur)
hýr	Adjective	hýr (comparative hýrari, superlative hýrastur)
freknóttur	Adjective	freknóttur (comparative freknóttari, superlative freknóttastur)
lama	Adjective	lama (invariable)
skozkur	Adjective	skozkur (comparative skozkari, superlative skozkastur)
rándýr	Adjective	rándýr (comparative rándýrari, superlative rándýrastur)
grænn	Adjective	grænn (comparative grænni, superlative grænastur)
siðsamur	Adjective	siðsamur (comparative siðsamari, superlative siðsamastur)
óstyrkur	Adjective	óstyrkur (comparative óstyrkari, superlative óstyrkastur)
syndur	Adjective	syndur (not comparable)
kjörgengur	Adjective	kjörgengur (not comparable)
hress	Adjective	hress (comparative hressari, superlative hressastur)
ljós	Adjective	ljós (comparative ljósari, superlative ljósastur)
traustur	Adjective	traustur (comparative traustari, superlative traustastur)
kornbreskur	Adjective	kornbreskur (comparative kornbreskari, superlative kornbreskastur)
einn	Adjective	einn
glæsilegur	Adjective	glæsilegur (comparative glæsilegri, superlative glæsilegastur)
spes	Adjective	spes
almennilegur	Adjective	almennilegur (comparative almennilegri, superlative almennilegastur)
vær	Adjective	vær (comparative værari, superlative værastur)
réttur	Adjective	réttur (comparative réttari, superlative réttastur)
greypur	Adjective	greypur (not comparable)
blíður	Adjective	blíður (comparative blíðari, superlative blíðastur)
heiður	Adjective	heiður (comparative heiðari, superlative heiðastur)
æðisgenginn	Adjective	æðisgenginn (comparative æðisgengnari, superlative æðisgengnastur)
erítreskur	Adjective	erítreskur (comparative erítreskari, superlative erítreskastur)
frár	Adjective	frár (comparative frárri, superlative fráastur)
erlendur	Adjective	erlendur (not comparable)
spænskur	Adjective	spænskur (comparative spænskari, superlative spænskastur)
öflugur	Adjective	öflugur (comparative öflugri, superlative öflugastur)
blæst	Adjective	blæst
æra	Adjective	æra
lítill	Adjective	lítill (comparative minni, superlative minnstur)
tregur	Adjective	tregur (comparative tregari, superlative tregastur)
rýr	Adjective	rýr
veikur	Adjective	veikur (comparative veikari, superlative veikastur)
regnlegur	Adjective	regnlegur (comparative regnlegri, superlative regnlegastur)
léttur	Adjective	léttur (comparative léttari, superlative léttastur)
rofinn	Adjective	rofinn (not comparable)
stórfenglegur	Adjective	stórfenglegur (comparative stórfenglegri, superlative stórfenglegastur)
íslenskur	Adjective	íslenskur (comparative íslenskari, superlative íslenskastur)
duglegur	Adjective	duglegur (comparative duglegri, superlative duglegastur)
salt	Adjective	salt
gegnvirkur	Adjective	gegnvirkur
snöggur	Adjective	snöggur (comparative sneggri, superlative sneggstur)
ósléttur	Adjective	ósléttur (comparative ósléttari, superlative ósléttastur)
spakur	Adjective	spakur
margþættur	Adjective	margþættur (comparative margþættari, superlative margþættastur)
læsilegur	Adjective	læsilegur (comparative læsilegri, superlative læsilegastur)
ljúgfróður	Adjective	ljúgfróður (comparative ljúgfróðari, superlative ljúgfróðastur)
teitur	Adjective	teitur
afbrigðilegur	Adjective	afbrigðilegur (comparative afbrigðilegri, superlative afbrigðilegastur)
heilbrigður	Adjective	heilbrigður (comparative heilbrigðari, superlative heilbrigðastur)
einir	Adjective	einir
kössóttur	Adjective	kössóttur (comparative kössóttari, superlative kössóttastur)
skemmtilegur	Adjective	skemmtilegur (comparative skemmtilegri, superlative skemmtilegastur)
sljór	Adjective	sljór (comparative sljórri, superlative sljóastur)
sveittur	Adjective	sveittur (comparative sveittari, superlative sveittastur)
fleygur	Adjective	fleygur (comparative fleygari, superlative fleygastur)
ær	Adjective	ær (comparative ærari, superlative ærastur)
rólegur	Adjective	rólegur (comparative rólegri, superlative rólegastur)
fær	Adjective	fær (comparative færari, superlative færastur)
stór	Adjective	stór (comparative stærri, superlative stærstur)
skær	Adjective	skær (comparative skærari, superlative skærari)
skær	Adjective	skær (not comparable)
hlýr	Adjective	hlýr (comparative hlýrri, superlative hlýjastur)
kaldur	Adjective	kaldur (comparative kaldari, superlative kaldastur)
líkur	Adjective	líkur (comparative líkari, superlative líkastur)
glaður	Adjective	glaður (comparative glaðari, superlative glaðastur)
blautur	Adjective	blautur (comparative blautari, superlative blautastur)
tíundi	Adjective	tíundi
nettó	Adjective	nettó
svartur	Adjective	svartur (comparative svartari, superlative svartastur)
stórkostlegur	Adjective	stórkostlegur (comparative stórkostlegri, superlative stórkostlegastur)
herkinn	Adjective	herkinn (comparative herknari, superlative herknastur)
ítur	Adjective	ítur (comparative ítrari, superlative ítrastur)
jákvæður	Adjective	jákvæður (comparative jákvæðari, superlative jákvæðastur)
úkraínskur	Adjective	úkraínskur
sleipur	Adjective	sleipur (comparative sleipari, superlative sleipastur)
tvöfaldur	Adjective	tvöfaldur (not comparable)
þýður	Adjective	þýður (comparative þýðari, superlative þýðastur)
bjartur	Adjective	bjartur (comparative bjartari, superlative bjartastur)
hár	Adjective	hár (comparative hærri, superlative hæstur)
grunnur	Adjective	grunnur (comparative grynnri, superlative grynnstur)
tóm	Adjective	tóm
ómblíður	Adjective	ómblíður (comparative ómblíðari, superlative ómblíðastur)
frónskur	Adjective	frónskur (comparative frónskari, superlative frónskastur)
gjarn	Adjective	gjarn (comparative gjarnari, superlative gjarnastur)
skárri	Adjective	skárri (comparative form, no absolute, superlative skástur)
maltur	Adjective	maltur (comparative maltari, superlative maltastur)
dyggur	Adjective	dyggur (comparative dyggari, superlative dyggastur)
lóða	Adjective	lóða (invariable)
sjaldgæfur	Adjective	sjaldgæfur (comparative sjaldgæfari, superlative sjaldgæfastur)
tæpur	Adjective	tæpur (comparative tæpari, superlative tæpastur)
breiður	Adjective	breiður (comparative breiðari, superlative breiðastur)
hvítur	Adjective	hvítur (comparative hvítari, superlative hvítastur)
margfaldur	Adjective	margfaldur (comparative margfaldari, superlative margfaldastur)
augljós	Adjective	augljós (comparative augljósari, superlative augljósastur)
æfur	Adjective	æfur (comparative æfari, superlative æfastur)
smellinn	Adjective	smellinn (comparative smellnari, superlative smellnastur)
vaskur	Adjective	vaskur (comparative vaskari, superlative vaskastur)
skiljanlegur	Adjective	skiljanlegur (comparative skiljanlegri, superlative skiljanlegastur)
girnilegur	Adjective	girnilegur (comparative girnilegri, superlative girnilegastur)
tilviljunarkenndur	Adjective	tilviljunarkenndur (comparative tilviljunarkenndari, superlative tilviljunarkenndastur)
lygn	Adjective	lygn (comparative lygnari, superlative lygnastur)
rjóður	Adjective	rjóður (comparative rjóðari, superlative rjóðastur)
æruverður	Adjective	æruverður (comparative æruverðari, superlative æruverðastur)
beittur	Adjective	beittur (comparative beittari, superlative beittastur)
heiðarlegur	Adjective	heiðarlegur (comparative heiðarlegri, superlative heiðarlegastur)
hreinn	Adjective	hreinn (comparative hreinni, superlative hreinastur)
áríðandi	Adjective	áríðandi (not comparable)
þurr	Adjective	þurr (comparative þurrari, superlative þurrastur)
sæti	Adjective	sæti
prettvís	Adjective	prettvís (comparative prettvísari, superlative prettvísastur)
albanskur	Adjective	albanskur
lyginn	Adjective	lyginn (comparative lygnari, superlative lygnastur)
agalegur	Adjective	agalegur (comparative agalegri, superlative agalegastur)
æðrufullur	Adjective	æðrufullur (comparative æðrufyllri, superlative æðrufyllastur)
snauður	Adjective	snauður (comparative snauðari, superlative snauðastur)
sautjándi	Adjective	sautjándi
hrokafullur	Adjective	hrokafullur (comparative hrokafyllri, superlative hrokafyllstur)
ung	Adjective	ung
loðinn	Adjective	loðinn (comparative loðnari, superlative loðnastur)
þröngur	Adjective	þröngur (comparative þrengri, superlative þrengstur)
einfaldur	Adjective	einfaldur (comparative einfaldari, superlative einfaldastur)
sjötti	Adjective	sjötti
klár	Adjective	klár (comparative klárari, superlative klárastur)
lekur	Adjective	lekur (comparative lekari, superlative lekastur)
mettur	Adjective	mettur (comparative mettari, superlative mettastur)
fáránlegur	Adjective	fáránlegur (comparative fáránlegri, superlative fáránlegastur)
kaþólskur	Adjective	kaþólskur (comparative kaþólskari, superlative kaþólskastur)
haffær	Adjective	haffær (comparative haffærari, superlative haffærastur)
styrkur	Adjective	styrkur (comparative styrkari, superlative styrkastur)
kynlaus	Adjective	kynlaus (comparative kynlausari, superlative kynlausastur)
þykkur	Adjective	þykkur (comparative þykkari or þykkri, superlative þykkastur)
kátur	Adjective	kátur (comparative kátari, superlative kátastur)
vingjarnlegur	Adjective	vingjarnlegur (comparative vingjarnlegri, superlative vingjarnlegastur)
holdvotur	Adjective	holdvotur
ógeðslegur	Adjective	ógeðslegur (comparative ógeðslegri, superlative ógeðslegastur)
vís	Adjective	vís (comparative vísari, superlative vísastur)
uppseldur	Adjective	uppseldur (not comparable)
ákveðinn	Adjective	ákveðinn (comparative ákveðnari, superlative ákveðnastur)
sléttur	Adjective	sléttur (comparative sléttari, superlative sléttastur)
súr	Adjective	súr (comparative súrari, superlative súrastur)
þýskur	Adjective	þýskur
hávær	Adjective	hávær (comparative háværari, superlative háværastur)
ljótur	Adjective	ljótur (comparative ljótari, superlative ljótastur)
beinn	Adjective	beinn (comparative beinni, superlative beinastur)
þrjóskur	Adjective	þrjóskur (comparative þrjóskari, superlative þrjóskastur)
gotneskur	Adjective	gotneskur (comparative gotneskari, superlative gotneskastur)
flæmskur	Adjective	flæmskur (comparative flæmskari, superlative flæmskastur)
falur	Adjective	falur (comparative falari, superlative falastur)
gleðilegur	Adjective	gleðilegur (comparative gleðilegri, superlative gleðilegastur)
hljóður	Adjective	hljóður (comparative hljóðari, superlative hljóðastur)
þunnur	Adjective	þunnur (comparative þynnri, superlative þynnstur)
fagur	Adjective	fagur (comparative fegurri, superlative fegurstur)
afríkanskur	Adjective	afríkanskur
mongólska	Adjective	mongólska
næmur	Adjective	næmur (comparative næmari, superlative næmastur)
gallalaus	Adjective	gallalaus
indæll	Adjective	indæll (comparative indælli, superlative indælastur)
viðamikill	Adjective	viðamikill (comparative viðameiri, superlative viðamestur)
patt	Adjective	patt (indeclinable)
sænskur	Adjective	sænskur (comparative sænskari, superlative sænskastur)
hvellur	Adjective	hvellur (comparative hvellari, superlative hvellastur)
serbneskur	Adjective	serbneskur
ærinn	Adjective	ærinn (not comparable)
nýr	Adjective	nýr (comparative nýrri, superlative nýjastur)
óraunverulegur	Adjective	óraunverulegur
afrískur	Adjective	afrískur (comparative afrískari, superlative afrískastur)
áhugasamur	Adjective	áhugasamur (comparative áhugasamari, superlative áhugasamastur)
argur	Adjective	argur (comparative argari, superlative argastur)
ólyginn	Adjective	ólyginn (comparative ólygnari, superlative ólygnastur)
ærlegur	Adjective	ærlegur (comparative ærlegri, superlative ærlegastur)
vinalegur	Adjective	vinalegur (comparative vinalegri, superlative vinalegastur)
afbrýðisamur	Adjective	afbrýðisamur (comparative afbrýðisamari, superlative afbrýðisamastur)
slakur	Adjective	slakur (comparative slakari, superlative slakastur)
tárvotur	Adjective	tárvotur (comparative tárvotari, superlative tárvotastur)
hrörlegur	Adjective	hrörlegur (comparative hrörlegri, superlative hrörlegastur)
frjósamur	Adjective	frjósamur (comparative frjósamari, superlative frjósamastur)
herfær	Adjective	herfær (comparative herfærari, superlative herfærastur)
sjálfhælinn	Adjective	sjálfhælinn (comparative sjálfhælnari, superlative sjálfhælnastur)
haltur	Adjective	haltur (comparative haltari, superlative haltastur)
mórauður	Adjective	mórauður
tær	Adjective	tær (comparative tærari, superlative tærastur)
grýttur	Adjective	grýttur (comparative grýttari, superlative grýttastur)
sikker	Adjective	sikker
latur	Adjective	latur (comparative latari, superlative latastur)
óvæntur	Adjective	óvæntur (comparative óvæntari, superlative óvæntastur)
slímugur	Adjective	slímugur (comparative slímugri, superlative slímugastur)
persónulegur	Adjective	persónulegur
skyggn	Adjective	skyggn (comparative skyggnari, superlative skyggnastur)
slægur	Adjective	slægur (comparative slægari, superlative slægastur)
ern	Adjective	ern (comparative ernari, superlative ernastur)
skæður	Adjective	skæður (comparative skæðari, superlative skæðastur)
hrái	Adjective	hrái
seinn	Adjective	seinn (comparative seinni, superlative seinastur)
stelvís	Adjective	stelvís (comparative stelvísari, superlative stelvísastur)
dýr	Adjective	dýr (comparative dýrari, superlative dýrastur) or
dýr (comparative dýrri, superlative dýrstur)
þrá	Adjective	þrá
ryðfrír	Adjective	ryðfrír (not comparable)
gríðarlegur	Adjective	gríðarlegur (comparative gríðarlegri, superlative gríðarlegastur)
góða	Adjective	góða
huglaus	Adjective	huglaus (comparative huglausari, superlative huglausastur)
hæðóttur	Adjective	hæðóttur (comparative hæðóttari, superlative hæðóttastur)
tvítyngdur	Adjective	tvítyngdur
tryggur	Adjective	tryggur (comparative tryggari, superlative tryggastur)
skírlífur	Adjective	skírlífur (comparative skírlífari, superlative skírlífastur)
safamikill	Adjective	safamikill (comparative safameiri, superlative safamestur)
illur	Adjective	illur (comparative verri, superlative verstur)
rangstæður	Adjective	rangstæður (comparative rangstæðari, superlative rangstæðastur)
gamall	Adjective	gamall (comparative eldri, superlative elstur)
glær	Adjective	glær (comparative glærari or glæjari, superlative glærastur or glæjastur)
hallur	Adjective	hallur (comparative hallari, superlative hallastur)
fár	Adjective	fár (comparative færri, superlative fæstur)
óþekkur	Adjective	óþekkur
verðugur	Adjective	verðugur (comparative verðugri, superlative verðugastur)
bólginn	Adjective	bólginn (comparative bólgnari, superlative bólgnastur)
lasinn	Adjective	lasinn (comparative lasnari, superlative lasnastur)
lífrænn	Adjective	lífrænn (comparative lífrænni, superlative lífrænastur)
safaríkur	Adjective	safaríkur (comparative safaríkari, superlative safaríkastur)
fúinn	Adjective	fúinn (comparative fúnari, superlative fúnastur)
spurull	Adjective	spurull (comparative spurulli, superlative spurulastur)
ítalskur	Adjective	ítalskur (comparative ítalskari, superlative ítalskastur)
fljótur	Adjective	fljótur (comparative fljótari, superlative fljótastur)
litríkur	Adjective	litríkur (comparative litríkari, superlative litríkastur)
gagnsær	Adjective	gagnsær (comparative gagnsærri, superlative gagnsæjastur)
hagur	Adjective	hagur (comparative hagari, superlative hagastur)
feiminn	Adjective	feiminn (comparative feimnari, superlative feimnastur)
kær	Adjective	kær (comparative kærari, superlative kærastur)
meiddur	Adjective	meiddur (comparative meiddari, superlative meiddastur)
hart	Adjective	hart
strangur	Adjective	strangur (comparative strangari, superlative strangastur)
sorglegur	Adjective	sorglegur (comparative sorglegri, superlative sorglegastur)
pólskur	Adjective	pólskur
milt	Adjective	milt
laus	Adjective	laus (comparative lausari, superlative lausastur)
norskur	Adjective	norskur (not comparable)
afkáralegur	Adjective	afkáralegur (comparative afkáralegri, superlative afkáralegastur)
auðugur	Adjective	auðugur (comparative auðugri, superlative auðugastur)
bágur	Adjective	bágur (comparative bágari, superlative bágastur)
litúrgískur	Adjective	litúrgískur
platónskur	Adjective	platónskur (comparative platónskari, superlative platónskastur)
hissa	Adjective	hissa (indeclinable)
rór	Adjective	rór (comparative rórri, superlative róastur)
graður	Adjective	graður (comparative graðari, superlative graðastur)
fætt	Adjective	fætt
aðdáanlegur	Adjective	aðdáanlegur (comparative aðdáanlegri, superlative aðdáanlegastur)
tómur	Adjective	tómur (comparative tómari, superlative tómastur)
votur	Adjective	votur (comparative votari, superlative votastur)
ilmandi	Adjective	ilmandi
göfugur	Adjective	göfugur (comparative göfugri, superlative göfugastur)
tólfti	Adjective	tólfti
frjáls	Adjective	frjáls (comparative frjálsari, superlative frjálsastur)
sekur	Adjective	sekur (comparative sekari, superlative sekastur)
háll	Adjective	háll
æt	Adjective	æt
meyr	Adjective	meyr (comparative meyrari, superlative meyrastur)
hrár	Adjective	hrár (comparative hrárri, superlative hráastur)
stakur	Adjective	stakur (comparative stakari, superlative stakastur)
roskinn	Adjective	roskinn (comparative rosknari, superlative rosknastur)
lettneskur	Adjective	lettneskur
fljúgandi	Adjective	fljúgandi
svalur	Adjective	svalur (comparative svalari, superlative svalastur)
þúsundasti	Adjective	þúsundasti
dólgslegur	Adjective	dólgslegur (comparative dólgslegri, superlative dólgslegastur)
allur	Adjective	allur
fjórði	Adjective	fjórði
hræðilegur	Adjective	hræðilegur (comparative hræðilegri, superlative hræðilegastur)
töluverður	Adjective	töluverður
fælinn	Adjective	fælinn (comparative fælnari, superlative fælnastur)
hás	Adjective	hás (comparative hásari, superlative hásastur)
lakur	Adjective	lakur (comparative lakari, superlative lakastur)
franskur	Adjective	franskur (comparative franskari, superlative franskastur)
ógagnsær	Adjective	ógagnsær (comparative ógagnsærri, superlative ógagnsæjastur)
mjúkur	Adjective	mjúkur (comparative mýkri, superlative mýkstur)
réttlátur	Adjective	réttlátur (comparative réttlátari, superlative réttlátastur)
linur	Adjective	linur (comparative linari, superlative linastur)
fullkominn	Adjective	fullkominn (comparative fullkomnari, superlative fullkomnastur)
einmanna	Adjective	einmanna
haustlegur	Adjective	haustlegur (comparative haustlegri, superlative haustlegastur)
snoppufríður	Adjective	snoppufríður (comparative snoppufríðari, superlative snoppufríðastur)
ættstór	Adjective	ættstór (comparative ættstærri, superlative ættstærstur)
útlendur	Adjective	útlendur (comparative útlendari, superlative útlendastur)
nauðsynlegur	Adjective	nauðsynlegur (comparative nauðsynlegri, superlative nauðsynlegastur)
þriðji	Adjective	þriðji
ragur	Adjective	ragur (comparative ragari, superlative ragastur)
snar	Adjective	snar (comparative snarari, superlative snarastur)
klunnalegur	Adjective	klunnalegur (comparative klunnalegri, superlative klunnalegastur)
fýldur	Adjective	fýldur (comparative fýldari, superlative fýldastur)
bræt	Adjective	bræt (invariable)
rúmur	Adjective	rúmur (comparative rýmri, superlative rýmstur)
frakkur	Adjective	frakkur (comparative frakkari, superlative frakkastur)
andvaka	Adjective	andvaka
krappur	Adjective	krappur (comparative krappari, superlative krappastur)
bitur	Adjective	bitur (comparative bitrari, superlative bitrastur)
sjónskertur	Adjective	sjónskertur (comparative sjónskertari, superlative sjónskertastur)
rangeygður	Adjective	rangeygður (comparative rangeygðari, superlative rangeygðastur)
leikinn	Adjective	leikinn (comparative leiknari, superlative leiknastur)
laglegur	Adjective	laglegur (comparative laglegri, superlative laglegastur)
kvikur	Adjective	kvikur (comparative kvikari, superlative kvikastur)
hrikalegur	Adjective	hrikalegur (comparative hrikalegri, superlative hrikalegastur)
ævintýralegur	Adjective	ævintýralegur (comparative ævintýralegri, superlative ævintýralegastur)
kvíðinn	Adjective	kvíðinn (comparative kvíðnari, superlative kvíðnastur)
flókinn	Adjective	flókinn (comparative flóknari, superlative flóknastur)
mattur	Adjective	mattur (comparative mattari, superlative mattastur)
enskur	Adjective	enskur (comparative enskari, superlative enskastur)
frí	Adjective	frí (invariable)
andfélagslegur	Adjective	andfélagslegur
gungulegur	Adjective	gungulegur (comparative gungulegri, superlative gungulegastur)
sýnn	Adjective	sýnn (comparative sýnni, superlative sýnstur)
þyrnóttur	Adjective	þyrnóttur (comparative þyrnóttari, superlative þyrnóttastur)
sextándi	Adjective	sextándi
grár	Adjective	grár (comparative grárri, superlative gráastur)
heimskulegur	Adjective	heimskulegur (comparative heimskulegri, superlative heimskulegastur)
formlegur	Adjective	formlegur (comparative formlegri, superlative formlegastur)
fastur	Adjective	fastur (comparative fastari, superlative fastastur)
landluktur	Adjective	landluktur (not comparable)
varmur	Adjective	varmur (comparative varmari, superlative varmastur)
vatnsheldur	Adjective	vatnsheldur (comparative vatnsheldari, superlative vatnsheldastur)
blár	Adjective	blár (comparative blárri, superlative bláastur)
drykkfelldur	Adjective	drykkfelldur (comparative drykkfelldari, superlative drykkfelldastur)
deplóttur	Adjective	deplóttur (comparative deplóttari, superlative deplóttastur)
hyggjuþungur	Adjective	hyggjuþungur (comparative hyggjuþyngri, superlative hyggjuþyngstur)
heitur	Adjective	heitur (comparative heitari, superlative heitastur)
röskur	Adjective	röskur (comparative röskari, superlative röskastur)
óþolinmóður	Adjective	óþolinmóður (comparative óþolinmóðari, superlative óþolinmóðastur)
heilagur	Adjective	heilagur
nálægur	Adjective	nálægur (comparative nálægari, superlative nálægastur)
fátækur	Adjective	fátækur (comparative fátækari, superlative fátækastur)
virkur	Adjective	virkur (comparative virkari, superlative virkastur)
freðinn	Adjective	freðinn (comparative freðnari, superlative freðnastur)
sjöundi	Adjective	sjöundi
laggóður	Adjective	laggóður (comparative laggóð, superlative laggott)
farsæll	Adjective	farsæll (comparative farsælli, superlative farsælastur)
harður	Adjective	harður (comparative harðari, superlative harðastur)
arabískur	Adjective	arabískur (comparative arabískari, superlative arabískastur)
náttúrulegur	Adjective	náttúrulegur (comparative náttúrulegri, superlative náttúrulegastur)
hyrndur	Adjective	hyrndur (comparative hyrndari, superlative hyrndastur)
þerrinn	Adjective	þerrinn (not comparable)
fölur	Adjective	fölur (comparative fölari, superlative fölastur)
bókstaflegur	Adjective	bókstaflegur (comparative bókstaflegri, superlative bókstaflegastur)
appelsínugulur	Adjective	appelsínugulur (comparative appelsínugulari, superlative appelsínugulastur)
bleikur	Adjective	bleikur (comparative bleikari, superlative bleikastur)
nítjándi	Adjective	nítjándi
pínulítill	Adjective	pínulítill (not comparable)
nytsamlegur	Adjective	nytsamlegur (comparative nytsamlegri, superlative nytsamlegastur)
feginn	Adjective	feginn (comparative fegnari, superlative fegnastur)
hraður	Adjective	hraður (comparative hraðari, superlative hraðastur)
ómerkilegur	Adjective	ómerkilegur (comparative ómerkilegri, superlative ómerkilegastur)
baldur	Adjective	baldur
happadrjúgur	Adjective	happadrjúgur (comparative happadrýgri, superlative happadrýgðstur)
feitur	Adjective	feitur (comparative feitari, superlative feitastur)
skítugur	Adjective	skítugur (comparative skítugri, superlative skítugastur)
skilvirkur	Adjective	skilvirkur (comparative skilvirkari, superlative skilvirkastur)
ófrískur	Adjective	ófrískur
danskur	Adjective	danskur
væminn	Adjective	væminn (comparative væmnari, superlative væmnastur)
óhreinn	Adjective	óhreinn (comparative óhreinni, superlative óhreinastur)
fjöltyngdur	Adjective	fjöltyngdur
sannur	Adjective	sannur (comparative sannari, superlative sannastur)
ólæsilegur	Adjective	ólæsilegur (comparative ólæsiglegri, superlative ólæsilegastur)
viss	Adjective	viss (comparative vissari, superlative vissastur)
öldóttur	Adjective	öldóttur (comparative öldóttari, superlative öldóttastur)
gildur	Adjective	gildur (comparative gildari, superlative gildastur)
myndarlegur	Adjective	myndarlegur (comparative myndarlegri, superlative myndarlegastur)
kyrr	Adjective	kyrr (comparative kyrrari, superlative kyrrastur)
ódýr	Adjective	ódýr (comparative ódýrari, superlative ódýrastur)
gæfur	Adjective	gæfur (comparative gæfari, superlative gæfastur)
næs	Adjective	næs (invariable)
smár	Adjective	smár (comparative smærri, superlative smæstur)
óhuggulegur	Adjective	óhuggulegur (comparative óhuggulegri, superlative óhuggulegastur)
rotinn	Adjective	rotinn (comparative rotnari, superlative rotnastur)
sver	Adjective	sver (comparative sverari, superlative sverastur)
leiður	Adjective	leiður (comparative leiðari, superlative leiðastur)
spar	Adjective	spar (comparative sparari, superlative sparastur)
skakkur	Adjective	skakkur (comparative skakkari, superlative skakkastur)
holur	Adjective	holur (comparative holari, superlative holastur)
minnisgóður	Adjective	minnisgóður (comparative minnisbetri, superlative minnisbestur)
þrítyngdur	Adjective	þrítyngdur
þrennur	Adjective	þrennur (not comparable)
ónothæfur	Adjective	ónothæfur (comparative ónothæfari, superlative ónothæfastur)
ótrúlegur	Adjective	ótrúlegur (comparative ótrúlegri, superlative ótrúlegastur)
hvass	Adjective	hvass (comparative hvassari, superlative hvassastur)
steri	Adjective	steri
sum	Adjective	sum
kunnur	Adjective	kunnur (comparative kunnari, superlative kunnastur)
montinn	Adjective	montinn (comparative montnari, superlative montnastur)
reiður	Adjective	reiður (comparative reiðari, superlative reiðastur)
yngri	Adjective	yngri
hrumur	Adjective	hrumur (comparative hrumari, superlative hrumastur)
þrettándi	Adjective	þrettándi
ljúfur	Adjective	ljúfur (comparative ljúfari, superlative ljúfastur)
hægur	Adjective	hægur (comparative hægari, superlative hægastur)
auðveldur	Adjective	auðveldur (comparative auðveldari, superlative auðveldastur)
víðáttumikill	Adjective	víðáttumikill (comparative víðáttumeiri, superlative víðáttumestur)
skoplegur	Adjective	skoplegur (comparative skoplegri, superlative skoplegastur)
nothæfur	Adjective	nothæfur (comparative nothæfari, superlative nothæfastur)
tímabundinn	Adjective	tímabundinn (comparative tímabundnari, superlative tímabundnastur)
fullur	Adjective	fullur (comparative fyllri, superlative fyllstur)
prúður	Adjective	prúður (comparative prúðari, superlative prúðastur)
sjúkur	Adjective	sjúkur (comparative sjúkari, superlative sjúkastur)
ófrjór	Adjective	ófrjór (comparative ófrjórri, superlative ófrjóastur)
lágur	Adjective	lágur (comparative lægri, superlative lægstur)
flekklaus	Adjective	flekklaus (comparative flekklausari, superlative flekklausastur)
bert	Adjective	bert
eintyngdur	Adjective	eintyngdur (not comparable)
ætur	Adjective	ætur (comparative ætari, superlative ætastur)
heiðskír	Adjective	heiðskír (comparative heiðskírari, superlative heiðskírastur)
gullinn	Adjective	gullinn (not comparable)
dökkur	Adjective	dökkur (comparative dekkri, superlative dekkstur)
andstæður	Adjective	andstæður (comparative andstæðari, superlative andstæðastur)
tamur	Adjective	tamur (comparative tamari, superlative tamastur)
helber	Adjective	helber (not comparable)
ófríður	Adjective	ófríður (comparative ófríðari, superlative ófríðastur)
ungur	Adjective	ungur (comparative yngri, superlative yngstur)
harkalegur	Adjective	harkalegur (comparative harkalegri, superlative harkalegastur)
ysmikill	Adjective	ysmikill (comparative ysmeiri, superlative ysmestur)
óbeinn	Adjective	óbeinn (comparative óbeinni, superlative óbeinastur)
svangur	Adjective	svangur (comparative svengri or svangari, superlative svengstur or svangastur)
ómþýður	Adjective	ómþýður (comparative ómþýðari, superlative ómþýðastur)
hljóðlátur	Adjective	hljóðlátur (comparative hljóðlátari, superlative hljóðlátastur)
rangur	Adjective	rangur (comparative rangari, superlative rangastur)
hæfur	Adjective	hæfur (comparative hæfari, superlative hæfastur)
áttundi	Adjective	áttundi
óþekkt	Adjective	óþekkt
óþekkt	Adjective	óþekkt
greindur	Adjective	greindur (comparative greindari, superlative greindastur)
raupsamur	Adjective	raupsamur (comparative raupsamari, superlative raupsamastur)
mestur	Adjective	mestur
rússneskur	Adjective	rússneskur
safírblár	Adjective	safírblár
ánægður	Adjective	ánægður (comparative ánægðari, superlative ánægðastur)
spenntur	Adjective	spenntur (comparative spenntari, superlative spenntastur)
reiðubúinn	Adjective	reiðubúinn (comparative reiðubúnari, superlative reiðubúnastur)
rámur	Adjective	rámur (comparative rámari, superlative rámastur)
óléttur	Adjective	óléttur (comparative óléttari, superlative óléttastur)
þjáll	Adjective	þjáll (comparative þjálli, superlative þjálastur)
trúr	Adjective	trúr (comparative trúrri, superlative trúastur)
hamingjusamur	Adjective	hamingjusamur (comparative hamingjusamari, superlative hamingjusamastur)
rakur	Adjective	rakur (comparative rakari, superlative rakastur)
kvæntur	Adjective	kvæntur (not comparable)
hljóðlaus	Adjective	hljóðlaus (comparative hljóðlausari, superlative hljóðlausastur)
viðstaddur	Adjective	viðstaddur (not comparable)
grannur	Adjective	grannur (comparative grennri, superlative grennstur)
vestri	Adjective	vestri (comparative, superlative vestastur)
langur	Adjective	langur (comparative lengri, superlative lengstur)
daufur	Adjective	daufur (comparative daufari, superlative daufastur)
átti	Adjective	átti
bjartsýnn	Adjective	bjartsýnn (comparative bjartsýnni, superlative bjartsýnastur)
heilalaus	Adjective	heilalaus (comparative heilalausari, superlative heilalausastur)
alþjóðlegur	Adjective	alþjóðlegur
grimmur	Adjective	grimmur (comparative grimmari, superlative grimmastur)
dauðlegur	Adjective	dauðlegur (comparative dauðlegri, superlative dauðlegastur)
merkur	Adjective	merkur (comparative merkari, superlative merkastur)
vanur	Adjective	vanur (comparative vanari, superlative vanastur)
hryggur	Adjective	hryggur (comparative hryggari, superlative hryggastur)
mikill	Adjective	mikill (comparative meiri, superlative mestur)
errinn	Adjective	errinn (not comparable)
alvarlegur	Adjective	alvarlegur (comparative alvarlegri, superlative alvarlegastur)
lánsamur	Adjective	lánsamur (comparative lánsamari, superlative lánsamastur)
dimmur	Adjective	dimmur (comparative dimmari, superlative dimmastur)
mætur	Adjective	mætur (comparative mætari, superlative mætastur)
fyrst	Adjective	fyrst
æskilegur	Adjective	æskilegur (comparative æskilegri, superlative æskilegastur)
varanlegur	Adjective	varanlegur (comparative varanlegri, superlative varanlegastur)
bráður	Adjective	bráður (comparative bráðari, superlative bráðastur)
fjólublár	Adjective	fjólublár
ræður	Adjective	ræður (comparative ræðari, superlative ræðastur)
hraustur	Adjective	hraustur (comparative hraustari, superlative hraustastur)
ótraustur	Adjective	ótraustur (comparative ótraustari, superlative ótraustastur)
svissneskur	Adjective	svissneskur (comparative svissneskari, superlative svissneskastur)
opinn	Adjective	opinn (comparative opnari, superlative opnastur)
megn	Adjective	megn (comparative megnari, superlative megnastur)
látin	Adjective	látin f
opinskár	Adjective	opinskár (comparative opinskárri, superlative opinskáastur)
ellefti	Adjective	ellefti
japanskur	Adjective	japanskur
fjórtándi	Adjective	fjórtándi
almennur	Adjective	almennur
umtalsverður	Adjective	umtalsverður
löskur	Adjective	löskur (comparative löskari, superlative löskastur)
svartsýnn	Adjective	svartsýnn (comparative svartsýnni, superlative svartsýnastur)
óætur	Adjective	óætur (not comparable)
fróður	Adjective	fróður (comparative fróðari, superlative fróðastur)
fúll	Adjective	fúll (comparative fúlli, superlative fúlastur)
áboginn	Adjective	áboginn (comparative ábognari, superlative ábognastur)
feigur	Adjective	feigur (comparative feigari, superlative feigastur)
gjörvallur	Adjective	gjörvallur (comparative gjörvallari, superlative gjörvallastur)
mildur	Adjective	mildur (comparative mildari, superlative mildastur)
æðislegur	Adjective	æðislegur (comparative æðislegri, superlative æðislegastur)
volgur	Adjective	volgur (comparative volgari, superlative volgastur)
skipgengur	Adjective	skipgengur (comparative skipgengari, superlative skipgengastur)
finnskur	Adjective	finnskur (comparative finnskari, superlative finnskastur)
norrænn	Adjective	norrænn
prúðmannlegur	Adjective	prúðmannlegur (comparative prúðmannlegri, superlative prúðmannlegastur)
heil	Adjective	heil (masculine heill, feminine heil, neuter heilt)
blindur	Adjective	blindur (comparative blindari, superlative blindastur)
hollur	Adjective	hollur (comparative hollari, superlative hollastur)
brattur	Adjective	brattur (comparative brattari, superlative brattastur)
týndur	Adjective	týndur (comparative týndari, superlative týndastur)
þakklátur	Adjective	þakklátur (comparative þakklátari, superlative þakklátastur)
marxískur	Adjective	marxískur (comparative marxískari, superlative marxískastur)
kaldlyndur	Adjective	kaldlyndur (comparative kaldlyndari, superlative kaldlyndastur)
borinn	Adjective	borinn
boginn	Adjective	boginn (comparative bognari, superlative bognastur)
klókur	Adjective	klókur (comparative klókari, superlative klókastur)
hrottalegur	Adjective	hrottalegur (comparative hrottalegri, superlative hrottalegastur)
fern	Adjective	fern
reglulegur	Adjective	reglulegur (comparative reglulegri, superlative reglulegastur)
lipur	Adjective	lipur m, f, lipurt n
ómstríður	Adjective	ómstríður (comparative ómstríðari, superlative ómstríðastur)
hollenskur	Adjective	hollenskur (comparative hollenskari, superlative hollenskastur)
djúpur	Adjective	djúpur (comparative dýpri, superlative dýpstur)
kænn	Adjective	kænn (comparative kænni, superlative kænastur)
dramatískur	Adjective	dramatískur (comparative dramatískari, superlative dramatískastur)
víður	Adjective	víður (comparative víðari, superlative víðastur)
frískur	Adjective	frískur (comparative frískari, superlative frískastur)
samkvæmur	Adjective	samkvæmur (comparative samkvæmari, superlative samkvæmastur)
myrkur	Adjective	myrkur (comparative myrkari, superlative myrkastur)
læs	Adjective	læs (comparative læsari, superlative læsastur)
orðinn	Adjective	orðinn (not comparable) m, orðin f, orðið n
fyndinn	Adjective	fyndinn (comparative fyndnari, superlative fyndnastur)
leiðari	Adjective	leiðari
alþýðlegur	Adjective	alþýðlegur (comparative alþýðlegri, superlative alþýðlegastur)
frjór	Adjective	frjór (comparative frjórri, superlative frjóastur)
fimmtándi	Adjective	fimmtándi
útdauður	Adjective	útdauður (not comparable)
líffræðilegur	Adjective	líffræðilegur (comparative líffræðilegri, superlative líffræðilegastur)
hastarlegur	Adjective	hastarlegur (comparative hastarlegri, superlative hastarlegastur)
ágætur	Adjective	ágætur
skyndilegur	Adjective	skyndilegur (comparative skyndilegri, superlative skyndilegastur)
gildandi	Adjective	gildandi (not comparable)
ógiftur	Adjective	ógiftur
kámugur	Adjective	kámugur (comparative kámugri, superlative kámugastur)
heppinn	Adjective	heppinn (comparative heppnari, superlative heppnastur)
óbundin	Adjective	óbundin
stinnur	Adjective	stinnur (comparative stinnari, superlative stinnastur)
rauður	Adjective	rauður (comparative rauðari, superlative rauðastur)
spánskur	Adjective	spánskur (comparative spánskari, superlative spánskastur)
efnilegur	Adjective	efnilegur (comparative efnilegri, superlative efnilegastur)
tékkneskur	Adjective	tékkneskur
óháður	Adjective	óháður (comparative óháðari, superlative óháðastur)
saltur	Adjective	saltur (comparative saltari, superlative saltastur)
gengur	Adjective	gengur (comparative gengari, superlative gengastur)
þreklaus	Adjective	þreklaus (comparative þreklausari, superlative þreklausastur)
örlítill	Adjective	örlítill (not comparable)
var	Adjective	var (comparative varari, superlative varastur)
vondur	Adjective	vondur (comparative verri, superlative verstur)
allverulegur	Adjective	allverulegur (not comparable)
fimmti	Adjective	fimmti
annar	Adjective	annar
hálfur	Adjective	hálfur (not comparable)
eðlilegur	Adjective	eðlilegur (comparative eðlilegri, superlative eðlilegastur)
fallegur	Adjective	fallegur (comparative fallegri, superlative fallegastur)
ríkur	Adjective	ríkur (comparative ríkari, superlative ríkastur)
óákveðinn	Adjective	óákveðinn (comparative óákveðnari, superlative óákveðnastur)
prússneskur	Adjective	prússneskur (comparative prússneskari, superlative prússneskastur)
heiðblár	Adjective	heiðblár (comparative heiðblárri, superlative heiðbláastur)
loka	Adjective	loka
æður	Adjective	æður (not comparable)
ódauðlegur	Adjective	ódauðlegur (comparative ódauðlegri, superlative ódauðlegastur)
postullegur	Adjective	postullegur
lesblindur	Adjective	lesblindur (comparative lesblindari, superlative lesblindastur)
saurugur	Adjective	saurugur (comparative saurugri, superlative saurugastur)
skír	Adjective	skír (comparative skírri, superlative skírstur) or
skír (comparative skírari, superlative skírastur)
frægur	Adjective	frægur (comparative frægari, superlative frægastur)
tiginn	Adjective	tiginn (comparative tignari, superlative tignastur)
ástfanginn	Adjective	ástfanginn (comparative ástfangnari, superlative ástfangnastur)
auður	Adjective	auður (comparative auðari, superlative auðastur)
nafnlaus	Adjective	nafnlaus (comparative nafnlausari, superlative nafnlausastur)
forn	Adjective	forn (comparative fornari, superlative fornastur)
nokkur	Adjective	nokkur
fín	Adjective	fín
gómsætur	Adjective	gómsætur (comparative gómsætari, superlative gómsætastur)
grænlenskur	Adjective	grænlenskur
kringlóttur	Adjective	kringlóttur (comparative kringlóttari, superlative kringlóttastur)
ber	Adjective	ber (comparative berari, superlative berastur)
bæheimskur	Adjective	bæheimskur
aumur	Adjective	aumur (comparative aumari, superlative aumastur)
strjáll	Adjective	strjáll (comparative strjálli, superlative strjálastur)
stuttur	Adjective	stuttur (comparative styttri, superlative stystur)
niðrandi	Adjective	niðrandi (not comparable)
vandaður	Adjective	vandaður (comparative vandaðri, superlative vandaðastur)
sætur	Adjective	sætur (comparative sætari, superlative sætastur)
góður	Adjective	góður (comparative betri, superlative bestur)
hög	Adjective	hög
heill	Adjective	heill (comparative heilli, superlative heilastur)
þungur	Adjective	þungur (comparative þyngri, superlative þyngstur)
