ауыз	Noun	ауыз • (awız) (nominative plural ауыздар)
балға	Noun	балға • (balğa)
алан	Noun	алан • (alan)
жолбарыс	Noun	жолбарыс • (jolbarıs) (nominative plural жолбарыстар)
бал	Noun	бал • (bal)
ірімшік	Noun	ірімшік • (irimşik) (nominative plural ірімшіктер)
өлім	Noun	өлім • (ölim) (nominative plural өлімдер)
велосипед	Noun	велосипед • (velosïped)
аутизм	Noun	аутизм • (awtïzm)
сағат	Noun	сағат • (sağat)
құлақ	Noun	құлақ • (qulaq) (nominative plural құлақтар)
штат	Noun	штат • (ştat)
дәм	Noun	дәм • (däm) (nominative plural дәмдер)
сарай	Noun	сарай • (saray)
мысық	Noun	мысық • (mısıq) (nominative plural мысықтар)
қырғыз	Noun	қырғыз • (qırğız)
сиыр	Noun	сиыр • (sïır)
ананас	Noun	ананас • (ananas)
жел	Noun	жел • (jel) (nominative plural желдер)
хайуан	Noun	хайуан • (xaywan)
алгоритм	Noun	алгоритм • (algorïtm)
хаж	Noun	хаж • (xaj)
фургон	Noun	фургон • (fwrgon)
көз	Noun	көз • (köz) (nominative plural көздер)
борсық	Noun	борсық • (borsıq)
балта	Noun	балта • (balta)
ам	Noun	ам • (am)
адам	Noun	адам • (adam) (nominative plural адамдар)
білім	Noun	білім • (bilim)
есек	Noun	есек • (esek)
университет	Noun	университет • (wnïversïtet)
хадис	Noun	хадис • (xadïs)
сөз	Noun	сөз • (söz)
аспап	Noun	аспап • (aspap)
тарих	Noun	тарих • (tarïx)
калий	Noun	калий • (kalïy)
минөт	Noun	минөт • (mïnöt)
қанат	Noun	қанат • (qanat)
қабір	Noun	қабір • (qabir) (nominative plural қабірлер)
тас	Noun	тас • (tas)
су	Noun	су • (sw)
уйғур	Noun	уйғур • (wyğwr)
аспан	Noun	аспан • (aspan)
тау	Noun	тау • (taw)
шаш	Noun	шаш • (şaş)
полиция	Noun	полиция • (polïcïya)
динозавр	Noun	динозавр • (dïnozavr)
табан	Noun	табан • (taban)
іңкәр	Noun	іңкәр • (iñkär) (nominative plural іңкәрлер)
сәбіз	Noun	сәбіз • (säbiz)
ұйғыр	Noun	ұйғыр • (uyğır)
имам	Noun	имам • (ïmam)
қазақ	Noun	қазақ • (qazaq)
тіл	Noun	тіл • (til)
аргон	Noun	аргон • (argon)
кеш	Noun	кеш • (keş)
ауыл	Noun	ауыл • (awıl)
король	Noun	король • (korolʹ)
күн	Noun	күн • (kün)
өмір	Noun	өмір • (ömir)
ұшақ	Noun	ұшақ • (uşaq) (nominative plural ұшақтар)
ит	Noun	ит • (ït) (nominative plural иттер)
тұрғын	Noun	тұрғын • (turğın) (nominative plural тұрғындар)
банан	Noun	банан • (banan) (nominative plural банандар)
Үркер	Noun	Үркер • (ürker)
кальмар	Noun	кальмар • (kalʹmar)
қарақ	Noun	қарақ • (qaraq)
сыр	Noun	сыр • (sır) (nominative plural сырлар)
сом	Noun	сом • (som)
кент	Noun	кент • (kent)
жаһаннам	Noun	жаһаннам • (jahannam)
ат	Noun	ат • (at)
жұлдыз	Noun	жұлдыз • (juldız) (nominative plural жұлдыздар)
таң	Noun	таң • (tañ)
мүйіз	Noun	мүйіз • (müyiz)
балық	Noun	балық • (balıq) (nominative plural балықтар)
автобус	Noun	автобус • (avtobws) (nominative plural автобустар)
нан	Noun	нан • (nan)
құс	Noun	құс • (qus) (nominative plural құстар)
поезд	Noun	поезд • (poezd)
құйрық	Noun	құйрық • (quyrıq)
қасқыр	Noun	қасқыр • (qasqır) (nominative plural қасқырлар)
азан	Noun	азан • (azan)
педагогика	Noun	педагогика • (pedagogïka) f
кисель	Noun	кисель • (kïselʹ)
шкаф	Noun	шкаф • (şkaf)
үй	Noun	үй • (üy) (nominative plural үйлер)
дин	Noun	дин • (dïn)
тұлық	Noun	тұлық • (tulıq)
қыпшақ	Noun	қыпшақ • (qıpşaq)
хат	Noun	хат • (xat)
секунд	Noun	секунд • (sekwnd)
бала	Noun	бала • (bala) (nominative plural балалар)
