кӱмӱс	Noun	кӱмӱс • (kümüs)
сан	Noun	сан • (san)
алтын	Noun	алтын • (altın)
алабарыс	Noun	алабарыс • (alabarıs)
сыын	Noun	сыын • (sıın)
тимір	Noun	тимір • (timír)
пуға	Noun	пуға • (puğa)
чазы	Noun	чазы • (çazı)
ӱстінзарых	Noun	ӱстінзарых • (üstínzarıx)
харағай	Noun	харағай • (xarağay)
порсых	Noun	порсых • (porsıx)
тайға	Noun	тайға • (tayğa)
кӧрік	Noun	кӧрік • (kӧrík)
пӱӱр	Noun	пӱӱр • (püür)
пуғдай	Noun	пуғдай • (puğday)
пасха	Noun	пасха • (pasxa)
суғ	Noun	суғ • (suğ)
наңмыр	Noun	наңмыр • (nañmır)
сабын	Noun	сабын • (sabın)
інек	Noun	інек • (ínek)
тибе	Noun	тибе • (tibe)
тигір	Noun	тигір • (tigír)
талай	Noun	талай • (talay)
тағ	Noun	тағ • (tağ)
чылтыс	Noun	чылтыс • (çıltıs)
ағас	Noun	ағас • (ağas)
им	Noun	им • (im)
ӧрке	Noun	ӧрке • (ӧrke)
кӱзен	Noun	кӱзен • (küzen)
часхы	Noun	часхы • (çasxı)
сӧс	Noun	сӧс • (sӧs)
хамнос	Noun	хамнос • (xamnos)
кас	Noun	кас • (kas)
кас	Noun	кас • (kas)
ит	Noun	ит • (it)
ит	Noun	ит • (it)
ит	Noun	ит • (it)
алтынзарых	Noun	алтынзарых • (altınzarıx)
тарбаған	Noun	тарбаған • (tarbağan)
тӱн	Noun	тӱн • (tün)
ир	Noun	ир • (ir)
парыс	Noun	парыс • (parıs)
тіл	Noun	тіл • (tíl)
хуча	Noun	хуча • (xuça)
іскер	Noun	іскер • (ísker)
табах	Noun	табах • (tabax)
хан	Noun	хан • (xan)
адай	Noun	адай • (aday)
аба	Noun	аба • (aba)
пус	Noun	пус • (pus)
кізі	Noun	кізі • (kízí)
тас	Noun	тас • (tas)
оо	Noun	оо • (oo)
хузурух	Noun	хузурух • (xuzurux)
иней	Noun	иней • (iney)
хар	Noun	хар • (xar)
кір	Noun	кір • (kír)
тиин	Noun	тиин • (tiin)
хара хурт	Noun	хара хурт • (xara xurt)
тӱлгӱ	Noun	тӱлгӱ • (tülgü)
азах	Noun	азах • (azax)
сосха	Noun	сосха • (sosxa)
хозан	Noun	хозан • (xozan)
киндір	Noun	киндір • (kindír)
кӧл	Noun	кӧл • (kӧl)
хул	Noun	хул • (xul)
молат	Noun	молат • (molat)
чил	Noun	чил • (çil)
иир	Noun	иир • (iir)
пулут	Noun	пулут • (pulut)
пӧрік	Noun	пӧрік • (pӧrík)
кӱн	Noun	кӱн • (kün)
чис	Noun	чис • (çis)
тирек	Noun	тирек • (tirek)
хоосха	Noun	хоосха • (xoosxa)
кӱскӱ	Noun	кӱскӱ • (küskü)
чылан	Noun	чылан • (çılan)
саң	Noun	саң • (sañ)
тамыр	Noun	тамыр • (tamır)
чар	Noun	чар • (çar)
чайғы	Noun	чайғы • (çayğı)
мылтых	Noun	мылтых • (mıltıx)
хум	Noun	хум • (xum)
хымысха	Noun	хымысха • (xımısxa)
чон	Noun	чон • (çon)
сағат	Noun	сағат • (sağat)
хысхы	Noun	хысхы • (xısxı)
сас	Noun	сас • (sas)
кидер	Noun	кидер • (kider)
палых	Noun	палых • (palıx)
