magistrat	Noun	magistrat m (plural magistrac)
republica	Noun	republica (f republicas)
referendums	Noun	referendums
fantom	Noun	fantom
basa	Noun	basa m (plural [please provide]) 
oma	Noun	oma f (plural omans)
amnestia	Noun	amnestia f (plural amnesties)
mandat	Noun	mandat m (plural mandac)
genitor	Noun	genitor m (plural genitores)
ambient	Noun	ambient m (plural ambienc)
ora	Noun	ora f (plural ores)
vita	Noun	vita f (plural vites)
pena	Noun	pena f (plural penes)
ena	Noun	ena f (plural enes)
lege	Noun	lege m (plural leges)
statut	Noun	statut m (plural statuc)
cultura	Noun	cultura f (plural [please provide])
fond	Noun	fond m (plural fonds)
caia	Noun	caia f
vint	Noun	vint m (uncountable)
senator	Noun	senator f (plural senatores)
comes	Noun	comes
ecosistem	Noun	ecosistem f (plural ecosistems)
mort	Noun	mort f (plural mortes)
tiera	Noun	tiera f (plural tieres)
coma	Noun	coma f (plural comes)
fin	Noun	fin m (plural fins)
propaganda	Noun	propaganda f (plural propagandes)
moda	Noun	moda f (plural modes)
stipendium	Noun	stipendium m (plural stipendiums)
sistem	Noun	sistem m (plural sistems)
norma	Noun	norma f (plural normes)
data	Noun	data f (plural dates)
test	Noun	test m (plural [please provide])
valor	Noun	valor m (plural valores)
dependent	Noun	dependent m (plural dependenc)
opera	Noun	opera f (plural operes)
set	Noun	set m (uncountable)
lim	Noun	lim m (plural lims)
aga	Noun	aga f (plural [please provide])
port	Noun	port m (plural porc)
ben	Noun	ben m (plural bens)
vender	Noun	vender m (plural vendres)
tera	Noun	tera f (plural teres)
natura	Noun	natura f (plural natures)
at	Noun	at m (plural ac)
ani	Noun	ani
resultat	Noun	resultat m (plural resultac)
categoria	Noun	categoria f (plural categories)
cont	Noun	cont m (plural conc)
cont	Noun	cont m (plural conc, plural conts, feminine contessa, feminine plural contesses)
parlament	Noun	parlament m (plural parlaments) (often capitalised)
fal	Noun	fal m (plural fai)
referendum	Noun	referendum m (plural referendums)
feria	Noun	feria f (plural feries)
president	Noun	president m (plural presidenc)
mira	Noun	mira f (plural mires)
vela	Noun	vela f (plural veles)
pert	Noun	pert f (plural pertes)
popul	Noun	popul m (plural populi)
fat	Noun	fat m (plural fac)
un	Noun	un m (uncountable)
raport	Noun	raport f (plural raporc)
avocat	Noun	avocat m (plural avocac)
minister	Noun	minister m (plural ministeres)
orden	Noun	orden m (plural ordens)
dì	Noun	dì m (plural dis)
program	Noun	program m (plural programs)
trei	Noun	trei m (uncountable)
materia	Noun	materia f (plural materies)
stat	Noun	stat m (plural stac)
november	Noun	november m (plural novembers)
grupa	Noun	grupa f (plural grupes)
parola	Noun	parola f (plural paroles)
religion	Noun	religion m (plural [please provide])
academia	Noun	academia f (plural academies)
mil	Noun	mil ? (plural [please provide])
gloria	Noun	gloria f (plural glories)
forma	Noun	forma f (plural formes)
monopol	Noun	monopol m (plural monopoi)
termin	Noun	termin m (plural termini)
an	Noun	an m (plural ani)
ert	Noun	ert m (plural erc)
ac	Noun	ac
festa	Noun	festa f (plural festes)
atentat	Noun	atentat m (plural atentac)
titul	Noun	titul m (plural tituli)
cura	Noun	cura f (plural cures)
leges	Noun	leges
numer	Noun	numer m (plural numers)
decret	Noun	decret m (plural decrec)
dat	Noun	dat m (plural dac)
porc	Noun	porc
camera	Noun	camera f (plural cameres)
veles	Noun	veles
metoda	Noun	metoda f (plural metodes)
region	Noun	region f (plural regions)
familia	Noun	familia f (plural families)
raion	Noun	raion m (plural raions)
ot	Noun	ot m (uncountable)
apel	Noun	apel m (plural apels)
stampa	Noun	stampa f (plural stampes)
magistratura	Noun	magistratura f (plural magistratures)
tribunal	Noun	tribunal m (plural tribunai)
mont	Noun	mont m (plural monts)
persona	Noun	persona f (plural persones)
senat	Noun	senat m (plural senac)
aeroport	Noun	aeroport m (plural aeroporc)
mens	Noun	mens m (plural mensc)
rest	Noun	rest m (plural resc)
dac	Noun	dac
zebra	Noun	zebra f (plural zebres)
autonomia	Noun	autonomia f (plural autonomies)
valuta	Noun	valuta f (plural valutes)
creta	Noun	creta f (plural cretes)
man	Noun	man f (plural mans)
part	Noun	part f (plural part)
dis	Noun	dis
ent	Noun	ent m (plural enc)
viera	Noun	viera f (plural viers)
otanta	Noun	otanta m (uncountable)
erma	Noun	erma f (plural ermes)
materies	Noun	materies
nuef	Noun	nuef m (uncountable)
cater	Noun	cater m (uncountable)
ejams	Noun	ejams
usc	Noun	usc m (plural usc)
aa	Noun	aa f (plural [please provide])
energia	Noun	energia f (plural energies)
mut	Noun	mut m (plural muts)
rata	Noun	rata f (plural rates)
mans	Noun	mans
roa	Noun	roa f (plural [please provide])
disciplina	Noun	disciplina f (plural disciplines)
