astan	Noun	astan f (genitive singular astan, plural astanyn)
roie	Noun	roie m (genitive singular roie, plural roiaghyn)
roie	Noun	roie m (genitive singular roie, plural roieyn)
ark	Noun	ark f (genitive singular arkagh, plural arkyn or irk)
beinn	Noun	beinn m (genitive singular beinnee, plural beinnyn or binn)
slug	Noun	slug m (genitive singular slug, plural sluggyn)
joan	Noun	joan m (genitive singular [please provide], plural [please provide])
soo	Noun	soo m (genitive singular [please provide], plural [please provide])
soo	Noun	soo m (genitive singular soo, plural sooghyn)
bolg	Noun	bolg m (genitive singular bolgey or bolgagh, plural builg)
ard	Noun	ard m (genitive singular [please provide], plural [please provide])
ard	Noun	ard m (genitive singular ard, plural ardjyn)
broc	Noun	broc m (genitive singular [please provide], plural [please provide])
mac	Noun	mac m (genitive singular mic, plural mec)
rass	Noun	rass m (genitive singular resh)
glass	Noun	glass m (genitive singular glish or gleish, plural glish or gleish)
aile	Noun	aile m (genitive singular ailey)
blass	Noun	blass m (genitive singular blass, plural blassyn)
castan	Noun	castan m (genitive singular [please provide], plural [please provide])
brein	Noun	brein f (genitive singular breinney)
gey	Noun	gey m
streng	Noun	streng f (genitive singular streng, plural strengyn)
kay	Noun	kay f (genitive singular kay, plural kayghyn)
bee	Noun	bee m (genitive singular bee, plural beeghyn)
feill	Noun	feill f (genitive singular foalley, no plural)
soar	Noun	soar m (genitive singular [please provide], plural [please provide])
doon	Noun	doon m (genitive singular doon, plural doonyn)
bock	Noun	bock m (genitive singular bock, plural buick)
ferg	Noun	ferg f (genitive singular [please provide], plural [please provide])
pian	Noun	pian f (genitive singular [please provide], plural [please provide])
block	Noun	block m (genitive singular bluick)
fa	Noun	fa m (genitive singular [please provide], plural [please provide])
laad	Noun	laad m (genitive singular [please provide], plural [please provide])
cair	Noun	cair f (genitive singular [please provide], plural [please provide])
umber	Noun	umber m (genitive singular [please provide], plural [please provide])
king	Noun	king m
ainle	Noun	ainle (plural ainleyn)
gay	Noun	gay f
mee	Noun	mee f (genitive singular ?, plural meeghyn)
fakin	Noun	fakin m (genitive singular [please provide], plural [please provide])
çherraghtaght	Noun	çherraghtaght f (genitive singular [please provide], plural [please provide])
bea	Noun	bea f (genitive singular [please provide], plural [please provide])
red	Noun	red m (genitive singular red, plural reddyn)
aer	Noun	aer f
fer	Noun	fer m (plural fir)
birling	Noun	birling f (genitive singular birling, plural birleeyn)
edd	Noun	edd m (genitive singular idd)
egin	Noun	egin m
troar	Noun	troar m (genitive singular ?, plural troaryn)
blein	Noun	blein f (genitive singular bleeaney, plural bleeantyn)
baa	Noun	baa f
mair	Noun	mair f (genitive singular mair, plural meir)
rub	Noun	rub m (genitive singular rub, plural rubbyn)
argon	Noun	argon m (genitive singular [please provide], plural [please provide])
rea	Noun	rea m (genitive singular rea, plural reaghyn)
muc	Noun	muc f (genitive singular muickey or muigey, plural mucyn or muckyn or muick)
thie	Noun	thie m (genitive singular thie, plural thieyn)
abb	Noun	abb m (genitive singular abb, plural abbyn)
gant	Noun	gant m (genitive singular [please provide], plural [please provide])
shee	Noun	shee m (genitive singular shee, plural sheeghyn)
corp	Noun	corp m (genitive singular kirpey, plural kirp)
arm	Noun	arm m (genitive singular arm, plural armyn)
grian	Noun	grian f (genitive singular greiney, plural grianyn)
altar	Noun	altar m (plural altaryn)
punt	Noun	punt m (genitive singular punt, plural puint)
side	Noun	side f (genitive singular sidey, plural sideyn)
oranje	Noun	oranje f (genitive singular oranje, plural oranjeyn)
cost	Noun	cost m (genitive singular cost, plural costyn)
teks	Noun	teks m (genitive singular teks, plural teksyn)
fine	Noun	fine f
blod	Noun	blod m (genitive singular [please provide], plural [please provide])
oaie	Noun	oaie f (genitive singular oaie, plural oaieghyn)
oaie	Noun	oaie m (genitive singular oaie, plural oaieyn)
tonn	Noun	tonn f (genitive singular [please provide], plural [please provide])
dragan	Noun	dragan m (genitive singular dragan, plural draganyn)
umlaut	Noun	umlaut m (genitive singular umlaut, plural umlautyn)
mill	Noun	mill m (genitive singular molley, plural millyn)
cah	Noun	cah m (genitive singular [please provide], plural [please provide])
lus	Noun	lus m (genitive singular lus, plural lussyn)
penn	Noun	penn m (genitive singular penney, plural pennyn)
baar	Noun	baar m (genitive singular baar, plural baaryn)
agh	Noun	agh m (genitive singular agh, plural aghyn)
faill	Noun	faill f (genitive singular faillee)
jees	Noun	jees f (genitive singular [please provide], plural [please provide])
sorn	Noun	sorn m (genitive singular sorn)
bard	Noun	bard m (genitive singular ?, plural bardyn)
van	Noun	van f (genitive singular van, plural vannyn)
coip	Noun	coip m (genitive singular coip, plural coipyn)
tead	Noun	tead m (genitive singular tead, plural teaddyn)
snooker	Noun	snooker m (genitive singular [please provide], plural [please provide])
ben	Noun	ben f (genitive singular mreih, plural mraane)
brod	Noun	brod m (genitive singular brod, plural brodyn)
suim	Noun	suim f (genitive singular [please provide], plural [please provide])
lann	Noun	lann f (genitive singular lann, plural lannyn)
vertebra	Noun	vertebra f (genitive singular vertebra, plural vertebraghyn)
muir	Noun	muir f (genitive singular marrey, plural muiraghyn)
puint	Noun	puint m pl
gitar	Noun	gitar m (genitive singular [please provide], plural [please provide])
folt	Noun	folt m (genitive singular fuilt, plural fuilt)
