kuram	Noun	kuram (using Raguileo Alphabet)
kuku	Noun	kuku (using Raguileo Alphabet)
maci	Noun	maci (using Raguileo Alphabet)
miski	Noun	miski (using Raguileo, Azümchefe and Unified Alphabets)
kure	Noun	kure (using Raguileo Alphabet)
mangel	Noun	mangel (using Unified Alphabet)
piru	Noun	piru (using Raguileo Alphabet)
titi	Noun	titi (using Raguileo Alphabet)
mogen	Noun	mogen (using Raguileo Alphabet)
ule	Noun	ule (using Raguileo Alphabet)
foye	Noun	foye (using Raguileo Alphabet)
guru	Noun	guru (using Raguileo Alphabet)
kura	Noun	kura (using Raguileo Alphabet)
runa	Noun	runa (using Raguileo Alphabet)
kara	Noun	kara (using Raguileo Alphabet)
foro	Noun	foro (using Raguileo Alphabet)
toki	Noun	toki (using Raguileo Alphabet)
kutri	Noun	kutri (using Unified Alphabet)
patu	Noun	patu (using Raguileo Alphabet)
ayvn	Noun	ayvn (using Raguileo Alphabet)
ke	Noun	ke (using Raguileo Alphabet)
korv	Noun	korv (using Raguileo Alphabet)
ilo	Noun	ilo (using Raguileo Alphabet)
luku	Noun	luku (using Raguileo Alphabet)
ruka	Noun	ruka (using Raguileo Alphabet)
fena	Noun	fena (using Unified Alphabet)
lemu	Noun	lemu (m)
challa	Noun	challa (using Unified Alphabet)
mara	Noun	mara (using Raguileo Alphabet)
lof	Noun	lof
wili	Noun	wili (using Raguileo Alphabet)
funa	Noun	funa (using Unified Alphabet)
werken	Noun	werken (using Raguileo Alphabet)
vy	Noun	vy (using Raguileo Alphabet)
puh	Noun	puh (using Raguileo Alphabet)
are	Noun	are (using Raguileo Alphabet)
kapi	Noun	kapi (using Raguileo Alphabet)
filu	Noun	filu (using Unified Alphabet and Raguileo alphabet)
ko	Noun	ko (using Raguileo Alphabet)
age	Noun	age (using Raguileo Alphabet)
az	Noun	az (using Raguileo Alphabet)
ako	Noun	ako (using Raguileo, Unified and Azümchefe Alphabets)
defe	Noun	defe (using Unified Alphabet)
voro	Noun	voro (using Raguileo Alphabet)
ge	Noun	ge (using Raguileo Alphabet)
waka	Noun	waka (using Raguileo Alphabet)
alka	Noun	alka (using Raguileo Alphabet)
pagi	Noun	pagi (using Raguileo Alphabet)
malle	Noun	malle (using Unified Alphabet)
ban	Noun	ban (using Raguileo Alphabet)
