bił	Noun	bił
tsiiyéél	Noun	tsiiyéél
inchxǫ́ʼí	Noun	inchxǫ́ʼí
gad	Noun	gad
atʼééd	Noun	atʼééd (plural atʼééké)
íígąsh	Noun	íígąsh
hai	Noun	hai
chin	Noun	chin
atsʼiil	Noun	atsʼiil
ataaʼ	Noun	ataaʼ
bitsiiʼ	Noun	bitsiiʼ
achʼozh	Noun	achʼozh
atʼaʼ	Noun	atʼaʼ
alzį́į́h	Noun	alzį́į́h
atsóí	Noun	atsóí (plural atsóóké)
ánííʼ	Noun	ánííʼ
diyin	Noun	diyin
atsiighaʼ	Noun	atsiighaʼ
ntsáhákees	Noun	ntsáhákees
bijaaʼ	Noun	bijaaʼ
ayaatsʼiin	Noun	ayaatsʼiin
bikeeʼ	Noun	bikeeʼ
ákʼaʼí	Noun	ákʼaʼí
azhiʼ	Noun	azhiʼ
shá	Noun	shá
azhéʼé	Noun	azhéʼé
adeezhí	Noun	adeezhí
chʼiyáán	Noun	chʼiyáán (possessed form chʼiyąʼ)
átsą́ą́ʼ	Noun	átsą́ą́ʼ
ánéeltʼeʼ	Noun	ánéeltʼeʼ
bikin	Noun	bikin
hayeʼ	Noun	hayeʼ (plural hayeʼke)
bizaad	Noun	bizaad
akaiʼ	Noun	akaiʼ
iiná	Noun	iiná (possessed form beʼiinaʼ)
ajáád	Noun	ajáád
atsiitsʼiin	Noun	atsiitsʼiin
hééł	Noun	hééł (possessed form biyéél)
akézhoozh	Noun	akézhoozh
haniiʼ	Noun	haniiʼ
sih	Noun	sih
azis	Noun	azis
anákʼee	Noun	anákʼee
áłchíní	Noun	áłchíní
ké	Noun	ké (possessed form bikeeʼ)
shikąʼ	Noun	shikąʼ
álátłʼááh	Noun	álátłʼááh
atiin	Noun	atiin
adáʼi	Noun	adáʼi
hataał	Noun	hataał
tin	Noun	tin
bíniʼ	Noun	bíniʼ
dził	Noun	dził (combining form dziil)
achoʼ	Noun	achoʼ
yá	Noun	yá
shíniʼ	Noun	shíniʼ
heeneez	Noun	heeneez
átááʼ	Noun	átááʼ
binááʼ	Noun	binááʼ
amásání	Noun	amásání
ayid	Noun	ayid
acheii	Noun	acheii
akʼah	Noun	akʼah
cha	Noun	cha
ajéí	Noun	ajéí
áʼázhoozh	Noun	áʼázhoozh
hagaan	Noun	hagaan
azází	Noun	azází
chąąʼ	Noun	chąąʼ (possessed form bichaan)
ashkii	Noun	ashkii (plural ashiiké, ashkiikéyóó, possessed form beʼashkii)
bis	Noun	bis
achʼoozhlaaʼ	Noun	achʼoozhlaaʼ
ajóózh	Noun	ajóózh
álátsíín	Noun	álátsíín
siláo	Noun	siláo
ajéídíshjool	Noun	ajéídíshjool
gish	Noun	gish
atłʼeh	Noun	atłʼeh
achʼííʼ	Noun	achʼííʼ
yoołkááł	Noun	yoołkááł
azhí	Noun	azhí
ayih	Noun	ayih
anághah	Noun	anághah
ásaaʼ	Noun	ásaaʼ (possessed form beʼésaʼ)
akʼis	Noun	akʼis (plural akʼisóó)
akʼǫ́ǫ́ʼ	Noun	akʼǫ́ǫ́ʼ
adaaʼ	Noun	adaaʼ
shiʼáád	Noun	shiʼáád
shijaaʼ	Noun	shijaaʼ
ajaaʼ	Noun	ajaaʼ
haʼaʼaah	Noun	haʼaʼaah
análí hastiin	Noun	análí hastiin
bikʼos	Noun	bikʼos
biyáázh	Noun	biyáázh
bitsóóké	Noun	bitsóóké pl
atsiin	Noun	atsiin
hatsʼíís	Noun	hatsʼíís
kʼaasdá	Noun	kʼaasdá (possessive form bikʼaasdaʼ)
iishchʼid	Noun	iishchʼid
tseeʼé	Noun	tseeʼé
agąąstsiin	Noun	agąąstsiin
atsilí	Noun	atsilí (plural atsilíkéyóó)
das	Noun	das
bíígháán	Noun	bíígháán
naʼachʼąąh	Noun	naʼachʼąąh
ééʼ	Noun	ééʼ
daan	Noun	daan
akétal	Noun	akétal
bighan	Noun	bighan (plural dabighan)
atsą́	Noun	atsą́
hakeeʼ	Noun	hakeeʼ
atsooskʼid	Noun	atsooskʼid
naʼnitin	Noun	naʼnitin
azaʼazis	Noun	azaʼazis
atéél	Noun	atéél
áláyáázh	Noun	áláyáázh
bízhiʼ	Noun	bízhiʼ
níłchʼi	Noun	níłchʼi
tó	Noun	tó (possessed form -toʼ, prefixal form tá-)
azooł	Noun	azooł
azágí	Noun	azágí
hachʼoozhlaaʼ	Noun	hachʼoozhlaaʼ
sęęs	Noun	sęęs (possessed form: bizęęs)
azid	Noun	azid
akéshgaan	Noun	akéshgaan (inalienable)
análí asdzą́ą́	Noun	análí asdzą́ą́
bitseeʼ	Noun	bitseeʼ
atsʼos	Noun	atsʼos
atsįʼ	Noun	atsįʼ
níyol	Noun	níyol
adeeʼ	Noun	adeeʼ
atsʼóóz	Noun	atsʼóóz
aniitsįʼ	Noun	aniitsįʼ
amá	Noun	amá
aʼáád	Noun	aʼáád (plural aʼááké)
anáziz	Noun	anáziz
hatsʼin	Noun	hatsʼin
iichʼąh	Noun	iichʼąh
akʼéí	Noun	akʼéí (plural akʼéíyóó)
hózhǫ́	Noun	hózhǫ́
hatsiiʼ	Noun	hatsiiʼ
hagod	Noun	hagod
achʼooní	Noun	achʼooní
íígháán	Noun	íígháán
siil	Noun	siil
hálátsíín	Noun	hálátsíín
łitso	Noun	łitso
abid	Noun	abid
álázhoozh	Noun	álázhoozh
deezʼá	Noun	deezʼá
nástłʼah	Noun	nástłʼah (plural ńdaastłʼah)
hahoodzo	Noun	hahoodzo
atʼoh	Noun	atʼoh
dootłʼizh	Noun	dootłʼizh
ííshgháán	Noun	ííshgháán
hatłʼaaʼ	Noun	hatłʼaaʼ
habid	Noun	habid
tsíłkę́ę́h	Noun	tsíłkę́ę́h (possessed form bitsíłkęʼ, plural tsíłkéí, tsíłkéyóó)
aziz	Noun	aziz
ootsą́	Noun	ootsą́
azééʼ	Noun	azééʼ
názbąs	Noun	názbąs
aadaaní	Noun	aadaaní
shilah	Noun	shilah
tłʼaakał	Noun	tłʼaakał
béésh	Noun	béésh (possessed form bibéézh)
álátsoh	Noun	álátsoh
ajéítsʼiin	Noun	ajéítsʼiin
joobaʼ	Noun	joobaʼ (possessed form bijoobaʼ)
dilkʼis	Noun	dilkʼis
kéyah	Noun	kéyah (plural kédaayah)
awótsįʼ	Noun	awótsįʼ
agod	Noun	agod
akétsíín	Noun	akétsíín
agaan	Noun	agaan (compound forms gąą-, gą-, gan-)
atʼąąʼ	Noun	atʼąąʼ
achʼéʼé	Noun	achʼéʼé (plural achʼéʼéké)
łichííʼ	Noun	łichííʼ
ayęęzhii	Noun	ayęęzhii
dziil	Noun	dziil
awol	Noun	awol
dzígai	Noun	dzígai
atʼog	Noun	atʼog
sin	Noun	sin (possessed form biyiin)
akʼos	Noun	akʼos
anááʼ	Noun	anááʼ
ákáshtłʼo	Noun	ákáshtłʼo
naalté	Noun	naalté
alohkʼeʼ	Noun	alohkʼeʼ
anádiz	Noun	anádiz
sáanii	Noun	sáanii pl (singular asdzą́ą́)
adoh	Noun	adoh
awos	Noun	awos
aghaaʼ	Noun	aghaaʼ
séí	Noun	séí
iinééʼ	Noun	iinééʼ
hajáád	Noun	hajáád
sǫʼ	Noun	sǫʼ (possessed form bizǫʼ)
atélí	Noun	atélí
akeeʼ	Noun	akeeʼ
naaltsoos	Noun	naaltsoos
análí	Noun	análí (plural análíké)
anííʼ	Noun	anííʼ
hakétsíín	Noun	hakétsíín
sis	Noun	sis (possessed form -ziiz)
sis	Noun	sis
abeʼ	Noun	abeʼ
dinééh	Noun	dinééh
achó	Noun	achó
ayol	Noun	ayol
-god	Noun	-god (inalienable)
hadoh	Noun	hadoh
hooghan	Noun	hooghan
disxǫs	Noun	disxǫs
náhookǫs	Noun	náhookǫs
áláshgaan	Noun	áláshgaan
akágí	Noun	akágí
bigaan	Noun	bigaan
hákʼaʼí	Noun	hákʼaʼí
názhah	Noun	názhah
beeldléí	Noun	beeldléí
łeetsʼaaʼ	Noun	łeetsʼaaʼ (possessed form biłeetsʼaʼ)
ahaʼdeetʼaah	Noun	ahaʼdeetʼaah
bikétsíín	Noun	bikétsíín
łį́į́ʼ	Noun	łį́į́ʼ (possessed form bilį́į́ʼ)
amáyázhí	Noun	amáyázhí
álátah	Noun	álátah
atseeʼ	Noun	atseeʼ
ajilchiiʼ	Noun	ajilchiiʼ
ih	Noun	ih
aghą́ą́ʼ	Noun	aghą́ą́ʼ
aniiʼ	Noun	aniiʼ
bílaʼ	Noun	bílaʼ
akąʼ	Noun	akąʼ
ajástis	Noun	ajástis
aháshtʼóózh	Noun	aháshtʼóózh
sid	Noun	sid (possessed form bizid)
sikʼis	Noun	sikʼis (plural sikʼisóó)
hálaʼ	Noun	hálaʼ
ałnííʼ	Noun	ałnííʼ (possessed form beʼałnííʼ)
naʼatłʼoʼ	Noun	naʼatłʼoʼ
ił	Noun	ił (possessed form biʼiil)
sho	Noun	sho
his	Noun	his
awóchiiʼ	Noun	awóchiiʼ
anázhiin	Noun	anázhiin
hakʼéí	Noun	hakʼéí (plural hakʼéíyóó)
áhátʼį́	Noun	áhátʼį́
atsʼin	Noun	atsʼin
atłʼaaʼ	Noun	atłʼaaʼ
nádleeh	Noun	nádleeh
álaʼ	Noun	álaʼ
ániʼ	Noun	ániʼ
dághá	Noun	dághá (possessed form bidághaa’)
bighaaʼ	Noun	bighaaʼ
níbaal	Noun	níbaal
azǫ́ǫ́z	Noun	azǫ́ǫ́z
anágaii	Noun	anágaii
áchį́į́h	Noun	áchį́į́h
amá sání	Noun	amá sání
atah	Noun	atah
hánaaí	Noun	hánaaí
atsékʼee	Noun	atsékʼee
adáyiʼ	Noun	adáyiʼ
tłʼaajįʼééʼ	Noun	tłʼaajįʼééʼ
shoh	Noun	shoh
alah	Noun	alah (plural alahké)
yaaʼ	Noun	yaaʼ (possessed form biyaʼ)
hashké	Noun	hashké
abízhí	Noun	abízhí
atsiiʼ	Noun	atsiiʼ
akááz	Noun	akááz
ánaaí	Noun	ánaaí
hatsiʼ	Noun	hatsiʼ
saad	Noun	saad (possessed form bizaad)
awooʼ	Noun	awooʼ
azeedí	Noun	azeedí
bízháneeʼ	Noun	bízháneeʼ
atsʼíís	Noun	atsʼíís
łéʼéyázhí	Noun	łéʼéyázhí
biyeʼ	Noun	biyeʼ (plural biyeʼke)
yoolééł	Noun	yoolééł
atsooʼ	Noun	atsooʼ
kin	Noun	kin
atságah	Noun	atságah
azháʼáád	Noun	azháʼáád
bizis	Noun	bizis
anátʼéézh	Noun	anátʼéézh
bijáád	Noun	bijáád
álánééz	Noun	álánééz
yistłé	Noun	yistłé
atsiʼ	Noun	atsiʼ (plural atsiʼké)
eʼeʼaah	Noun	eʼeʼaah
atsʼééʼ	Noun	atsʼééʼ
hakʼos	Noun	hakʼos
chidí	Noun	chidí
