polka	Noun	polka f (plural polkas)
bel	Noun	bel m (plural bels)
consul	Noun	consul m (plural consuls)
bombe	Noun	bombe f (plural bombes)
sonde	Noun	sonde f (plural sondes)
bombardement	Noun	bombardement m (plural bombardements)
ris	Noun	ris m (plural ris)
lavabo	Noun	lavabo m (plural lavabos)
hangar	Noun	hangar m (plural hangars)
air	Noun	air m (plural airs)
faux	Noun	faux f (plural faux)
galaxie	Noun	galaxie f (plural galaxies)
us	Noun	us m (plural us)
pyjamas	Noun	pyjamas m pl
tus	Noun	tus m (plural tuss)
aspi	Noun	aspi m (plural aspis)
bolle	Noun	bolle f (plural bolles)
filot	Noun	filot m (plural filots)
vase	Noun	vase m (plural vases)
chanson	Noun	chanson f (plural chansons)
quèrre	Noun	quèrre m (plural quèrres)
cormoran	Noun	cormoran m (plural cormorans)
ragoût	Noun	ragoût m (plural ragoûts)
as	Noun	as m (plural as)
pot	Noun	pot m (plural pots)
penni	Noun	penni m (plural pennis)
bandage	Noun	bandage m (plural bandages)
proposition	Noun	proposition f (plural propositions)
tuile	Noun	tuile f (plural tuiles)
co	Noun	co m (plural cos)
co	Noun	co m (plural cos)
co	Noun	co m (plural cos)
filet	Noun	filet m (plural filets)
gars	Noun	gars m (plural gars)
ail	Noun	ail m (uncountable)
adresse	Noun	adresse f (plural adresses)
frigo	Noun	frigo m (plural frigos)
whisky	Noun	whisky m (plural whiskys)
trafi	Noun	trafi m (uncountable)
gallon	Noun	gallon m (plural gallons)
lait	Noun	lait m (plural laits)
faer	Noun	faer m (uncountable)
raz	Noun	raz m (plural raz)
sport	Noun	sport m (plural sports)
bandit	Noun	bandit m (plural bandits)
rande	Noun	rande f (plural randes)
sort	Noun	sort m (plural sorts)
mar	Noun	mar f (plural mars)
man	Noun	man f (plural mans)
papier	Noun	papier m (plural papiers)
dogme	Noun	dogme m (plural dogmes)
fort	Noun	fort m (plural forts)
cat	Noun	cat m (plural cats, feminine catte)
gant	Noun	gant m (plural gants)
avocat	Noun	avocat m (plural avocats)
avocat	Noun	avocat m (plural avocats)
me	Noun	me f (plural mes)
fax	Noun	fax m (plural fax)
rose	Noun	rose f (plural roses)
lundi	Noun	lundi m (plural lundis)
café	Noun	café m (plural cafés)
mousse	Noun	mousse m (plural mousses)
mousse	Noun	mousse m, f (plural mousses)
cannabis	Noun	cannabis m (uncountable)
fain	Noun	fain m (uncountable)
alysson	Noun	alysson m (uncountable)
mission	Noun	mission f (plural missions)
futur	Noun	futur m (plural futurs)
sang	Noun	sang m (uncountable)
rat	Noun	rat m (plural rats)
tro	Noun	tro m (plural tros)
page	Noun	page f (plural pages)
gens	Noun	gens m pl
su	Noun	su m (uncountable)
bro	Noun	bro m (plural bros)
mielle	Noun	mielle f (plural mielles)
monument	Noun	monument m (plural monuments)
salon	Noun	salon m (plural salons)
magnolia	Noun	magnolia m (plural magnolias)
lit	Noun	lit m (plural lits)
trappe	Noun	trappe f (plural trappes)
veste	Noun	veste f (plural vestes)
brie	Noun	brie f (plural bries)
rapport	Noun	rapport m (plural rapports)
bür	Noun	bür m (plural bürs)
meule	Noun	meule f (plural meules)
lot	Noun	lot m (plural lots)
tante	Noun	tante f (plural tantes)
lampion	Noun	lampion m (plural lampions)
milan	Noun	milan m (plural milans)
patte	Noun	patte f (plural pattes)
kilo	Noun	kilo m (plural kilos)
mur	Noun	mur m (plural murs)
sabbat	Noun	sabbat m (plural sabbats)
sofa	Noun	sofa m (plural sofas)
fo	Noun	fo m (plural fos)
vol	Noun	vol m (plural vols)
garage	Noun	garage m (plural garages)
abbé	Noun	abbé m (plural abbés)
mort	Noun	mort f (plural morts)
pé	Noun	pé m (uncountable)
pé	Noun	pé f (uncountable)
hana	Noun	hana m (plural hanas)
ambulance	Noun	ambulance f (plural ambulances)
et	Noun	et m (plural ets)
L's Alpes	Noun	L's Alpes f pl
kaki	Noun	kaki m (uncountable)
astronomie	Noun	astronomie f (plural astronomies)
safran	Noun	safran m (uncountable)
pus	Noun	pus m (plural pus)
talon	Noun	talon m (plural talons)
canon	Noun	canon m (plural canons)
mille	Noun	mille m (plural mille)
rai	Noun	rai m (plural rais)
carte	Noun	carte f (plural cartes)
pont	Noun	pont m (plural ponts)
souper	Noun	souper m (plural soupers)
quiz	Noun	quiz m (plural quizs)
an	Noun	an m (plural ans)
magistrat	Noun	magistrat m (plural magistrats)
laine	Noun	laine f (plural laines)
taxi	Noun	taxi m (plural taxis)
ko	Noun	ko m (plural kos)
parti	Noun	parti m (plural partis)
format	Noun	format m (plural formats)
multimédia	Noun	multimédia m (plural multimédias)
gas	Noun	gas m (plural gas)
barre	Noun	barre f (plural barres)
front	Noun	front m (plural fronts)
bec	Noun	bec ? (plural becs)
hans	Noun	hans
galant	Noun	galant m (plural galants)
alcool	Noun	alcool m (plural alcools)
export	Noun	export m (plural exports)
bille	Noun	bille f (plural billes)
panne	Noun	panne f (plural pannes)
lof	Noun	lof m (plural lofs)
yacht	Noun	yacht ? (plural yachts)
puk	Noun	puk f (plural puks)
bras	Noun	bras m (plural bras)
avé	Noun	avé m (plural avés)
banc	Noun	banc m (plural bancs)
ciel	Noun	ciel m (plural cieux)
vak	Noun	vak f (plural vaks)
tun	Noun	tun m (plural tuns)
chef	Noun	chef m (plural chefs)
magie	Noun	magie f (plural magies)
lief	Noun	lief m (plural liefs)
lande	Noun	lande f (plural landes)
kut	Noun	kut m (plural kuts)
brise	Noun	brise f (plural brises)
piano	Noun	piano m (plural pianos)
noc	Noun	noc m (plural nocs)
vodka	Noun	vodka m (plural vodkas)
coco	Noun	coco m (plural cocos)
profit	Noun	profit m (plural profits)
garde	Noun	garde f (plural gardes)
liets	Noun	liets
président	Noun	président m (plural présidents)
nosse	Noun	nosse f (plural nosses)
dare	Noun	dare ? (plural dares)
avion	Noun	avion m (plural avions)
temps	Noun	temps m (plural temps)
moto	Noun	moto m (plural motos)
bord	Noun	bord m (plural bords)
scorpion	Noun	scorpion m (plural scorpions)
mode	Noun	mode f (plural modes)
parfait	Noun	parfait m (plural parfaits)
latte	Noun	latte f (plural lattes)
magot	Noun	magot m (plural magots)
harpe	Noun	harpe f (plural harpes)
have	Noun	have f (plural haves)
papa	Noun	papa m (plural papas)
bikini	Noun	bikini m (plural bikinis)
est	Noun	est m (uncountable)
amas	Noun	amas f (uncountable)
modem	Noun	modem m (plural modems)
parapet	Noun	parapet m (plural parapets)
pi	Noun	pi m (plural pis)
bidet	Noun	bidet m (plural bidets)
patron	Noun	patron m (plural patrons)
saint	Noun	saint m (plural saints)
mare	Noun	mare f (plural mares)
anis	Noun	anis m (plural anis)
tondre	Noun	tondre m (uncountable)
film	Noun	film m (plural films)
minne	Noun	minne f (plural minnes)
pelle	Noun	pelle f (plural pelles)
papi	Noun	papi m (plural papièrs)
port	Noun	port m (plural ports)
mont	Noun	mont m (plural monts)
lian	Noun	lian m (plural lians)
note	Noun	note f (plural notes)
kayak	Noun	kayak m (plural kayaks)
sexisme	Noun	sexisme m (plural sexismes)
nord	Noun	nord m (uncountable)
police	Noun	police f (uncountable)
ranne	Noun	ranne f (plural rannes)
nor	Noun	nor m (uncountable)
liet	Noun	liet m (plural liets)
libet	Noun	libet m (plural libets)
du	Noun	du m
lac	Noun	lac m (plural lacs)
ange	Noun	ange m (plural anges)
fille	Noun	fille f (plural filles)
gardin	Noun	gardin m (plural gardins)
fer	Noun	fer m (uncountable)
sud	Noun	sud m (invariable)
service	Noun	service m (plural services)
point	Noun	point m (plural points)
accent	Noun	accent m (plural accents)
e-mail	Noun	e-mail m (plural e-mails)
pitchi	Noun	pitchi f (plural pitchis)
genre	Noun	genre m (plural genres)
dos	Noun	dos m (plural dos)
ais	Noun	ais m (plural ais)
nyit	Noun	nyit f (plural nyits)
u	Noun	u m (plural uûs or uur)
baie	Noun	baie f (plural baies)
rosmarin	Noun	rosmarin m (uncountable)
por	Noun	por m (plural pors)
rade	Noun	rade f (plural rades)
bas	Noun	bas m (plural bas)
salut	Noun	salut m (plural saluts)
rabat	Noun	rabat m (plural rabats)
radio	Noun	radio m (plural radios)
baron	Noun	baron m (plural barons)
sent	Noun	sent m (plural sents)
panda	Noun	panda m (plural pandas)
castor	Noun	castor m (plural castors)
viol	Noun	viol m (plural viols)
mors	Noun	mors m (plural mors)
tuore	Noun	tuore m (plural tuores)
fé	Noun	fé m (uncountable)
nonne	Noun	nonne f (plural nonnes)
catte	Noun	catte f (plural cattes)
fro	Noun	fro m (plural frocs)
ambassade	Noun	ambassade f (plural ambassades)
trio	Noun	trio m (plural trios)
motion	Noun	motion f (plural motions)
tron	Noun	tron m (plural trons)
patates	Noun	patates
gode	Noun	gode f (plural godes)
martyr	Noun	martyr m (plural martyrs)
limon	Noun	limon m (plural limons)
mais	Noun	mais m (plural mais)
fis	Noun	fis m (plural fis)
balle	Noun	balle f (plural balles)
rein	Noun	rein m (plural reins)
reine	Noun	reine f (plural reines)
dé	Noun	dé m (plural dés)
charme	Noun	charme m (plural charmes)
melle	Noun	melle f (plural melles)
dromadaire	Noun	dromadaire m (plural dromadaires)
han	Noun	han m (plural hans)
pis	Noun	pis m pl
fa	Noun	fa m (plural fas)
rayon	Noun	rayon m (plural rayons)
arme	Noun	arme f (plural armes)
hus	Noun	hus m (plural hus)
barbi	Noun	barbi m (plural barbièrs)
taon	Noun	taon m (plural taons)
mie	Noun	mie f (plural mies)
dragon	Noun	dragon m (plural dragons)
