tigre	Noun	tigre m (plural tigres)
dolor	Noun	dolor m, f (plural dolors)
riba	Noun	riba f (plural ribas)
ora	Noun	ora f (plural oras)
dets	Noun	dets
dinnar	Noun	dinnar m (plural dinnars)
ironia	Noun	ironia f (uncountable)
esperanto	Noun	esperanto m (uncountable)
arma	Noun	arma f (plural armas)
sorire	Noun	sorire m (plural sorires)
catalan	Noun	catalan m (plural catalans, feminine catalana, feminine plural catalanas)
catalan	Noun	catalan m (uncountable)
chata	Noun	chata f (plural chatas)
lenga	Noun	lenga f (plural lengas)
tais	Noun	tais m (plural taisses)
italian	Noun	italian m (plural italians)
joglar	Noun	joglar m (plural joglars)
rat	Noun	rat m (plural rats)
mura	Noun	mura f (plural muras)
prat	Noun	prat m (plural prats)
ola	Noun	ola f (plural olas)
pan	Noun	pan m (plural pans)
vida	Noun	vida f (plural vidas)
ussa	Noun	ussa
abats	Noun	abats
algoritme	Noun	algoritme m (plural algoritmes)
luna	Noun	luna f (plural lunas)
pedagogia	Noun	pedagogia f (uncountable)
mot	Noun	mot m (plural mots)
fada	Noun	fada f (plural fadas)
safran	Noun	safran m (plural safrans)
lista	Noun	lista f (plural listas)
leon	Noun	leon m (plural leons)
estrada	Noun	estrada f (plural estradas)
figa	Noun	figa f (plural figas)
nap	Noun	nap m (plural naps)
geis	Noun	geis m
categoria	Noun	categoria f (plural categorias)
gost	Noun	gost m (plural gosts)
sopar	Noun	sopar m (plural sopars)
hont	Noun	hont m (plural honts)
sabla	Noun	sabla f (uncountable)
rit	Noun	rit m (plural rits)
leton	Noun	leton m (uncountable)
color	Noun	color f (plural colors)
brana	Noun	brana f (plural branas)
mond	Noun	mond m (plural monds)
taula	Noun	taula f (plural taulas)
casa	Noun	casa f (plural cases)
aleta	Noun	aleta f (plural aletas)
torres	Noun	torres
amor	Noun	amor m (plural amors)
polka	Noun	polka f (plural polkas)
cortina	Noun	cortina f (plural cortinas)
boca	Noun	boca f (plural bocas)
taur	Noun	taur m (plural taurs)
rire	Noun	rire m (plural rires)
sinonim	Noun	sinonim m (plural sinonims)
brusc	Noun	brusc m (plural brusques)
mont	Noun	mont m
avocat	Noun	avocat m (plural avocats)
cantaire	Noun	cantaire m (plural cantaires, feminine cantaira, feminine plural cantairas)
islandés	Noun	islandés m (plural islandés or islandeses)
mar	Noun	mar f (plural mars)
man	Noun	man f (plural mans)
det	Noun	det m (plural dets)
talpa	Noun	talpa m (plural talpas)
pega	Noun	pega f (plural pegas)
latin	Noun	latin m (uncountable)
amic	Noun	amic m (plural amics, feminine amiga, feminine plural amigas)
sauma	Noun	sauma f (plural saumas)
ase	Noun	ase m (plural ases)
planeta	Noun	planeta f (plural planetas)
pera	Noun	pera f (plural peras)
mes	Noun	mes m (plural meses)
ami	Noun	ami m (plural amis)
masca	Noun	masca f (plural mascas)
aire	Noun	aire m (plural aires)
bana	Noun	bana f (plural banas)
pelican	Noun	pelican m (plural pelicans)
gals	Noun	gals
prefix	Noun	prefix m
causa	Noun	causa f (plural causas)
dejunar	Noun	dejunar m (plural dejunars)
elefant	Noun	elefant m (plural elefants)
vinha	Noun	vinha f (plural vinhas)
vin	Noun	vin m (plural vins)
portugués	Noun	portugués m (plural portugués or portugueses)
aur	Noun	aur m (uncountable)
rata	Noun	rata f (plural ratas)
gos	Noun	gos m (plural gosses)
andorran	Noun	andorran m (plural andorrans)
victima	Noun	victima f (plural victimas)
lait	Noun	lait m (plural laits)
fons	Noun	fons m
gascon	Noun	gascon m (plural gascons, feminine gascona, feminine plural gasconas)
lua	Noun	lua f (plural luas)
plural	Noun	plural m (plural plurals)
ataca	Noun	ataca f (plural atacas)
jo	Noun	jo m
mas	Noun	mas m (plural mases)
fiu	Noun	fiu m
musica	Noun	musica f (plural musicas)
tron	Noun	tron m (plural trons)
ancora	Noun	ancora f (plural ancoras)
arpa	Noun	arpa f (plural arpas)
breton	Noun	breton m (plural bretons)
mandra	Noun	mandra f (plural mandras)
voler	Noun	voler m (plural volers)
cap	Noun	cap m (plural caps)
age	Noun	age m (plural ages)
mai	Noun	mai m (plural mais)
sang	Noun	sang m, f (uncountable)
gal	Noun	gal m (plural gals)
rua	Noun	rua f (plural ruas)
gat	Noun	gat m (plural gats, feminine gata, feminine plural gatas)
buc	Noun	buc m
lop	Noun	lop m (plural lops, feminine loba, feminine plural lobas)
can	Noun	can m (plural cans)
mur	Noun	mur m (plural murs)
vagina	Noun	vagina f
dit	Noun	dit m (plural dits)
rome	Noun	rome f (plural romes)
mort	Noun	mort f (plural morts)
gips	Noun	gips
ordre	Noun	ordre m (plural ordres)
water	Noun	water m
tanta	Noun	tanta f (plural tantas)
gant	Noun	gant m (plural gants)
an	Noun	an m (plural ans)
planta	Noun	planta f (plural plantas)
cranc	Noun	cranc m (plural crancs)
caire	Noun	caire m (plural caires)
minuta	Noun	minuta f (plural minutas)
