معروف	Adjective	معروف • (ma'ruf) (comparative معروف‌تر‏, superlative معروف‌ترین‏)
میرنده	Adjective	میرنده • (mirande)
مجهول	Adjective	مجهول • (majhul)
دلداده	Adjective	دلداده • (deldâde)
عموم	Adjective	عموم • ('omum)
مرطوب	Adjective	مرطوب • (martub) (comparative مرطوب‌تر‏, superlative مرطوب‌ترین‏)
واجب	Adjective	واجب • (vâjeb)
معشوق	Adjective	معشوق • (ma'šuq) (comparative معشوق‌تر‏, superlative معشوق‌ترین‏)
مؤمن	Adjective	مؤمن • (mo'men) (comparative مؤمن‌تر‏, superlative مؤمن‌ترین‏)
مزخرف	Adjective	مزخرف • (mozaxraf) (comparative مزخرف‌تر‏, superlative مزخرف‌ترین‏)
مفت	Adjective	مفت • (moft)
مجنون	Adjective	مجنون • (majnun) (comparative مجنون‌تر‏, superlative مجنون‌ترین‏)
صرف	Adjective	صرف • (serf)
مشغول	Adjective	مشغول • (mašğul)
عجول	Adjective	عجول • ('ajul)
ویژه	Adjective	ویژه • (viže) (comparative ویژه‌تر‏, superlative ویژه‌ترین‏)
لذیذ	Adjective	لذیذ • (laziz) (comparative لذیذتر‏, superlative لذیذترین‏)
جذاب	Adjective	جذاب • (jazzâb)
خارجی	Adjective	خارجی • (xâreji)
گشاد	Adjective	گشاد • (gošâd) (comparative گشادتر‏, superlative گشادترین‏)
سپاسگزار	Adjective	سپاسگزار • (sepâsgozâr)
مهاجم	Adjective	مهاجم • (mohâjem) (comparative مهاجم‌تر‏, superlative مهاجم‌ترین‏)
مخصوص	Adjective	مخصوص • (maxsus)
تنبل	Adjective	تنبل • (tanbal) (comparative تنبل‌تر‏, superlative تنبل‌ترین‏)
حافظ	Adjective	حافظ • (hâfez)
معلوم	Adjective	معلوم • (ma'lum)
فاسق	Adjective	فاسق • (fâseq) (comparative فاسق‌تر‏, superlative فاسق‌ترین‏)
بیمار	Adjective	بیمار • (bimâr) (comparative بیمارتر‏, superlative بیمارترین‏)
ماه	Adjective	ماه • (mâh)
دلگیر	Adjective	دلگیر • (delgir) (comparative دلگیرتر‏, superlative دلگیرترین‏)
مهم	Adjective	مهم • (mohemm) (comparative مهم‌تر‏, superlative مهم‌ترین‏)
مشهود	Adjective	مشهود • (mašhud)
دوم	Adjective	دوم • (dovvom)
معاصر	Adjective	معاصر • (mo'âser)
ممنوع	Adjective	ممنوع • (mamnu')
دیوانه	Adjective	دیوانه • (divâne) (comparative دیوانه‌تر‏, superlative دیوانه‌ترین‏)
بد	Adjective	بد • (bad) (comparative بدتر‏, superlative بدترین‏)
باب	Adjective	باب • (bâb)
سابق	Adjective	سابق • (sâbeq)
غلط	Adjective	غلط • (ğalat)
غریب	Adjective	غریب • (ğarib) (comparative غریب‌تر‏, superlative غریب‌ترین‏)
تخت	Adjective	تخت • (taxt)
پایه	Adjective	پایه • (pâye) (comparative پایه‌تر‏, superlative پایه‌ترین‏)
قشنگ	Adjective	قشنگ • (qašang) (comparative قشنگ‌تر‏, superlative قشنگ‌ترین‏)
مات	Adjective	مات • (mât)
مسؤول	Adjective	مسؤول • (mas'ul) (plural مسئولان‏)
ماهر	Adjective	ماهر • (mâher) (comparative ماهرتر‏, superlative ماهرترین‏)
متحد	Adjective	متحد • (mottahed)
دلتنگ	Adjective	دلتنگ • (deltang) (comparative دلتنگ‌تر‏, superlative دلتنگ‌ترین‏)
سالم	Adjective	سالم • (sâlem) (comparative سالم‌تر‏, superlative سالم‌ترین‏)
عرب	Adjective	عرب • ('arab)
هوشمند	Adjective	هوشمند • (hušmand) (comparative هوشمندتر‏, superlative هوشمندترین‏)
ضد	Adjective	ضد • (zedd)
مرده	Adjective	مرده • (morde)
کچل	Adjective	کچل • (kačal)
حلال	Adjective	حلال • (halâl) (comparative حلال‌تر‏, superlative حلال‌ترین‏)
مردانه	Adjective	مردانه • (mardâne) (comparative مردانه‌تر‏, superlative مردانه‌ترین‏)
لازم	Adjective	لازم • (lâzem)
عاشق	Adjective	عاشق • ('âšeq)
متوسط	Adjective	متوسط • (motavasset or motevasset)
خر	Adjective	خر • (xar) (comparative خرتر‏, superlative خرترین‏)
شاهد	Adjective	شاهد • (šâhed)
نمودار	Adjective	نمودار • (nemudār)
کثیف	Adjective	کثیف • (kasif) (comparative کثیف‌تر‏, superlative کثیف‌ترین‏)
صاف	Adjective	صاف • (sâf)
جاهل	Adjective	جاهل • (jâhel) (comparative جاهل‌تر‏, superlative جاهل‌ترین‏)
قطور	Adjective	قطور • (qatur) (comparative قطورتر‏, superlative قطورترین‏)
صعب	Adjective	صعب • (sa'b) (comparative صعب‌تر‏, superlative صعب‌ترین‏)
کیمیا	Adjective	کیمیا • (kimiyâ) (comparative کیمیاتر‏, superlative کیمیاترین‏)
نابینا	Adjective	نابینا • (nâbinâ)
اکسیر	Adjective	اکسیر • (eksir) (comparative اکسیرتر‏, superlative اکسیرترین‏)
لوند	Adjective	لوند • (lavand)
دلسوز	Adjective	دلسوز • (delsuz) (comparative دلسوزتر‏, superlative دلسوزترین‏)
قابل	Adjective	قابل • (qâbel) (comparative قابل‌تر‏, superlative قابل‌ترین‏)
احمق	Adjective	احمق • (ahmaq) (comparative احمق‌تر‏, superlative احمق‌ترین‏)
خشن	Adjective	خشن • (xašen)
موجود	Adjective	موجود • (mowjud)
بالغ	Adjective	بالغ • (bâleğ) (comparative بالغ‌تر‏, superlative بالغ‌ترین‏)
کمیاب	Adjective	کمیاب • (kamyâb) (comparative کمیاب‌تر‏, superlative کمیاب‌ترین‏)
عادل	Adjective	عادل • (transliteration needed)
موقت	Adjective	موقت • (movaqqat)
داغ	Adjective	داغ • (dâğ) (comparative داغ‌تر‏, superlative داغ‌ترین‏)
بلد	Adjective	بلد • (balad)
ارزان	Adjective	ارزان • (arzân) (comparative ارزان‌تر‏, superlative ارزان‌ترین‏)
مجرد	Adjective	مجرد • (mojarrad)
آمریکایی	Adjective	آمریکایی • (Âmrikâyi)
شاذ	Adjective	شاذ • (šâz)
حرام	Adjective	حرام • (harâm)
نر	Adjective	نر • (nar)
مقدس	Adjective	مقدس • (moqaddas)
ثابت	Adjective	ثابت • (sâbet)
خوش	Adjective	خوش • (xoš) (comparative خوش‌تر‏, superlative خوش‌ترین‏)
کور	Adjective	کور • (kur)
راد	Adjective	راد • (rād)
جوان	Adjective	جوان • (javân) (comparative جوان‌تر‏, superlative جوان‌ترین‏)
آرام	Adjective	آرام • (ârâm)
حاد	Adjective	حاد • (hâd) (comparative حادتر‏, superlative حادترین‏)
نادر	Adjective	نادر • (nâder) (comparative نادرتر‏, superlative نادرترین‏)
جابر	Adjective	جابر • (jâber)
ناقص	Adjective	ناقص • (nâqes)
صادق	Adjective	صادق • (sâdeq) (comparative صادق‌تر‏, superlative صادق‌ترین‏)
غرق	Adjective	غرق • (ğarq)
مفقود	Adjective	مفقود • (mafqud)
طاس	Adjective	طاس • (tâs)
تو	Adjective	تو • (tu)
مأمور	Adjective	مأمور • (ma'mur)
مریض	Adjective	مریض • (mariz) (comparative مریض‌تر‏, superlative مریض‌ترین‏)
هرزه	Adjective	هرزه • (harze) (comparative هرزه‌تر‏, superlative هرزه‌ترین‏)
جامع	Adjective	جامع • (jâme') (comparative جامع‌تر‏, superlative جامع‌ترین‏)
موافق	Adjective	موافق • (movâfeq)
جبار	Adjective	جبار • (jabâr) (comparative جبارتر‏, superlative جبارترین‏)
آباد	Adjective	آباد • (âbâd)
قبل	Adjective	قبل • (qabl)
زال	Adjective	زال • (zâl)
سرخ	Adjective	سرخ • (sorx)
تمیز	Adjective	تمیز • (tamiz) (comparative تمیزتر‏, superlative تمیزترین‏)
خوشگل	Adjective	خوشگل • (xošgel) (comparative خوشگل‌تر‏, superlative خوشگل‌ترین‏)
کوچک	Adjective	کوچک • (kučak, kuček) (comparative کوچک‌تر‏, superlative کوچک‌ترین‏)
پیر	Adjective	پیر • (pir) (comparative پیرتر‏, superlative پیرترین‏)
کسشعر	Adjective	کسشعر • (kos(e)še'r) (comparative کسشعرتر‏, superlative کسشعرترین‏)
