دار	Noun	دار • (dâr)
دار	Noun	دار • (dâr)
مجد	Noun	مجد • (majjed)
رباب	Noun	رباب • (robâb)
جان	Noun	جان • (jân) (plural جان‌ها‏ (jân-hâ))
مجاهد	Noun	مجاهد • (mojâhed) (plural مجاهدها‏ (mojâhed-hâ) or مجاهدان‏ (mojâhedân) or مجاهدین‏ (mojâhedin))
فرار	Noun	فرار • (farâr)
مضراب	Noun	مضراب • (mezrâb)
خفاش	Noun	خفاش • (xoffâš) (plural خفاشان‏ (xoffâšân) or خفاش‌ها‏ (xoffâš-hâ))
میرنده	Noun	میرنده • (mirande) (plural میرندگان‏ (mirandegân))
نسل	Noun	نسل • (nasl)
دلداده	Noun	دلداده • (deldâde) (plural دلدادگان‏ (deldâdegân))
عموم	Noun	عموم • ('omum)
تفرق	Noun	تفرق • (tafarroq)
سنجاقک	Noun	سنجاقک • (sanjâqak) (plural سنجاقک‌ها‏ (sanjâqak-hâ))
رشد	Noun	رشد • (rošd)
شاش	Noun	شاش • (šâš)
حمل	Noun	حمل • (haml)
مخ	Noun	مخ • (mox)
خرس	Noun	خرس • (xers) (plural خرس‌ها‏ (xers-hâ))
خرس	Noun	خرس • (xros)
اهل	Noun	اهل • (ahl) (plural اهالی‏ (ahâli))
واجب	Noun	واجب • (vâjeb)
مور	Noun	مور • (môr)
قاموس	Noun	قاموس • (qâmus)
مؤمن	Noun	مؤمن • (mo'men) (plural مؤمنان‏ (mo'menân) or مؤمن‌ها‏ (mo'men-hâ) or مؤمنین‏)
جمع	Noun	جمع • (jam')
چکمه	Noun	چکمه • (čakme) (plural چکمه‌ها‏ (čakme-hâ))
غو	Noun	غو • (ğav)
موضوع	Noun	موضوع • (mowzu) (plural مَواضيع‏ (mowzu'ât))
نجوم	Noun	نجوم • (nojum)
زائر	Noun	زائر • (zâ'er) (plural زائران‏ (zâ'erân))
موقع	Noun	موقع • (mouqe') (plural موقع‌ها‏ (mouqe'-hâ))
سطر	Noun	سطر • (satr) (plural سطرها‏ (satr-hâ) or سطور‏ (sotur))
طوطی	Noun	طوطی • (tuti) (plural طوطی‌ها‏ (tuti-hâ) or طوطیان‏ (tutiân))
شمع	Noun	شمع • (šam') (plural شمع‌ها‏ (šam'-hâ))
پارو	Noun	پارو • (pâru) (plural پاروها‏ (pâru-hâ))
سرباز	Noun	سرباز • (sarbâz) (plural سربازان‏ (sarbâzân) or سربازها‏ (sarbâz-hâ))
سمت	Noun	سمت • (samt)
خانواده	Noun	خانواده • (xânevâde) (plural خانواده‌ها‏ (xânevâde-hâ))
نقاب	Noun	نقاب • (neqâb)
ایجاد	Noun	ایجاد • (ijâd) (plural ایجادها‏ (ijâd-hâ))
گاومیش	Noun	گاومیش • (gâvmiš) (plural گاومیشان‏ (gâvmišân) or گاومیش‌ها‏ (gâvmiš-hâ))
راغ	Noun	راغ • (râğ)
حسن	Noun	حسن • (hosn)
برقع	Noun	برقع • (borqa‘)
خالق	Noun	خالق • (xâleq)
فرسخ	Noun	فرسخ • (farsax) (plural فرسخ‌ها‏ (farsax-hâ) or فراسخ‏)
نقد	Noun	نقد • (naqd)
خارج	Noun	خارج • (xârej)
خطر	Noun	خطر • (xatar)
هاون	Noun	هاون • (hâvan)
بار	Noun	بار • (bâr)
بار	Noun	بار • (bâr)
بار	Noun	بار • (bâr)
بار	Noun	بار • (bâr)
بار	Noun	بار • (bâr)
بار	Noun	بار • (bâr)
بار	Noun	بار • (bâr)
قمر	Noun	قمر • (ghamar)
پلم	Noun	پلم • (palem, palam)
پلم	Noun	پلم • (palm)
دهن	Noun	دهن • (dahan) (plural دهن‌ها‏ (dahan-hâ))
مجنون	Noun	مجنون • (majnun)
عن	Noun	عن • ('an)
صرف	Noun	صرف • (sarf)
آخر	Noun	آخر • (âxar)
لقب	Noun	لقب • (laqab)
مکان	Noun	مکان • (makân) (plural مکان‌ها‏ (makân-hâ) or اماکن‏ (amâken))
پروگرام	Noun	پروگرام • (progrâm, porogerâm, perogerâm)
مقدار	Noun	مقدار • (meqdâr) (plural مقادیر‏ (maqâdir))
چراغ	Noun	چراغ • (čerâğ, čarâğ) (plural چراغ‌ها‏ (čerâğ-hâ, čarâğ-hâ))
پروسه	Noun	پروسه • (prose, porose, perose)
انفجار	Noun	انفجار • (enfejâr) (plural انفجارها‏ (enfejâr-hâ))
بته	Noun	بته • (botte)
مترجم	Noun	مترجم • (motarjem)
حرم	Noun	حرم • (haram)
شخص	Noun	شخص • (šaxs) (plural اشخاص‏ (ašxâs) or شخص‌ها‏ (šaxs-hâ))
رز	Noun	رز • (raz)
رز	Noun	رز • (roz)
منشی	Noun	منشی • (monši) (plural منشیان‏ (monšiân))
توقع	Noun	توقع • (tavaqqo') (plural توقعات‏ (tavaqqo'ât))
وال	Noun	وال • (vâl) (plural وال‌ها‏ (vâl-hâ))
لحظه	Noun	لحظه • (lahze) (plural لحظه‌ها‏ (lahze-hâ))
هلال	Noun	هلال • (helâl)
توت	Noun	توت • (tut)
خارجی	Noun	خارجی • (xâreji) (plural خارجی‌ها‏ (xâreji-hâ))
جام	Noun	جام • (jâm) (plural جام‌ها‏ (jâm-hâ))
خندق	Noun	خندق • (xandaq) (plural خندق‌ها‏ (xandaq-hâ))
مهار	Noun	مهار • (mahār)
اعتبار	Noun	اعتبار • (e'tebâr)
قواد	Noun	قواد • (qavvād)
مزار	Noun	مزار • (mazâr) (plural مزارها‏ (mazâr-hâ))
موت	Noun	موت • (mout) (plural موت‌ها‏ (mout-hâ) or اموات‏ (amvât))
آلت	Noun	آلت • (âlat)
حضور	Noun	حضور • (hozur)
رب	Noun	رب • (robb)
شعار	Noun	شعار • (šo'âr)
بن	Noun	بن • (bon)
بن	Noun	بن • (ben)
حلب	Noun	حلب • (halab)
ظاهر	Noun	ظاهر • (zâher)
اعتقاد	Noun	اعتقاد • (e'teqâd) (plural اعتقادها‏ (e'teqâd-hâ) or اعتقادات‏ (e'teqâdât))
ساحر	Noun	ساحر • (sâher) (plural ساحرها‏ (sâher-hâ) or سحره‏ (sahere))
طلوع	Noun	طلوع • (tolu')
تلو	Noun	تلو • (talu)
تلو	Noun	تلو • (telow)
وزن	Noun	وزن • (vazn) (plural وزن‌ها‏ (vazn-hâ) or اوزان‏ (owzân))
بل	Noun	بل • (bol)
زنبق	Noun	زنبق • (zanbaq) (plural زنبق‌ها‏ (zanbaq-hâ))
شیر	Noun	شیر • (šir) (plural شیرها‏ (šir-hâ) or شیران‏ (širân))
شیر	Noun	شیر • (šir)
طاق	Noun	طاق • (tâq) (plural طاق‌ها‏ (tâq-hâ))
پیکر	Noun	پیکر • (paikar) (plural پیکرها‏ (paikar-hâ))
چیز	Noun	چیز • (čiz) (plural چیزها‏ (čiz-hâ))
مهاجم	Noun	مهاجم • (mohâjem) (plural مهاجمین‏ (mohâjemin) or مهاجمان‏ (mohâjemân) or مهاجم‌‌ها‏ (mohâjem-hâ))
سقف	Noun	سقف • (saqf)
ملا	Noun	ملا • (mollâ) (plural ملايان‏ or ملاها‏ (mollâ-hâ))
حافظ	Noun	حافظ • (hâfez)
فاسق	Noun	فاسق • (fâseq) (plural فساق‏ (fosâq) or فاسق‌ها‏ (fâseq-hâ))
بور	Noun	بور • (bor)
عضو	Noun	عضو • (ozv) (plural اعضا‏ (a'zâ))
دام	Noun	دام • (dâm)
موج	Noun	موج • (mowj)
حجاب	Noun	حجاب • (hejâb)
جبر	Noun	جبر • (jabr)
سنا	Noun	سنا • (senâ)
نحو	Noun	نحو • (nahv)
سرداب	Noun	سرداب • (sardâb) (plural سرداب‌ها‏ (sardâb-hâ))
ماما	Noun	ماما • (mâmâ)
دارچین	Noun	دارچین • (dârčin)
تم	Noun	تم • (tam)
تم	Noun	تم • (tem)
ظفر	Noun	ظفر • (zafar)
درب	Noun	درب • (darb)
مسلمان	Noun	مسلمان • (mosalmân) (plural مسلمانان‏ (mosalmânân) or مسلمان‌ها‏ (mosalmân-hâ))
بیمار	Noun	بیمار • (bimâr) (plural بیماران‏ (bimârân) or بیمارها‏ (bimâr-hâ))
دلدار	Noun	دلدار • (deldār) (plural دلدارها‏ (deldār-hâ) or دلداران‏ (deldārân))
طلاق	Noun	طلاق • (talâq)
تمام	Noun	تمام • (tamâm)
جن	Noun	جن • (jen)
پروژه	Noun	پروژه • (prože, porože, perože)
پناهنده	Noun	پناهنده • (panâhande) (plural پناهندگان‏ (panâhandegân) or پناهنده‌ها‏ (panâhande-hâ))
غربال	Noun	غربال • (qarbāl)
نجار	Noun	نجار • (najjâr)
زعفران	Noun	زعفران • (za'ferân)
سخن	Noun	سخن • (soxan) (plural سخنان‏ (soxanân))
نفس	Noun	نفس • (nafas) (plural نفس‌ها‏ (nafas-hâ) or انفاس‏ (anfâs))
نفس	Noun	نفس • (nafs) (plural نفس‌ها‏ (nafs-hâ) or نفوس‏ (nofus))
جزء	Noun	جزء • (joz)
احتمال	Noun	احتمال • (ehtemâl)
قفل	Noun	قفل • (qofl)
خائن	Noun	خائن • (khâ'en)
مفعول	Noun	مفعول • (maf'ul)
مصرف	Noun	مصرف • (masraf)
زلزله	Noun	زلزله • (zelzele) (plural زلزله‌ها‏ (zelzele-hâ))
درس	Noun	درس • (dars)
طب	Noun	طب • (tebb)
ورود	Noun	ورود • (vorud)
شرق	Noun	شرق • (šarq)
فلافل	Noun	فلافل • (falâfel)
آی	Noun	آی • (ây)
پوپک	Noun	پوپک • (pupak)
خاتم	Noun	خاتم • (xātam)
تب	Noun	تب • (tab)
کشور	Noun	کشور • (kešvar) (plural کشورها‏ (kešvar-hâ))
دختر	Noun	دختر • (doxtar) (plural دختران‏ (doxtarân) or دخترها‏ (doxtar-hâ))
مرجان	Noun	مرجان • (marjân)
عدس	Noun	عدس • ('adas) (plural عدس‌ها‏ ('adas-hâ))
اتصال	Noun	اتصال • (ettesâl) (plural اتصالات‏ (ettesâlât) or اتصال‌ها‏ (ettesâl-hâ))
ارتداد	Noun	ارتداد • (ertedæd)
بلا	Noun	بلا • (balâ) (plural بلاها‏ (balâ-hâ))
محصول	Noun	محصول • (mahsul) (plural محصولات‏ (mahsulât))
ریش	Noun	ریش • (riš) (plural ریش‌ها‏ (riš-hâ))
ریش	Noun	ریش • (riš) (plural ریش‌ها‏ (riš-hâ))
حرب	Noun	حرب • (harb)
عزر	Noun	عزر • (ʻazr)
طالب	Noun	طالب • (tâleb) (plural طالبان‏ (tâlebân))
قرار	Noun	قرار • (qarâr)
فندق	Noun	فندق • (fandoq)
فندق	Noun	فندق • (fondoq)
عقیده	Noun	عقیده • ('aqide) (plural عقاید‏ ('aqâyed))
مسجد	Noun	مسجد • (masjed) (plural مساجد‏ (masâjed) or مسجدها‏ (masjed-hâ))
وشم	Noun	وشم • (vašm)
وشم	Noun	وشم • (vošom)
سرکار	Noun	سرکار • (sarkâr) (plural سرکارها‏ (sarkâr-hâ))
فتح	Noun	فتح • (fath)
درج	Noun	درج • (dorj)
شهر	Noun	شهر • (šahr) (plural شهرها‏ (šahr-hâ))
است	Noun	است • (ast)
عجان	Noun	عجان • ('ejân)
دیوانه	Noun	دیوانه • (divâne)
فاعل	Noun	فاعل • (fâ'el) (plural فاعل‌ها‏ (fâ'el-hâ))
انتقاد	Noun	انتقاد • (enteqâd)
گوز	Noun	گوز • (guz) (plural گوزها‏ (guz-hâ))
ملک	Noun	ملک • (malak) (plural ملائک‏ (malâ'ek))
ملک	Noun	ملک • (malek) (plural ملوک‏ (moluk))
ملک	Noun	ملک • (melk) (plural املاک‏ (amlâk))
ملک	Noun	ملک • (molk)
طبق	Noun	طبق • (tabaq)
بد	Noun	بد • (-bad, -bed, -bod)
عصر	Noun	عصر • (asr) (plural عصرها‏ (asr-hâ))
حالت	Noun	حالت • (hâlat) (plural حالت‌ها‏ (hâlat-hâ) or حالات‏ (hâlât))
سلط	Noun	سلط • (salt)
باب	Noun	باب • (bâb) (plural باب‌ها‏ (bâb-hâ))
باب	Noun	باب • (bâb)
من	Noun	من • (man)
طحال	Noun	طحال • (tahâl) (plural طحال‌ها‏ (tahâl-hâ) or طحل‏ (tohol))
مزاج	Noun	مزاج • (mazâj)
عبور	Noun	عبور • ('obur)
فشار	Noun	فشار • (fešâr)
تجمع	Noun	تجمع • (tajammo')
انجمن	Noun	انجمن • (anjoman) (plural انجمن‌ها‏ (anjoman-hâ))
عصب	Noun	عصب • ('asab)
سلطان	Noun	سلطان • (soltân)
کلاس	Noun	کلاس • (kelâs) (plural کلاس‌ها‏ (kelâs-hâ))
بذر	Noun	بذر • (bazr)
داور	Noun	داور • (dâvar)
نظام	Noun	نظام • (nezâm)
نقاش	Noun	نقاش • (naqqâš)
مهاجر	Noun	مهاجر • (mohâjer) (plural مهاجران‏ (mohâjerân))
جو	Noun	جو • (javv)
معهد	Noun	معهد • (transliteration needed) (plural معاهد‏)
تاریخدان	Noun	تاریخدان • (târixdân) (plural تاریخدانان‏ (târixdânân))
محل	Noun	محل • (mahall)
رقم	Noun	رقم • (raqam) (plural ارقام‏ or رقم‌ها‏ (raqam-hâ))
منطق	Noun	منطق • (manteq) (plural مناط‏)
فاس	Noun	فاس • (fâs)
بو	Noun	بو • (bow)
احتلام	Noun	احتلام • (ehtelấm) (plural احتلامات‏ (ehtelâmất))
صرع	Noun	صرع • (sar')
تمر	Noun	تمر • (tamor)
تمر	Noun	تمر • (tamr)
تمر	Noun	تمر • (temer)
موضع	Noun	موضع • (mowze')
بعد	Noun	بعد • (bo'd) (plural ابعاد‏ (ab'âd) or بعدها‏ (bo'd-hâ))
قرض	Noun	قرض • (qarz)
ضربان	Noun	ضربان • (zarabân)
غلط	Noun	غلط • (ğalat) (plural غلط‌ها‏ (ğalat-hâ))
التماس	Noun	التماس • (eltemâs)
فجر	Noun	فجر • (fajr)
جاسوس	Noun	جاسوس • (jâsus) (plural جواسیس‏ (javâsis) or جاسوسان‏ (jâsusân))
قرن	Noun	قرن • (qarn) (plural قرن‌ها‏ (qarn-hâ) or قرون‏ (qorun))
غرور	Noun	غرور • (ghorur)
تخت	Noun	تخت • (taxt) (plural تخت‌ها‏ (taxt-hâ))
عود	Noun	عود • (ud) (plural عودها‏ (ud-hâ))
تصوف	Noun	تصوف • (Tasavvof)
مجلس	Noun	مجلس • (majles)
امتحان	Noun	امتحان • (emtehân) (plural امتحانات‏ (emtehânât))
دم	Noun	دم • (dam)
شعب	Noun	شعب • (šo'ab)
مثال	Noun	مثال • (mesâl) (plural مثال‌ها‏ (mesâl-hâ))
مذاکره	Noun	مذاکره • (mozâkere) (plural مذاکره‌ها‏ (mozâkere-hâ) or مذاکرات‏ (mozâkerât))
نسخ	Noun	نسخ • (nasx)
ویرایش	Noun	ویرایش • (virâyeš) (plural ویرایش‌ها‏ (virâyeš-hâ))
جماع	Noun	جماع • (jemâ')
صراط	Noun	صراط • (serât)
کلمه	Noun	کلمه • (kalame) (plural کلمه‌ها‏ (kalame-hâ) or كلمات‏)
برز	Noun	برز • (barz) (plural برزان‏ (barzân) or برزها‏ (barz-hâ))
فارس	Noun	فارس • (fârs) (plural فارس‌ها‏ (fârs-hâ))
فارس	Noun	فارس • (fâres)
شر	Noun	شر • (šarr)
قد	Noun	قد • (qad)
ظهر	Noun	ظهر • (zahr)
ظهر	Noun	ظهر • (zohr)
صدف	Noun	صدف • (sadaf) (plural صدف‌ها‏ (sadaf-hâ))
پوشاک	Noun	پوشاک • (pušấk)
عذاب	Noun	عذاب • ('azâb)
عطر	Noun	عطر • (atr)
حمّام	Noun	حمّام • (hammâm)
حمام	Noun	حمام • (hamâm)
خان	Noun	خان • (xân) (plural خان‌ها‏ (xân-hâ))
خان	Noun	خان • (xân) (plural خان‌ها‏ (xân-hâ) or خانات‏ (xânât) or خوانین‏ (xavânin))
صندل	Noun	صندل • (sandal)
صندل	Noun	صندل • (sandal)
صندل	Noun	صندل • (sandal)
عفو	Noun	عفو • (ʻafv)
قطار	Noun	قطار • (qatâr) (plural قطارها‏ (qatâr-hâ))
بول	Noun	بول • (bowl) (plural بول‌ها‏ (bowl-hâ))
ثبت	Noun	ثبت • (sabt)
دوران	Noun	دوران • (dowrân)
ران	Noun	ران • (rân) (plural ران‌ها‏ (rân-hâ))
عارض	Noun	عارض • (arez)
خف	Noun	خف • (xof, xaf)
پندار	Noun	پندار • (pendâr) (plural پندارها‏ (pendâr-hâ))
جسد	Noun	جسد • (jasad) (plural اجساد‏ (ajsâd) or جسدها‏ (jasad-hâ))
عمر	Noun	عمر • (omr)
فنجان	Noun	فنجان • (fenjân) (plural فنجان‌ها‏ (fenjân-hâ) or فناجين‏ (fenâjin))
عجم	Noun	عجم • ('ajam)
ظهور	Noun	ظهور • (zohur)
تلفظ	Noun	تلفظ • (talaffoz)
تلفن	Noun	تلفن • (telefon)
پزشک	Noun	پزشک • (pezešk) (plural پزشکان‏ (pezeškân))
هدهد	Noun	هدهد • (hodhod)
پلان	Noun	پلان • (plân, pelân)
سلام	Noun	سلام • (salâm)
لواط	Noun	لواط • (lavât)
مترو	Noun	مترو • (metro)
جنون	Noun	جنون • (jonun)
شانه‌بسر	Noun	شانه‌بسر • (šânebesar)
مسلسل	Noun	مسلسل • (mosalsal)
دسر	Noun	دسر • (deser)
عنکبوت	Noun	عنکبوت • ('ankabut) (plural عنکبوت‌ها‏ ('ankabut-hâ) or عناکب‏ ('anâkib) or عنکبوتان‏ ('ankabutân))
غروب	Noun	غروب • (qorub)
هم‌نیا	Noun	هم‌نیا • (ham-niâ) (plural هم‌نیاها‏ (ham-niâ-hâ))
فلفل	Noun	فلفل • (felfel) (plural فلفل‌ها‏ (felfel-hâ))
حنا	Noun	حنا • (hanâ)
رمان	Noun	رمان • (român)
فهم	Noun	فهم • (fahm)
عرب	Noun	عرب • ('arab) (plural عرب‌ها‏ ('arab-hâ))
فرض	Noun	فرض • (farz) (plural فرض‌ها‏ (farz-hâ))
ببر	Noun	ببر • (babar) (plural ببرها‏ (babar-hâ))
ببر	Noun	ببر • (babr) (plural ببرها‏ (babr-hâ) or ببران‏ (babrân))
ضد	Noun	ضد • (zedd)
خال‌کوبی	Noun	خال‌کوبی • (xâl-kubi) (plural خال‌کوبی‌ها‏ (xâl-kubi-hâ))
پرنده	Noun	پرنده • (parande) (plural پرندگان‏ (parandegân) or پرنده‌ها‏ (parande-hâ))
آجر	Noun	آجر • (âjor) (plural آجرها‏ (âjor-hâ))
مزرعه	Noun	مزرعه • (mazra'e) (plural مزرعه‌ها‏ (mazra'e-hâ) or مزارع‏ (mazâre'))
بنت	Noun	بنت • (bent)
فرآیند	Noun	فرآیند • (farāyand)
عرق	Noun	عرق • ('araq)
کونی	Noun	کونی • (kuni) (plural کونی‌ها‏ (kuni-hâ))
مرده	Noun	مرده • (morde) (plural مردگان‏ (mordegân) or مرده‌ها‏ (morde-hâ))
فقر	Noun	فقر • (faqr)
خباز	Noun	خباز • (khabbâz)
اتحاد	Noun	اتحاد • (ettehâd)
شباهنگ	Noun	شباهنگ • (šabâhang) (plural شباهنگ‌ها‏ (šabâhang-hâ))
شاعر	Noun	شاعر • (šâ'er) (plural شاعران‏ (šâ'erân) or شاعرها‏ (šâ'er-hâ) or شعرا‏ (šo'arâ))
هرتز	Noun	هرتز • (hertz)
مرج	Noun	مرج • (marj)
فرق	Noun	فرق • (farq)
کِچُل	Noun	کِچُل • (kečol)
رخ	Noun	رخ • (rox)
رخ	Noun	رخ • (rux)
ارتفاع	Noun	ارتفاع • (ertefâ') (plural ارتفاعات‏ (ertefâ'ât))
پهپاد	Noun	پهپاد • (pahpâd) (plural پهپادها‏ (pahpâd-hâ))
طرح	Noun	طرح • (tarh) (plural طرح‌ها‏ (tarh-hâ))
عقاب	Noun	عقاب • ('oqâb) (plural عقابان‏ (oqâbân) or عقاب‌ها‏ (oqâb-hâ))
عقاب	Noun	عقاب • ('eqâb)
هرم	Noun	هرم • (heram) (plural هرم‌ها‏ (heram-hâ))
هرم	Noun	هرم • (horm)
کرنا	Noun	کرنا • (karnâ)
حلال	Noun	حلال • (hallâl)
بوس	Noun	بوس • (bus)
نار	Noun	نار • (nâr)
نار	Noun	نار • (nâr)
دجال	Noun	دجال • (dajjâl) (plural دجالان‏ (dajjâlân))
زاده	Noun	زاده • (zâde) (plural زادگان‏ (zâdegân))
کمربند	Noun	کمربند • (kamarband)
تمساح	Noun	تمساح • (temsâh) (plural تمساح‌ها‏ (temsâh-hâ))
شعر	Noun	شعر • (še'r) (plural شعرها‏ (še'r-hâ) or اشعار‏ (aš'âr))
نجم	Noun	نجم • (najm)
عاشق	Noun	عاشق • ('âšeq) (plural عاشقان‏ ('âšeqân) or عشاق‏ ('oššaq) or عاشق‌ها‏ ('âšeq-hâ))
علم	Noun	علم • ('elm) (plural علوم‏ ('olum))
علم	Noun	علم • ('alam) (plural علم‌ها‏ ('alam-hâ))
خسته‌خانه	Noun	خسته‌خانه • (xaste-xâne) (plural خسته‌خانه‌ها‏ (xaste-xâne-hâ))
صنف	Noun	صنف • (senf)
خراب	Noun	خراب • (xarâb)
استعداد	Noun	استعداد • (este'dâd)
خزنده	Noun	خزنده • (xazande) (plural خزندگان‏ (xazandegân) or خزنده‌ها‌‏ (xazande-hâ))
شهاب	Noun	شهاب • (šahâb) (plural شهاب‌ها‏ (šahâb-hâ))
بان	Noun	بان • (bân)
بان	Noun	بان • (bân)
بان	Noun	بان • (bân)
بان	Noun	بان • (bân)
وضع	Noun	وضع • (vaz') (plural اوضاع‏ (owzâ') or وضع‌ها‏ (vaz'-hâ))
خر	Noun	خر • (xar) (plural خرها‏ (xar-hâ) or خران‏ (xarân))
شات	Noun	شات • (šât)
رضا	Noun	رضا • (rezâ)
اختراع	Noun	اختراع • (exterâ') (plural اختراعات‏ (exterâ'ât))
طبل	Noun	طبل • (tabl) (plural طبل‌ها‏ (tabl-hâ))
داخل	Noun	داخل • (dâxel)
غول	Noun	غول • (ğul) (plural غول‌ها‏ (ğul-hâ))
انتحار	Noun	انتحار • (entehâr)
شاهد	Noun	شاهد • (šâhed) (plural شاهدان‏ (šâhedân) or شاهدها‏ (šâhed-hâ))
نمودار	Noun	نمودار • (nemudār)
طلب	Noun	طلب • (talab)
نذر	Noun	نذر • (nazr)
سیاست	Noun	سیاست • (siyâsat) (plural سیاست‌ها‏ (siyâsat-hâ))
تکوک	Noun	تکوک • (takôk) (plural تکوک‌ها‏ (takôk-hâ))
روس	Noun	روس • (Rus) (plural روس‌ها‏ (Rus-hâ))
مطلع	Noun	مطلع • (matla') (plural مطلع‌ها‏ (matla'-hâ))
عمو	Noun	عمو • ('amu) (plural عموها‏ ('amu-hâ))
گنجشک	Noun	گنجشک • (gonješk) (plural گنجشکان‏ (gonješkân))
آوا	Noun	آوا • (âvâ) (plural آوا‌ها‏ (âvâ-hâ))
محراب	Noun	محراب • (mehrâb) (plural محراب‌ها‏ (mehrâb-hâ))
فرش	Noun	فرش • (farš)
سند	Noun	سند • (sanad)
سَروَر	Noun	سَروَر • (sarvar)
سه‌تار	Noun	سه‌تار • (se-târ) (plural سه‌تارها‏ (se-târ-hâ))
خون	Noun	خون • (xun)
خوف	Noun	خوف • (xouf) (plural خوف‌ها‏ (xouf-hâ))
اختصار	Noun	اختصار • (ekhtesâr)
سور	Noun	سور • (sur)
گیلاس	Noun	گیلاس • (gilâs) (plural گیلاس‌ها‏ (gilâs-hâ))
رد	Noun	رد • (rad)
رد	Noun	رد • (rad)
کیمیا	Noun	کیمیا • (kimiyâ) (plural کیمیاها‏ (kimiyâ-hâ))
قول	Noun	قول • (qoul)
دود	Noun	دود • (dud)
اژدها	Noun	اژدها • (aždahâ, eždehâ)
معدن	Noun	معدن • (ma'den) (plural معدن‌ها‏ (ma'den-hâ))
عدل	Noun	عدل • (adl)
قنطار	Noun	قنطار • (qentâr) (plural قناطیر‏)
اکسیر	Noun	اکسیر • (eksir) (plural اکسیرها‏ (eksir-hâ))
رسول	Noun	رسول • (rasul) (plural رسل‏ (rosol) or رسولان‏ (rasulân))
خال	Noun	خال • (xâl)
رحم	Noun	رحم • (rahem)
رحم	Noun	رحم • (rahm)
بشر	Noun	بشر • (bashar)
انقلاب	Noun	انقلاب • (enqelâb) (plural انقلابات‏ (enqelâbât) or انقلاب‌ها‏ (enqelâb-hâ))
خط	Noun	خط • (xatt) (plural خطوط‏ (xotut) or خط‌ها‏ (xatt-hâ))
برزخ	Noun	برزخ • (barzax)
زار	Noun	زار • (zâr)
قلیان	Noun	قلیان • (qalyân)
لوند	Noun	لوند • (lavand)
مخرج	Noun	مخرج • (maxraj) (plural مخرج‌ها‏ (maxraj-hâ))
عمل	Noun	عمل • ('amal) (plural اعمال‏ (a'mâl) or عمل‌ها‏ ('amal-hâ))
بازی	Noun	بازی • (bâzi) (plural بازی‌ها‏ (bâzi-hâ))
سقوط	Noun	سقوط • (soqut)
تنفس	Noun	تنفس • (tanaffos)
قصد	Noun	قصد • (qasd) (plural قصدها‏ (qasd-hâ))
مبنا	Noun	مبنا • (mabnâ) (plural مبناها‏ (mabnâ-hâ) or مبانی‏ (mabâni))
مصدر	Noun	مصدر • (masdar) (plural مصدرها‏ (masdar-hâ) or مصادر‏ (masâder))
وجدان	Noun	وجدان • (vojdân, vejdân)
وهم	Noun	وهم • (vahm) (plural اوهام‏ (ouhâm))
شطرنج	Noun	شطرنج • (shatranj)
قصاب	Noun	قصاب • (qassâb) (plural قصاب‌ها‏ (qassâb-hâ) or قصابان‏ (qassâbân))
نظر	Noun	نظر • (nazar) (plural نظرها‏ (nazar-hâ))
قبول	Noun	قبول • (qabul)
موجود	Noun	موجود • (mowjud) (plural موجودات‏ (mowjudât))
خروج	Noun	خروج • (xoruj)
شو	Noun	شو • (šow, šav)
عنوان	Noun	عنوان • ('onvân)
دماغ	Noun	دماغ • (damâq)
دان	Noun	دان • (dân)
حصار	Noun	حصار • (hesâr) (plural حصار‌ها‏ (hesâr-hâ))
روند	Noun	روند • (ravand)
نارگیل	Noun	نارگیل • (nârgêl) (plural نارگیل‌ها‏ (nârgêl-hâ))
دفتر	Noun	دفتر • (daftar) (plural دفترها‏ (daftar-hâ) or دفاتر‏ (dafâter))
منع	Noun	منع • (man')
بالغ	Noun	بالغ • (bâleğ) (plural بالغان‏ (bâleğân) or بالغ‌ها‏ (bâleğ-hâ))
بالغ	Noun	بالغ • (bâloq)
غرب	Noun	غرب • (ğarb)
طول	Noun	طول • (tul)
تکیه‌گاه	Noun	تکیه‌گاه • (tekye-gâh) (plural تکیه‌گاه‌ها‏ (tekye-gâh-hâ) or تکیه‌گاهان‏ (tekye-gâhân))
جرم	Noun	جرم • (jorm)
جرم	Noun	جرم • (jerm)
کول	Noun	کول • (kul)
جنس	Noun	جنس • (jens) (plural اجناس‏ (ajnâs))
موسم	Noun	موسم • (mousem)
قرمز	Noun	قرمز • (qermez)
حبل	Noun	حبل • (habl)
تجر	Noun	تجر • (tajar)
کالا	Noun	کالا • (kâlâ) (plural کالاها‏ (kâlâ-hâ))
مروت	Noun	مروت • (morovvat)
منزل	Noun	منزل • (manzel) (plural منازل‏ (manâzel) or منزل‌ها‏ (manzel-hâ))
بوران	Noun	بوران • (burân) (plural بوران‌ها‏ (burân-hâ))
احترام	Noun	احترام • (ehterâm) (plural احترامات‏ (ehterâmât))
عقرب	Noun	عقرب • ('aqrab) (plural عقرب‌ها‏ ('aqrab-hâ) or عقارب‏)
بحث	Noun	بحث • (bahs)
سماق	Noun	سماق • (somâq)
تعلم	Noun	تعلم • (ta'allom)
مثلث	Noun	مثلث • (mosalas)
فانوس	Noun	فانوس • (fânus) (plural ‌فانوس‌ها‏)
بوره	Noun	بوره • (bure)
شارع	Noun	شارع • (šāre)
طفل	Noun	طفل • (tefl)
توجیه	Noun	توجیه • (towjih) (plural توجیه‌ها‏ (towjih-hâ) or توجیهات‏ (towjihât))
خردل	Noun	خردل • (xardal)
کردار	Noun	کردار • (kerdâr) (plural کردارها‏ (kerdâr-hâ))
ازدواج	Noun	ازدواج • (ezdevâj) (plural ازدواج‌ها‏ (ezdevâj-hâ))
سلاح	Noun	سلاح • (selâh) (plural سلاح‌ها‏ (selâh-hâ) or اسلحه‏ (aslahe))
فوتون	Noun	فوتون • (foton) (plural فوتون‌ها‏ (foton-hâ))
منخر	Noun	منخر • (manxar) (plural مناخر‏ (manâxer) or منخرین‏ (manxareyn))
عنصر	Noun	عنصر • ('onsor)
دله	Noun	دله • (dale)
هیزم	Noun	هیزم • (hêzom) (plural هیزم‌ها‏ (hêzom-hâ))
معمار	Noun	معمار • (me'mâr)
مال	Noun	مال • (mâl)
آدمکش	Noun	آدمکش • (âdamkoš) (plural آدمکش‌ها‏ (âdamkoš-hâ) or آدمکشان‏ (âdamkošân))
تل	Noun	تل • (tall)
ذکر	Noun	ذکر • (zakar) (plural ذکور‏ (zokur) or ذکرها‏ (zakar-hâ))
ذکر	Noun	ذکر • (zekr)
خاله	Noun	خاله • (xâle) (plural خاله‌ها‏ (xâle-hâ))
ثمر	Noun	ثمر • (samar)
مر	Noun	مر • (mor)
نیا	Noun	نیا • (niyâ) (plural نیاکان‏ (niyâkân))
توده	Noun	توده • (tude) (plural توده‌ها‏ (tude-hâ))
بلاى عشق‏	Noun	بلاى عشق‏ • (balâ-yi 'ešq) (plural بلاهای عشق‏)
پالایشگاه	Noun	پالایشگاه • (pâlâyešgâh) (plural پالایشگاه‌ها‏ (pâlâyešgâh-hâ))
وجود	Noun	وجود • (vojud)
بلد	Noun	بلد • (balad)
نقل	Noun	نقل • (noql)
نقل	Noun	نقل • (naql)
مهر	Noun	مهر • (mahr) (plural مهرها‏ (mahr-hâ))
مهر	Noun	مهر • (mohr) (plural مهرها‏ (mohr-hâ))
مهر	Noun	مهر • (mohr)
کژدم	Noun	کژدم • (každom) (plural کژدم‌ها‏ (každom-hâ))
کون	Noun	کون • (kun)
کون	Noun	کون • (kown)
ققنوس	Noun	ققنوس • (qaqnus) (plural ققنوس‌ها‏ (qaqnus-hâ))
سم	Noun	سم • (sam)
سم	Noun	سم • (som)
تبديل	Noun	تبديل • (tabdil)
ذبح	Noun	ذبح • (zebh)
فن	Noun	فن • (fann) (plural فن‌ها‏ (fann-hâ) or فنون‏ (fonun))
دارو	Noun	دارو • (dâru) (plural داروها‏ (dâru-hâ))
مقعد	Noun	مقعد • (maq'ad)
خزینه	Noun	خزینه • (xazine) (plural خزینه‌ها‏ (xazine-hâ))
الله	Noun	الله • (allâh)
فلسفه	Noun	فلسفه • (falsafe)
صلح	Noun	صلح • (solh)
قس	Noun	قس • (qos)
مجرد	Noun	مجرد • (mojarrad) (plural مجردها‏ (mojarrad-hâ) or مجردان‏ (mojarradân))
حرص	Noun	حرص • (hers)
بادکنک	Noun	بادکنک • (bâdkonak) (plural بادکنک‌ها‏ (bâdkonak-hâ))
رف	Noun	رف • (raf)
جناس	Noun	جناس • (jenâs)
حرف	Noun	حرف • (harf) (plural حرف‌ها‏ (harf-hâ) or حروف‏ (horuf))
حرف	Noun	حرف • (heraf)
ثبات	Noun	ثبات • (sabât)
آمریکایی	Noun	آمریکایی • (Âmrikâyi) (plural آمریکایی‌ها‏ (Âmrikâyi-hâ))
چنگال	Noun	چنگال • (čangâl) (plural چنگال‌ها‏ (čangâl-hâ))
سار	Noun	سار • (sār)
نفوذ	Noun	نفوذ • (nofuz)
عروس	Noun	عروس • (arus)
شرط	Noun	شرط • (šart) (plural شرایط‏ (šarâyet) or شرط‌ها‏ (šart-hâ))
جهاز	Noun	جهاز • (jahâz)
شوهرخاله‏	Noun	شوهرخاله‏ • (šowharxâle) (plural شوهرخاله‌ها‏ (šowharxâle-hâ))
مهندس	Noun	مهندس • (mohandes) (plural مهندسان‏ (mohandesân) or مهندسین‏ or مهندس‌ها‏ (mohandes-hâ))
قبض	Noun	قبض • (qabz)
حق	Noun	حق • (haqq) (plural حقوق‏)
قو	Noun	قو • (qu) (plural قوها‏ (qu-hâ))
نر	Noun	نر • (nar)
سد	Noun	سد • (sadd) (plural سدها‏ (sadd-hâ))
سد	Noun	سد • (sed)
ثابت	Noun	ثابت • (sâbet) (plural ثابت‌ها‏ (sâbet-hâ))
هیجان	Noun	هیجان • (hayajân) (plural هیجان‌ها‏ (hayajân-hâ))
تارا	Noun	تارا • (târâ)
فصول	Noun	فصول • (fosul) pl
اهل درد‏	Noun	اهل درد‏ • (ahl-i dard) (plural اهالی درد‏ (ahâli-ye dard))
ضرب	Noun	ضرب • (zarb)
او	Noun	او • (ow)
هیره	Noun	هیره • (hiré) (plural هیره‌ها‏ (hire-hấ))
علف	Noun	علف • ('alaf) (plural علف‌ها‏ ('alaf-hâ))
تفاضل	Noun	تفاضل • (tafâzol)
آرام	Noun	آرام • (ârâm)
کمند	Noun	کمند • (kamand) (plural کمندها‏ (kamand-hâ))
ورد	Noun	ورد • (vard)
ورد	Noun	ورد • (verd) (plural وردها‏ (verd-hâ) or اوراد‏ (owrâd))
سن	Noun	سن • (san)
سن	Noun	سن • (senn)
سن	Noun	سن • (sen)
جابر	Noun	جابر • (jâber)
اعتراف	Noun	اعتراف • (e'terâf) (plural اعترافات‏ (e'terâfât) or اعتراف‌ها‏ (e'terâf-hâ))
گوریل	Noun	گوریل • (goril) (plural گوریل‌ها‏ (goril-hâ))
جواب	Noun	جواب • (javâb) (plural جواب‌ها‏ (javâb-hâ))
طرف	Noun	طرف • (taraf)
انار	Noun	انار • (anâr)
کاربرد	Noun	کاربرد • (kârbord) (plural کاربردها‏ (kârbord-hâ))
فر	Noun	فر • (farr)
فر	Noun	فر • (for)
فر	Noun	فر • (fer)
سر	Noun	سر • (serr) (plural اسرار‏ (asrâr))
سر	Noun	سر • (ser)
برج	Noun	برج • (borj) (plural برج‌ها‏ (borj-hâ) or بروج‏)
نعوظ	Noun	نعوظ • (no'uz) (plural نعوظ‌ها‏ (no'uz-hâ))
افغان	Noun	افغان • (afğân)
فرود	Noun	فرود • (forud)
نماینده	Noun	نماینده • (namâyande) (plural نمایندگان‏ (namâyandegân))
عرفان	Noun	عرفان • (erfân)
کتل	Noun	کتل • (ketl)
ذهن	Noun	ذهن • (zehn)
زور	Noun	زور • (zowr)
زور	Noun	زور • (zur)
دستار	Noun	دستار • (dastâr) (plural دستارها‏ (dastâr-hâ))
سفر	Noun	سفر • (sefr)
سکه	Noun	سکه • (sekke) (plural سکه‌ها‏ (sekke-hâ))
بزاق	Noun	بزاق • (bozâq)
تنبور	Noun	تنبور • (tanbur) (plural تنبورها‏ (tanbur-hâ))
عارف	Noun	عارف • (âref)
قطر	Noun	قطر • (qotr) (plural قطرها‏ (qotr-hâ) or اقطار‏ (aqtâr))
تفاهم	Noun	تفاهم • (tafâhom)
بارود	Noun	بارود • (bârud)
پای	Noun	پای • (pây)
خلق	Noun	خلق • (xalq)
تابع	Noun	تابع • (tâbe')
عسل	Noun	عسل • ('asal)
جز	Noun	جز • (jaz)
جز	Noun	جز • (joz')
طاس	Noun	طاس • (tâs) (plural طاس‌ها‏ (tâs-hâ))
طاس	Noun	طاس • (tâs) (plural طاس‌ها‏ (tâs-hâ))
ضلع	Noun	ضلع • (zel') (plural اضلاع‏ (azlâ') or ضلع‌ها‏ (zel'-hâ))
جهاد	Noun	جهاد • (jehâd)
جمال	Noun	جمال • (jamâl)
بندر	Noun	بندر • (bandar)
نعش	Noun	نعش • (na'š)
ذات	Noun	ذات • (zât)
تو	Noun	تو • (tav, tow)
تو	Noun	تو • (tu)
واو	Noun	واو • (vâv)
انتقام	Noun	انتقام • (enteqâm)
خانه‌دار‏	Noun	خانه‌دار‏ • (xâne-dâr) (plural خانه‌داران‏ (xâne-dâr-ân) or خانه‌دارها‏ (xâne-dâr-hâ))
صوت	Noun	صوت • (sowt)
خصم	Noun	خصم • (xasm) (plural خصام‏ or خصوم‏)
مأمور	Noun	مأمور • (ma'mur) (plural مأموران‏ (ma'murân))
ناظر	Noun	ناظر • (nâzer)
خصوص	Noun	خصوص • (xosus)
دین	Noun	دین • (deyn)
نصف	Noun	نصف • (nesf)
بارش	Noun	بارش • (bâreš)
بخار	Noun	بخار • (boxār)
اس	Noun	اس • (es)
اس	Noun	اس • (es)
باور	Noun	باور • (bâvar) (plural باورها‏ (bâvar-hâ))
جبل	Noun	جبل • (jabal)
شغل	Noun	شغل • (šoğl)
زاد	Noun	زاد • (zâd)
عنایت	Noun	عنایت • ('enâyat)
تن	Noun	تن • (ton)
طلسم	Noun	طلسم • (telesm) (plural طلسم‌ها‏ (telesm-hâ))
زقاق	Noun	زقاق • (zoqāq)
قلا	Noun	قلا • (qelâ)
صفر	Noun	صفر • (sefr)
زر	Noun	زر • (zar)
زر	Noun	زر • (zor)
بوم	Noun	بوم • (bum)
تنور	Noun	تنور • (tannūr)
باران	Noun	باران • (bârân)
صرب	Noun	صرب • (Serb)
بر	Noun	بر • (bar)
بر	Noun	بر • (bar)
جبار	Noun	جبار • (jabâr)
سرب	Noun	سرب • (sorb)
ورق	Noun	ورق • (varaq)
نعناع	Noun	نعناع • (na'nâ')
آباد	Noun	آباد • (âbâd)
شراب	Noun	شراب • (šarâb)
نماز	Noun	نماز • (namâz) (plural نمازها‏ (namâz-hâ))
نون	Noun	نون • (nun) (plural نون‌ها‏ (nun-hâ))
نون	Noun	نون • (nun) (plural نون‌ها‏ (nun-hâ))
نوم	Noun	نوم • (nowm)
نوم	Noun	نوم • (num)
نوم	Noun	نوم • (nōm)
قسم	Noun	قسم • (qesm) (plural قسم‌ها‏ (qesm-hâ))
رعد	Noun	رعد • (ra'd)
عمه	Noun	عمه • ('amme) (plural عمه‌ها‏ ('amme-hâ))
زال	Noun	زال • (zâl)
صبر	Noun	صبر • (sabr)
ماش	Noun	ماش • (mâš)
تعارف	Noun	تعارف • (ta'ârof)
طلبه	Noun	طلبه • (talebe)
قدم	Noun	قدم • (qadam)
شرع	Noun	شرع • (shar')
هو	Noun	هو • (hū)
تمیز	Noun	تمیز • (tamiz)
زان	Noun	زان • (zân)
ترجمان	Noun	ترجمان • (tarjomân)
بت	Noun	بت • (bat) (plural بت‌ها‏ (bat-hâ))
بت	Noun	بت • (bot)
حس	Noun	حس • (hess) (plural حس‌ها‏ (hess-hâ))
ندا	Noun	ندا • (nedâ)
سوس	Noun	سوس • (sos)
متر	Noun	متر • (metr)
باذنجان	Noun	باذنجان • (bâzenjân)
لطف	Noun	لطف • (lotf)
سنتور	Noun	سنتور • (santur) (plural سنتورها‏ (santur-hâ))
رمضان	Noun	رمضان • (ramazân, ramzân)
عدد	Noun	عدد • (adad)
حال	Noun	حال • (hâl)
گونیا	Noun	گونیا • (guniyâ) (plural گونیاها‏ (guniyâ-hâ))
شنبه	Noun	شنبه • (šanbe)
تور	Noun	تور • (towar, tavar)
شوق	Noun	شوق • (šawq)
لغت	Noun	لغت • (lağat)
مداد	Noun	مداد • (medâd)
شهد	Noun	شهد • (šahd)
فحش	Noun	فحش • (fohš) (plural فحش‌ها‏ (fohš-hâ))
جوهر	Noun	جوهر • (jowhar) (plural جواهر‏ (javâher))
جوهر	Noun	جوهر • (jowhar) (plural جوهرها‏ (jowhar-hâ))
سود	Noun	سود • (sud) (plural سود‌ها‏ (sud-hâ))
سود	Noun	سود • (sud) (plural سود‌ها‏ (sud-hâ))
پیر	Noun	پیر • (pir)
پیر	Noun	پیر • (piyar)
حد	Noun	حد • (hadd)
کسشعر	Noun	کسشعر • (kos(e)še'r) (plural کسشعرها‏ (kos(e)še'r-hâ))
عاج	Noun	عاج • ('âj) (plural عاج‌ها‏ ('âj-hâ))
سحر	Noun	سحر • (sahar)
سحر	Noun	سحر • (sehr)
یکا	Noun	یکا • (yekâ) (plural یکاها‏ (yekâ-hâ))
آوازه	Noun	آوازه • (âvâze)
آوازه	Noun	آوازه • (âvâze)
بلع	Noun	بلع • (bal')
