vira	Noun	vira m (plural viras)
concreto	Noun	concreto m (plural concretos)
marabu	Noun	marabu m (plural marabus)
paus	Noun	paus m pl
fresta	Noun	fresta f (plural frestas)
alva	Noun	alva f (plural alvas)
ritual	Noun	ritual m (plural rituais)
ortografia	Noun	ortografia f (plural ortografias)
kana	Noun	kana m (uncountable)
bota	Noun	bota f (plural botas)
int	Noun	int m (plural ints)
these	Noun	these f (plural theses)
zoologia	Noun	zoologia f (usually uncountable, plural zoologias)
arcatura	Noun	arcatura f (plural arcaturas)
maraca	Noun	maraca f (plural maracas)
tsunami	Noun	tsunami m or f (in variation) (plural tsunamis)
insulto	Noun	insulto m (plural insultos)
cera	Noun	cera f (plural ceras)
abade	Noun	abade m (plural abades, feminine abadessa, feminine plural abadessas)
barca	Noun	barca f (plural barcas)
liga	Noun	liga f (plural ligas)
bem	Noun	bem m (plural bens)
brasa	Noun	brasa f (plural brasas)
ema	Noun	ema f (plural emas)
valsa	Noun	valsa f (plural valsas)
fino	Noun	fino m (plural finos)
bufo	Noun	bufo m (plural bufos)
bufo	Noun	bufo m (plural bufos)
dinar	Noun	dinar m (plural dinares)
vespa	Noun	vespa f (plural vespas)
apartheid	Noun	apartheid m (plural apartheids)
ele	Noun	ele m (plural eles)
musa	Noun	musa f (plural musas)
andrologia	Noun	andrologia f (plural andrologias)
feudo	Noun	feudo m (plural feudos)
brisa	Noun	brisa f (plural brisas)
bronze	Noun	bronze m (plural bronzes)
acervo	Noun	acervo m (plural acervos)
ata	Noun	ata f (plural atas)
ancora	Noun	ancora f (plural ancoras)
trema	Noun	trema m or f (nonstandard) (plural tremas)
cauda	Noun	cauda f (plural caudas)
demagogia	Noun	demagogia f (plural demagogias)
sabbat	Noun	sabbat m (plural sabbats)
zeta	Noun	zeta m (plural zetas)
mulo	Noun	mulo m (plural mulos, feminine mula, feminine plural mulas)
social	Noun	social m f (plural sociais)
estranho	Noun	estranho m (plural estranhos, feminine estranha, feminine plural estranhas)
bula	Noun	bula f (plural bulas)
ufo	Noun	ufo m (plural ufos)
areal	Noun	areal m (plural areais)
TPM	Noun	TPM f (plural TPMs)
mediana	Noun	mediana f (plural medianas)
diodo	Noun	diodo m (plural diodos)
agama	Noun	agama m (plural agamas)
charme	Noun	charme m (plural charmes)
Big Mac	Noun	Big Mac m (plural Big Macs)
valentia	Noun	valentia f (plural valentias)
simonia	Noun	simonia f (plural simonias)
noob	Noun	noob m f (plural noobs)
mana	Noun	mana f (plural manas)
cento	Noun	cento m (plural centos)
velho	Noun	velho m (plural velhos, feminine velha, feminine plural velhas)
teorema	Noun	teorema m (plural teoremas)
catar	Noun	catar m (plural catares)
catar	Noun	catar m (plural catares)
laguna	Noun	laguna f (plural lagunas)
clips	Noun	clips m (plural clips)
bridge	Noun	bridge m (uncountable)
mole	Noun	mole f (plural moles)
mole	Noun	mole m (plural moles)
humo	Noun	humo m (plural humos)
clava	Noun	clava f (plural clavas)
teoria	Noun	teoria f (plural teorias)
pai	Noun	pai m (plural pais)
naga	Noun	naga f (plural nagas)
uns	Noun	uns
tal	Noun	tal m f (plural tais)
cantautor	Noun	cantautor m (plural cantautores, feminine cantautora, feminine plural cantautoras)
dogma	Noun	dogma m (plural dogmas)
lona	Noun	lona f (plural lonas)
aspa	Noun	aspa f (plural aspas)
tatu	Noun	tatu m (plural tatus)
pianista	Noun	pianista m f (plural pianistas)
batatas	Noun	batatas
tribuna	Noun	tribuna f (plural tribunas)
loteria	Noun	loteria f (plural loterias)
darma	Noun	darma m (plural darmas)
alvorecer	Noun	alvorecer m (plural alvoreceres)
soror	Noun	soror f (plural sorores)
net	Noun	net f (uncountable)
entropia	Noun	entropia f (plural entropias)
media	Noun	media m pl (plurale tantum)
as	Noun	as m
hamburger	Noun	hamburger m (plural hamburgeres)
amo	Noun	amo m (plural amos)
balista	Noun	balista f (plural balistas)
base	Noun	base f (plural bases)
gnus	Noun	gnus
neologismo	Noun	neologismo m (plural neologismos)
topografia	Noun	topografia f (plural topografias)
panda	Noun	panda m (plural pandas)
chanson	Noun	chanson f (plural chansons)
suborno	Noun	suborno m (plural subornos)
bibe	Noun	bibe m (plural bibes)
pipa	Noun	pipa f (plural pipas)
banda	Noun	banda f (plural bandas)
banda	Noun	banda f (plural bandas)
penso	Noun	penso m (plural pensos)
família	Noun	família f (plural famílias)
bang	Noun	bang m (plural bangs)
angaria	Noun	angaria f (uncountable)
moles	Noun	moles m pl
chanceler	Noun	chanceler m f (plural chanceleres)
hamburgers	Noun	hamburgers
bur	Noun	bur m f (plural bures)
hakka	Noun	hakka m f (plural hakkas)
apologia	Noun	apologia f (plural apologias)
emu	Noun	emu m (plural emus)
pequeno	Noun	pequeno m (plural pequenos, feminine pequena, feminine plural pequenas)
som	Noun	som m (plural sons)
malandrino	Noun	malandrino m (plural malandrinos)
sinologia	Noun	sinologia f (uncountable)
nego	Noun	nego m (plural negos, feminine nega, feminine plural negas)
principal	Noun	principal m (plural principais)
castigo	Noun	castigo m (plural castigos)
jaro	Noun	jaro m (plural jaros)
uva	Noun	uva f (plural uvas)
inscrito	Noun	inscrito m (plural inscritos)
estafeta	Noun	estafeta m f (plural estafetas)
papa	Noun	papa m (plural papas)
papa	Noun	papa m (plural papas)
lente	Noun	lente f (plural lentes)
zen	Noun	zen m (uncountable)
agonista	Noun	agonista m (plural agonistas)
agonista	Noun	agonista m f (plural agonistas)
leu	Noun	leu m (plural leus)
badminton	Noun	badminton m (invariable)
alma	Noun	alma f (plural almas)
kefir	Noun	kefir m (plural kefirs)
angina	Noun	angina f (plural anginas)
nega	Noun	nega f (plural negas)
alpaca	Noun	alpaca f (plural alpacas)
abajur	Noun	abajur m (plural abajures)
hit	Noun	hit m (plural hits)
orgia	Noun	orgia f (plural orgias)
si	Noun	si m (plural sis)
vós	Noun	vós f
sala	Noun	sala f (plural salas)
batina	Noun	batina f (plural batinas)
doge	Noun	doge m (plural doges)
eufonia	Noun	eufonia f (plural eufonias)
slogan	Noun	slogan m (plural slogans)
turista	Noun	turista m f (plural turistas)
verde	Noun	verde m (plural verdes)
n	Noun	n m (plural n)
galena	Noun	galena f (plural galenas)
solar	Noun	solar m (plural solares)
olas	Noun	olas
marimba	Noun	marimba f (plural marimbas)
terapeuta	Noun	terapeuta m f (plural terapeutas)
cambio	Noun	cambio m (plural cambios)
pudor	Noun	pudor m (plural pudores)
prosa	Noun	prosa f (plural prosas)
muda	Noun	muda f (plural mudas)
muda	Noun	muda f (plural mudas)
harmonia	Noun	harmonia f (plural harmonias)
radar	Noun	radar m (plural radares)
supernova	Noun	supernova f (plural supernovas)
favor	Noun	favor m (plural favores)
belga	Noun	belga m f (plural belgas)
daimio	Noun	daimio m (plural daimios)
ar	Noun	ar m (plural ares)
cerne	Noun	cerne m (plural cernes)
despontar	Noun	despontar m (plural despontares)
poema	Noun	poema m (plural poemas)
folhado	Noun	folhado m (plural folhados)
siemens	Noun	siemens m (plural siemens)
dog	Noun	dog m (plural dogs)
um	Noun	um m (plural uns)
gola	Noun	gola f (plural golas)
clima	Noun	clima m (plural climas)
vida	Noun	vida f (plural vidas)
boboca	Noun	boboca m f (plural bobocas)
biomassa	Noun	biomassa f (plural biomassas)
semita	Noun	semita m f (plural semitas)
libra	Noun	libra f (plural libras)
fraseologia	Noun	fraseologia f (plural fraseologias)
rumor	Noun	rumor m (plural rumores)
grua	Noun	grua f (plural gruas)
mono	Noun	mono m (plural monos)
neurologia	Noun	neurologia f (plural neurologias)
actor	Noun	actor m (plural actores)
nabo	Noun	nabo m (plural nabos)
franco	Noun	franco m (plural francos)
kvas	Noun	kvas m or f (in variation) (plural kvas)
filologia	Noun	filologia f (uncountable)
gol	Noun	gol m (plural gols or gois (very rare))
fomes	Noun	fomes
gripe	Noun	gripe f (plural gripes)
nougat	Noun	nougat m (plural nougats)
material	Noun	material m (plural materiais)
turné	Noun	turné f (plural turnés)
satanista	Noun	satanista m f (plural satanistas)
drupa	Noun	drupa f (plural drupas)
somali	Noun	somali m f (plural somalis)
fratricida	Noun	fratricida m f (plural fratricidas)
foto	Noun	foto f (plural fotos)
playboy	Noun	playboy m (plural playboys)
seppuku	Noun	seppuku m (plural seppukus)
bife	Noun	bife m (plural bifes)
logar	Noun	logar m (plural logares)
monogamia	Noun	monogamia f (plural monogamias)
viola	Noun	viola f (plural violas)
filatelia	Noun	filatelia f (usually uncountable, plural filatelias)
murta	Noun	murta f (plural murtas)
is	Noun	is
hadith	Noun	hadith m (uncountable)
arena	Noun	arena f (plural arenas)
tia	Noun	tia f (plural tias) (masculine tio)
árabe	Noun	árabe m f (plural árabes)
teologia	Noun	teologia f (plural teologias)
seiva	Noun	seiva f (plural seivas)
tosse	Noun	tosse f (plural tosses)
corruptela	Noun	corruptela f (plural corruptelas)
selenologia	Noun	selenologia f (uncountable)
prisma	Noun	prisma m (plural prismas)
salmo	Noun	salmo m (plural salmos)
sexos	Noun	sexos
viga	Noun	viga f (plural vigas)
socialistas	Noun	socialistas
mongo	Noun	mongo m (plural mongos, feminine monga, feminine plural mongas)
lado	Noun	lado m (plural lados)
dobro	Noun	dobro m (plural dobros)
fá	Noun	fá m (plural fás)
delta	Noun	delta m (plural deltas)
sirena	Noun	sirena f (plural sirenas)
solista	Noun	solista m f (plural solistas)
gastronomia	Noun	gastronomia f (uncountable)
puma	Noun	puma m or f (nonstandard) (plural pumas)
seis	Noun	seis m (plural seis)
telega	Noun	telega f (plural telegas)
conserva	Noun	conserva f (plural conservas)
pano	Noun	pano m (plural panos)
primatas	Noun	primatas
filantropia	Noun	filantropia f (usually uncountable, plural filantropias)
taverna	Noun	taverna f (plural tavernas)
mez	Noun	mez m (plural mezes)
Demetra	Noun	Demetra f
bailes	Noun	bailes
rastas	Noun	rastas m
didgeridoo	Noun	didgeridoo m (plural didgeridoos)
pedal	Noun	pedal m (plural pedais)
fado	Noun	fado m (plural fados)
cio	Noun	cio m (plural cios)
feta	Noun	feta m (plural fetas)
aorta	Noun	aorta f (plural aortas)
vara	Noun	vara f (plural varas)
magia	Noun	magia f (plural magias)
rock	Noun	rock m (uncountable)
peru	Noun	peru m (plural perus)
materia	Noun	materia f (plural materias)
luta	Noun	luta f (plural lutas)
wasabi	Noun	wasabi m (uncountable)
container	Noun	container m (plural containers)
adar	Noun	adar m (plural adares)
brie	Noun	brie m (plural bries)
nefrologia	Noun	nefrologia f (uncountable)
link	Noun	link m (plural links)
atol	Noun	atol m (plural atóis)
champignon	Noun	champignon m (plural champignons)
nebulosa	Noun	nebulosa f (plural nebulosas)
liturgia	Noun	liturgia f (plural liturgias)
biosfera	Noun	biosfera f (plural biosferas)
ring	Noun	ring m (plural rings)
badana	Noun	badana m (plural badanas)
ego	Noun	ego m (plural egos)
poker	Noun	poker m (uncountable)
quisling	Noun	quisling m (plural quislings)
veja	Noun	veja f (plural vejas)
iras	Noun	iras
fórum	Noun	fórum m (plural fóruns)
resina	Noun	resina f (plural resinas)
transgressor	Noun	transgressor m (plural transgressores)
renome	Noun	renome m (plural renomes)
taxa	Noun	taxa f (plural taxas)
bigamia	Noun	bigamia f (plural bigamias)
balada	Noun	balada f (plural baladas)
mor	Noun	mor m (plural mores)
portal	Noun	portal m (plural portais)
ás	Noun	ás m (plural ases)
vila	Noun	vila f (plural vilas)
enigma	Noun	enigma m (plural enigmas)
selva	Noun	selva f (plural selvas)
okrug	Noun	okrug m (plural okrugs)
homogenia	Noun	homogenia f (plural homogenias)
epidemia	Noun	epidemia f (plural epidemias)
lego	Noun	lego m (plural legos)
major	Noun	major m (plural majores)
abort	Noun	abort m (plural aborts)
lio	Noun	lio m (plural lios)
patologia	Noun	patologia f (plural patologias)
briga	Noun	briga f (plural brigas)
caracter	Noun	caracter m (plural caracters)
satrapia	Noun	satrapia f (plural satrapias)
dilema	Noun	dilema m (plural dilemas)
seismologia	Noun	seismologia f (plural seismologias)
kit	Noun	kit m (plural kits)
ameba	Noun	ameba f (plural amebas)
pinta	Noun	pinta f (plural pintas)
pinta	Noun	pinta f (uncountable)
malva	Noun	malva f (plural malvas)
factor	Noun	factor m (plural factores)
terra	Noun	terra f (plural terras)
transversal	Noun	transversal f (plural transversais)
transversal	Noun	transversal m (plural transversais)
lise	Noun	lise f (plural lises)
ida	Noun	ida f (plural idas)
multimédia	Noun	multimédia m pl (plurale tantum)
viva	Noun	viva m (plural vivas)
privilegio	Noun	privilegio m (plural privilegios)
mar	Noun	mar m (plural mares)
lobo	Noun	lobo m (plural lobos, feminine loba, feminine plural lobas)
lobo	Noun	lobo m (plural lobos)
murros	Noun	murros m pl
mineralogia	Noun	mineralogia f (uncountable)
skin	Noun	skin f (plural skins)
tapir	Noun	tapir m (plural tapires)
energia	Noun	energia f (uncountable)
alta	Noun	alta f (plural altas)
bidé	Noun	bidé m (plural bidés)
miseria	Noun	miseria f (plural miserias)
dong	Noun	dong m (plural dongs)
patriarcha	Noun	patriarcha m (plural patriarchas)
banya	Noun	banya m or f (in variation) (plural banyas)
lá	Noun	lá m (plural lás)
lupanar	Noun	lupanar m (plural lupanares)
vala	Noun	vala f (plural valas)
barda	Noun	barda f (plural bardas)
ovas	Noun	ovas f
continuum	Noun	continuum m (plural continuuns or continua)
pandemia	Noun	pandemia f (plural pandemias)
mandarina	Noun	mandarina f (plural mandarinas)
chips	Noun	chips m pl (plurale tantum)
gaydar	Noun	gaydar m (uncountable)
negro	Noun	negro m (plural negros, feminine negra, feminine plural negras)
antena	Noun	antena f (plural antenas)
inquilino	Noun	inquilino m (plural inquilinos, feminine inquilina, feminine plural inquilinas)
meta	Noun	meta f (plural metas)
anodo	Noun	anodo m (plural anodos)
vago	Noun	vago m (plural vagos)
zelo	Noun	zelo m (plural zelos)
paranóia	Noun	paranóia f (plural paranóias)
café	Noun	café m (plural cafés)
artéria	Noun	artéria f (plural artérias)
sino	Noun	sino m (plural sinos)
colona	Noun	colona f (plural colonas)
rancor	Noun	rancor m (plural rancores)
ene	Noun	ene m (plural enes)
mal	Noun	mal m (plural males)
zoofobia	Noun	zoofobia f (plural zoofobias)
onyx	Noun	onyx m (plural onyx)
aimara	Noun	aimara m f (plural aimaras)
aimara	Noun	aimara m (uncountable)
mineral	Noun	mineral m (plural minerais)
boi	Noun	boi m (plural bois, feminine vaca, feminine plural vacas)
tora	Noun	tora f (plural toras)
lev	Noun	lev m (plural levs)
roller	Noun	roller m (plural rollers)
anemia	Noun	anemia f (plural anemias)
ala	Noun	ala f (plural alas)
termosfera	Noun	termosfera f (plural termosferas)
Reich	Noun	Reich m (plural Reichs)
sodomia	Noun	sodomia f (plural sodomias)
ralo	Noun	ralo m (plural ralos)
ralo	Noun	ralo m (plural ralos)
cheerleader	Noun	cheerleader f (plural cheerleaders)
rima	Noun	rima f (plural rimas)
arginina	Noun	arginina f
sigla	Noun	sigla f (plural siglas)
uno	Noun	uno m (uncountable)
regata	Noun	regata f (plural regatas)
bibliofilia	Noun	bibliofilia f (uncountable)
moai	Noun	moai m (plural moais)
champagne	Noun	champagne m (plural champagnes)
beagle	Noun	beagle m f (plural beagles)
fitness	Noun	fitness m (uncountable)
luas	Noun	luas f pl
malina	Noun	malina f (plural malinas)
reis	Noun	reis m
elegia	Noun	elegia f (plural elegias)
Gral	Noun	Gral m (plural Grais)
pulso	Noun	pulso m (plural pulsos)
nado	Noun	nado m (uncountable)
fermento	Noun	fermento m (plural fermentos)
sonar	Noun	sonar m (plural sonares)
ou	Noun	ou m (plural ous)
culpa	Noun	culpa f (plural culpas)
tenista	Noun	tenista m f (plural tenistas)
fibra	Noun	fibra f (plural fibras)
nazista	Noun	nazista m f (plural nazistas)
grivna	Noun	grivna f (plural grivnas)
teleologia	Noun	teleologia f (plural teleologias)
gastroenterologia	Noun	gastroenterologia f (uncountable)
múmia	Noun	múmia f (plural múmias)
crescendo	Noun	crescendo m (plural crescendos)
antropologia	Noun	antropologia f (plural antropologias)
cor	Noun	cor f (plural cores)
cor	Noun	cor m (plural cores)
sigma	Noun	sigma m (plural sigmas)
fotografia	Noun	fotografia f (plural fotografias)
sorgo	Noun	sorgo m (plural sorgos)
A	Noun	A m (plural As)
alergia	Noun	alergia f (plural alergias)
guarani	Noun	guarani m (plural guaranis)
guarani	Noun	guarani m f (plural guaranis)
spray	Noun	spray m (plural sprays)
cataplasma	Noun	cataplasma m or f (in variation) (plural cataplasmas)
bot	Noun	bot m (plural bots)
morena	Noun	morena f (plural morenas)
morena	Noun	morena f (plural morenas)
palmo	Noun	palmo m (plural palmos)
ambiofonia	Noun	ambiofonia f (uncountable)
elefante	Noun	elefante m (plural elefantes, feminine elefanta, feminine plural elefantas, feminine aliá, feminine plural aliás)
hasta	Noun	hasta f (plural hastas)
sambo	Noun	sambo m (uncountable)
pica	Noun	pica f (plural picas)
pica	Noun	pica f (plural picas)
tortura	Noun	tortura f (plural torturas)
uso	Noun	uso m (plural usos)
maço	Noun	maço m (plural maços)
carica	Noun	carica f (plural caricas)
chama	Noun	chama f (plural chamas)
raptor	Noun	raptor m (plural raptores, feminine raptora, feminine plural raptoras)
manivela	Noun	manivela f (plural manivelas)
ulna	Noun	ulna f (plural ulnas)
pele	Noun	pele f (plural peles)
aligátor	Noun	aligátor m (plural aligátores)
monotonia	Noun	monotonia f (plural monotonias)
pay	Noun	pay m (plural pays)
flauta	Noun	flauta f (plural flautas)
casula	Noun	casula f (plural casulas)
andas	Noun	andas f pl (plurale tantum)
os	Noun	os m pl
flamingo	Noun	flamingo m (plural flamingos)
inferno	Noun	inferno m (plural inferno)
pote	Noun	pote m (plural potes)
paranoia	Noun	paranoia f (plural paranoias)
neve	Noun	neve f (plural neves)
viking	Noun	viking m f (plural vikings)
symmetria	Noun	symmetria f (uncountable)
ola	Noun	ola f (plural olas)
dama	Noun	dama f (plural damas)
menta	Noun	menta f (plural mentas)
falla	Noun	falla f (plural fallas)
SMS	Noun	SMS m (plural SMS)
aula	Noun	aula f (plural aulas)
jugo	Noun	jugo m (plural jugos)
tomate	Noun	tomate m (plural tomates)
fama	Noun	fama f (plural famas)
agrobiologia	Noun	agrobiologia f (uncountable)
sorva	Noun	sorva f (plural sorvas)
dingo	Noun	dingo m (plural dingos)
grey	Noun	grey m (plural greys)
esse	Noun	esse m (plural esses)
auga	Noun	auga f (plural augas)
hobby	Noun	hobby m (plural hobbies or hobbys)
arinca	Noun	arinca f (plural arincas)
Abitur	Noun	Abitur m (uncountable)
domo	Noun	domo m (plural domos)
country	Noun	country m (uncountable)
Doppelgänger	Noun	Doppelgänger m (plural Doppelgängers)
dermatologia	Noun	dermatologia f (uncountable)
anagrama	Noun	anagrama m (plural anagramas)
cela	Noun	cela f (plural celas)
talo	Noun	talo m (plural talos)
jazz	Noun	jazz m (uncountable)
vê	Noun	vê m (plural vês)
toa	Noun	toa f (plural toas)
site	Noun	site m (plural sites)
forma	Noun	forma f (plural formas)
forma	Noun	forma f (plural formas)
forte	Noun	forte m (plural fortes)
sedan	Noun	sedan m (plural sedans)
pota	Noun	pota f (plural potas)
dó	Noun	dó m or f (in variation) (plural dós)
dó	Noun	dó m (plural dós)
pasta	Noun	pasta f (plural pastas)
sensor	Noun	sensor m (plural sensores)
pixel	Noun	pixel m (plural pixels or pixeis)
opereta	Noun	opereta f (plural operetas)
frenologia	Noun	frenologia f (uncountable)
samurai	Noun	samurai m (plural samurais)
tuna	Noun	tuna f (plural tunas)
bug	Noun	bug m (plural bugs)
palatal	Noun	palatal f (plural palatais)
serra	Noun	serra f (plural serras)
complexo	Noun	complexo m (plural complexos)
tema	Noun	tema m (plural temas)
lume	Noun	lume m (plural lumes)
luxo	Noun	luxo m (plural luxos)
quadra	Noun	quadra f (plural quadras)
cobra	Noun	cobra f (plural cobras)
chihuahua	Noun	chihuahua m f (plural chihuahuas)
ubuntu	Noun	ubuntu m (uncountable)
demos	Noun	demos
provincia	Noun	provincia f (plural provincias)
rega	Noun	rega f (plural regas)
torpor	Noun	torpor m (plural torpores)
quiz	Noun	quiz m (plural quizes)
literal	Noun	literal m (plural literais)
abscissa	Noun	abscissa f (plural abscissas)
montra	Noun	montra f (plural montras)
alas	Noun	alas
autobiografia	Noun	autobiografia f (plural autobiografias)
val	Noun	val m (plural vales)
firmware	Noun	firmware m (plural firmwares)
curry	Noun	curry m (uncountable)
revisor	Noun	revisor m (plural revisores, feminine revisora, feminine plural revisoras)
mira	Noun	mira f (plural miras)
raia	Noun	raia f (plural raias)
raia	Noun	raia f (plural raias)
gram	Noun	gram m (plural grãos)
castro	Noun	castro m (plural castros)
emblema	Noun	emblema m (plural emblemas)
cardinal	Noun	cardinal m (plural cardinais)
rus	Noun	rus m (plural rus)
á	Noun	á m (plural ás)
á	Noun	á f (plural ás)
pato	Noun	pato m (plural patos, feminine pata, feminine plural patas)
camping	Noun	camping m (plural campings)
eu	Noun	eu m (plural eus)
lacuna	Noun	lacuna f (plural lacunas)
tento	Noun	tento m (plural tentos)
abc	Noun	abc m (plural abcs)
aba	Noun	aba f (plural abas)
assyriologia	Noun	assyriologia f (uncountable)
barra	Noun	barra f (plural barras)
resto	Noun	resto m (plural restos)
hegemonia	Noun	hegemonia f (plural hegemonias)
curling	Noun	curling m (uncountable)
estima	Noun	estima f (plural estimas)
cu	Noun	cu m (plural cus)
sauna	Noun	sauna f (plural saunas)
fatwa	Noun	fatwa f (plural fatwas)
russofobia	Noun	russofobia f (plural russofobias)
e	Noun	e m (uncountable)
e	Noun	e m (uncountable)
vez	Noun	vez f (plural vezes)
figo	Noun	figo m (plural figos)
veto	Noun	veto m (plural vetos)
khmer	Noun	khmer m (plural khmers)
tapete	Noun	tapete m (plural tapetes)
fora	Noun	fora m (plural foras)
gazeta	Noun	gazeta f (plural gazetas)
pantera	Noun	pantera f (plural panteras)
afar	Noun	afar m (plural afar)
psi	Noun	psi m (plural psis)
cicuta	Noun	cicuta f (plural cicutas)
spin	Noun	spin m (plural spins)
afonia	Noun	afonia f (plural afonias)
doula	Noun	doula f (plural doulas)
resumo	Noun	resumo m (plural resumos)
barbas	Noun	barbas
bordel	Noun	bordel m (plural bordéis)
integral	Noun	integral f (plural integrais)
metamorfose	Noun	metamorfose f (plural metamorfoses)
etologia	Noun	etologia f (usually uncountable, plural etologias)
hangar	Noun	hangar m (plural hangares)
rom	Noun	rom m (plural rons or roms)
protelo	Noun	protelo m (plural protelos)
resistor	Noun	resistor m (plural resistores)
lima	Noun	lima f (plural limas)
lima	Noun	lima f (plural limas)
mafioso	Noun	mafioso m (plural mafiosos, feminine mafiosa, feminine plural mafiosas)
anusvara	Noun	anusvara m (plural anusvaras)
amygdala	Noun	amygdala f (plural amygdalas)
homeopatia	Noun	homeopatia f (uncountable)
impetigo	Noun	impetigo m (uncountable)
grana	Noun	grana f (uncountable)
treonina	Noun	treonina f (plural treoninas)
selo	Noun	selo m (plural selos)
ser	Noun	ser m (plural seres)
boy	Noun	boy m (plural boys)
boy	Noun	boy m (plural boys)
troposfera	Noun	troposfera f (plural troposferas)
anoitecer	Noun	anoitecer m (plural anoiteceres)
parecer	Noun	parecer m (plural pareceres)
zloty	Noun	zloty m (plural zlotys)
afazer	Noun	afazer m (plural afazeres)
marmelada	Noun	marmelada f (plural marmeladas)
afasia	Noun	afasia f (plural afasias)
caca	Noun	caca f (plural cacas)
modo	Noun	modo m (plural modos)
antroposofia	Noun	antroposofia f (uncountable)
sequestro	Noun	sequestro m (plural sequestros)
saldo	Noun	saldo m (plural saldos)
pascal	Noun	pascal m (plural pascais)
manicure	Noun	manicure f (plural manicures)
cesta	Noun	cesta f (plural cestas)
hindi	Noun	hindi m (uncountable)
tigre	Noun	tigre m (plural tigres, feminine tigresa, feminine plural tigresas)
nostalgia	Noun	nostalgia f (plural nostalgias)
alho	Noun	alho m (plural alhos)
coccyx	Noun	coccyx m (plural coccyx)
henry	Noun	henry m (plural henrys or henries)
francez	Noun	francez m (plural francezes, feminine franceza, feminine plural francezas)
altar	Noun	altar m (plural altares)
cara	Noun	cara f (plural caras)
cara	Noun	cara m (plural caras)
app	Noun	app f or m (in variation) (plural apps)
tochas	Noun	tochas
fala	Noun	fala f (plural falas)
fenomenologia	Noun	fenomenologia f (uncountable)
wiki	Noun	wiki f or m (less common) (plural wikis)
donaire	Noun	donaire m (plural donaires)
endorfina	Noun	endorfina f (plural endorfinas)
gay	Noun	gay m f (plural gays)
crack	Noun	crack m (plural cracks)
mel	Noun	mel m (plural meles or méis)
biogeografia	Noun	biogeografia f (uncountable)
impulsor	Noun	impulsor m (plural impulsores, feminine impulsora, feminine plural impulsoras)
notebook	Noun	notebook m (plural notebooks)
doido	Noun	doido m (plural doidos)
anestesiologia	Noun	anestesiologia f (uncountable)
vice	Noun	vice m f (plural vices)
pimento	Noun	pimento m (plural pimentos)
bogatir	Noun	bogatir m (plural bogatires)
airo	Noun	airo m (plural airos)
az	Noun	az m (plural azes)
fresa	Noun	fresa f (plural fresas)
iPod	Noun	iPod m (plural iPods)
gazela	Noun	gazela f (plural gazelas)
andron	Noun	andron m (plural androns)
tina	Noun	tina f (plural tinas)
jejuno	Noun	jejuno m (plural jejunos)
blusa	Noun	blusa f (plural blusas)
magyar	Noun	magyar m f (plural magyares)
santo	Noun	santo m (plural santos, feminine santa, feminine plural santas)
auctor	Noun	auctor m (plural auctores, feminine auctora, feminine plural auctoras)
polo	Noun	polo m (plural polos)
polo	Noun	polo m (plural polos)
polo	Noun	polo m (plural polos)
lenda	Noun	lenda f (plural lendas)
hera	Noun	hera f (plural heras)
aioli	Noun	aioli m (uncountable)
ketchup	Noun	ketchup m (plural ketchups)
saami	Noun	saami m f (plural sasmi)
single	Noun	single m (plural singles)
rubi	Noun	rubi m (plural rubis)
semifinal	Noun	semifinal f (plural semifinais)
fuga	Noun	fuga f (plural fugas)
fuga	Noun	fuga f (plural fugas)
rapper	Noun	rapper m f (plural rappers)
frango	Noun	frango m (plural frangos)
irlandez	Noun	irlandez m (plural irlandezes, feminine irlandeza, feminine plural irlandezas)
macla	Noun	macla f (plural maclas)
theoria	Noun	theoria f (plural theorias)
destino	Noun	destino m (plural destinos)
seita	Noun	seita f (plural seitas)
musical	Noun	musical m (plural musicais)
turu	Noun	turu m (plural turus)
geometria	Noun	geometria f (plural geometrias)
han	Noun	han m (plural han or hans)
calo	Noun	calo m (plural calos)
rim	Noun	rim m (plural rins)
fi	Noun	fi m (plural fi)
antologia	Noun	antologia f (plural antologias)
arista	Noun	arista f (plural aristas)
bateria	Noun	bateria f (plural baterias)
interior	Noun	interior m (plural interiores)
diploma	Noun	diploma m (plural diplomas)
interno	Noun	interno m (plural internos, feminine interna, feminine plural internas)
odor	Noun	odor m (plural odores)
sulco	Noun	sulco m (plural sulcos)
kero	Noun	kero m (plural keros)
pagode	Noun	pagode m (plural pagodes)
bis	Noun	bis m (plural bis)
bis	Noun	bis m f
horticultor	Noun	horticultor m (plural horticultores, feminine horticultora, feminine plural horticultoras)
teta	Noun	teta m (plural tetas)
teta	Noun	teta f (plural tetas)
d	Noun	d m
possessor	Noun	possessor m (plural possessores, feminine possessoras, feminine plural possessoras)
edredon	Noun	edredon m (plural edredons)
intercessor	Noun	intercessor m (plural intercessores, feminine intercessora, feminine plural intercessoras)
lula	Noun	lula f (plural lulas)
mania	Noun	mania f (plural manias)
soda	Noun	soda f (plural sodas)
zé	Noun	zé m (plural zés)
mandril	Noun	mandril m (plural mandris)
mandril	Noun	mandril m (plural mandris)
candomblé	Noun	candomblé m (plural candomblés)
vigia	Noun	vigia f (plural vigias)
vigia	Noun	vigia m f (plural vigias)
designer	Noun	designer m f (plural designers)
partner	Noun	partner m f (plural partners)
pi	Noun	pi m (plural pis)
agenda	Noun	agenda f (plural agendas)
perna	Noun	perna f (plural pernas)
aspargo	Noun	aspargo m (plural aspargos)
nn	Noun	nn m
magenta	Noun	magenta m (uncountable)
sector	Noun	sector m (plural sectores)
ukulele	Noun	ukulele m (plural ukuleles)
atmosfera	Noun	atmosfera f (plural atmosferas)
flato	Noun	flato m (plural flatos)
shorts	Noun	shorts m pl (plurale tantum)
zulu	Noun	zulu m f (plural zulus)
amusia	Noun	amusia f (uncountable)
sagu	Noun	sagu m (plural sagus)
metrologia	Noun	metrologia f (plural metrologias)
sutura	Noun	sutura f (plural suturas)
sabor	Noun	sabor m (plural sabores)
vergas	Noun	vergas
dioptria	Noun	dioptria f (plural dioptrias)
canna	Noun	canna f (plural cannas)
leita	Noun	leita f (plural leitas)
sonda	Noun	sonda f (plural sondas)
mitra	Noun	mitra f (plural mitras)
mitra	Noun	mitra m (plural mitras)
plantago	Noun	plantago m or f (in variation) (plural plantagos)
spa	Noun	spa m (plural spas)
vírus	Noun	vírus m (plural vírus)
ombudsman	Noun	ombudsman m (plural ombudsmen or ombudsmans or ombudsman)
verso	Noun	verso m (plural versos)
anal	Noun	anal m (plural anais)
anal	Noun	anal m (plural anais)
parricida	Noun	parricida m f (plural parricidas)
paz	Noun	paz f (plural pazes)
motel	Noun	motel m (plural motéis)
esteta	Noun	esteta m f (plural estetas)
mapa	Noun	mapa m or f (obsolete) (plural mapas)
reparo	Noun	reparo m (plural reparos)
markka	Noun	markka f (plural markkas)
rádio	Noun	rádio m (plural rádios)
rádio	Noun	rádio m (plural rádios)
rádio	Noun	rádio f (plural rádios)
rádio	Noun	rádio m (plural rádios)
iris	Noun	iris f (plural iris)
rap	Noun	rap m (plural raps)
tagalog	Noun	tagalog m (uncountable)
amento	Noun	amento m (plural amentos)
trama	Noun	trama f (plural tramas)
porca	Noun	porca f (plural porcas)
guru	Noun	guru m (plural gurus)
guru	Noun	guru m f (plural gurus)
commando	Noun	commando m (plural commandos)
matas	Noun	matas
torpedo	Noun	torpedo m (plural torpedos)
PM	Noun	PM f (plural PMs)
PM	Noun	PM m f (plural PMs)
esquecido	Noun	esquecido m (plural esquecidos, feminine esquecida, feminine plural esquecidas)
terminal	Noun	terminal m (plural terminais)
castor	Noun	castor m (plural castores)
anima	Noun	anima f (plural animas)
kuru	Noun	kuru m (uncountable)
costa	Noun	costa f (plural costas)
manual	Noun	manual m (plural manuais)
architectura	Noun	architectura f (plural architecturas)
cultura	Noun	cultura f (plural culturas)
reforma	Noun	reforma f (plural reformas)
real	Noun	real m (plural reais)
real	Noun	real m (plural reais)
real	Noun	real m (plural reais or réis)
inventor	Noun	inventor m (plural inventores, feminine inventora, feminine plural inventoras)
joio	Noun	joio m (uncountable)
cule	Noun	cule m (plural cules)
acta	Noun	acta f (plural actas)
oud	Noun	oud m (plural ouds)
pupa	Noun	pupa f (plural pupas)
mas	Noun	mas m (plural mas)
csi	Noun	csi m (plural csis)
gravlax	Noun	gravlax m (uncountable)
superior	Noun	superior m (plural superiores, feminine superiora, feminine plural superioras)
forja	Noun	forja f (plural forjas)
vime	Noun	vime m (plural vimes)
sonata	Noun	sonata f (plural sonatas)
sofista	Noun	sofista m f (plural sofistas)
bend	Noun	bend m (plural bends)
rubrica	Noun	rubrica f (plural rubricas)
osmose	Noun	osmose f (plural osmoses)
oftalmologia	Noun	oftalmologia f (uncountable)
vodca	Noun	vodca f (plural vodcas)
membrana	Noun	membrana f (plural membranas)
mure	Noun	mure m (plural mures)
fenol	Noun	fenol m (plural fenóis)
sapo	Noun	sapo m (plural sapos)
sono	Noun	sono m (plural sonos)
officina	Noun	officina f (plural officinas)
genealogia	Noun	genealogia f (plural genealogias)
flag	Noun	flag m or f (in variation) (plural flags)
litteratura	Noun	litteratura f (plural litteraturas)
cloaca	Noun	cloaca f (plural cloacas)
baobab	Noun	baobab m (plural baobabs)
oliva	Noun	oliva f (plural olivas)
paleografia	Noun	paleografia f (plural paleografias)
amarelo	Noun	amarelo m (plural amarelos)
dextra	Noun	dextra f (plural dextras)
massa	Noun	massa f (plural massas)
líder	Noun	líder m f (plural líderes)
gordo	Noun	gordo m (plural gordos, feminine gorda, feminine plural gordas)
vinda	Noun	vinda f (plural vindas)
vapor	Noun	vapor m (plural vapores)
bia	Noun	bia f (plural bias)
alga	Noun	alga f (plural algas)
etanol	Noun	etanol m (uncountable)
tango	Noun	tango m (plural tangos)
cardo	Noun	cardo m (plural cardos)
poder	Noun	poder m (plural poderes)
instrumental	Noun	instrumental m (plural instrumentais)
pavio	Noun	pavio m (plural pavios)
loba	Noun	loba f (plural lobas)
ensemble	Noun	ensemble m (plural ensembles)
saliva	Noun	saliva f (plural salivas)
coco	Noun	coco m (plural cocos)
humanista	Noun	humanista m f (plural humanistas)
afta	Noun	afta f (plural aftas)
walkie-talkie	Noun	walkie-talkie m (plural walkie-talkies)
isometria	Noun	isometria f (plural isometrias)
abdominoplastia	Noun	abdominoplastia f (plural abdominoplastias)
smoking	Noun	smoking m (plural smokings)
halo	Noun	halo m (plural halos)
qui	Noun	qui m (plural quis)
salina	Noun	salina f (plural salinas)
moca	Noun	moca m (plural mocas)
moca	Noun	moca f (plural mocas)
apicultor	Noun	apicultor m (plural apicultores, feminine apicultora, feminine plural apicultoras)
analysta	Noun	analysta m f (plural analystas)
vinha	Noun	vinha f (plural vinhas)
bardas	Noun	bardas f pl
geriatria	Noun	geriatria f (usually uncountable, plural geriatrias)
mesa	Noun	mesa f (plural mesas)
relevo	Noun	relevo m (plural relevos)
cappuccino	Noun	cappuccino m (plural cappuccinos or cappuccini (rare))
inuktitut	Noun	inuktitut m (uncountable)
madeira	Noun	madeira f (plural madeiras)
madeira	Noun	madeira m (uncountable)
meio	Noun	meio m (plural meios)
buffet	Noun	buffet m (plural buffets)
hypnose	Noun	hypnose f (uncountable)
cham	Noun	cham m (plural chãos)
vuvuzela	Noun	vuvuzela f (plural vuvuzelas)
temporal	Noun	temporal m (plural temporais)
temporal	Noun	temporal m (plural temporais)
komondor	Noun	komondor m (plural komondores)
gloria	Noun	gloria f (plural glorias)
toca	Noun	toca f (plural tocas)
papilla	Noun	papilla f (plural papillas)
funda	Noun	funda f (plural fundas)
meloa	Noun	meloa f (plural meloas)
academia	Noun	academia f (plural academias)
nirvana	Noun	nirvana m (plural nirvanas)
melodia	Noun	melodia f (plural melodias)
lixa	Noun	lixa f (plural lixas)
prata	Noun	prata f (uncountable)
prata	Noun	prata f (plural pratas)
fè	Noun	fè f (plural fès)
mistura	Noun	mistura f (plural misturas)
moda	Noun	moda f (plural modas)
virologia	Noun	virologia f (plural virologias)
fantasia	Noun	fantasia f (plural fantasias)
rampa	Noun	rampa f (plural rampas)
central	Noun	central f (plural centrais)
taras	Noun	taras
éter	Noun	éter m (plural éteres, obsolete plural éters)
antes	Noun	antes m pl (plurale tantum)
sebenta	Noun	sebenta f (plural sebentas)
vogal	Noun	vogal f (plural vogais)
foro	Noun	foro m (plural foros)
par	Noun	par m (plural pares)
rata	Noun	rata f (plural ratas)
clamor	Noun	clamor m (plural clamores)
ómega	Noun	ómega m (plural ómegas) (European orthography)
heterogamia	Noun	heterogamia f (uncountable)
taberna	Noun	taberna f (plural tabernas)
duna	Noun	duna f (plural dunas)
potencial	Noun	potencial m (plural potenciais)
tiramisu	Noun	tiramisu m (plural tiramisus)
antipatia	Noun	antipatia f (plural antipatias)
bentos	Noun	bentos m pl
bermuda	Noun	bermuda f (plural bermudas)
lógico	Noun	lógico m (plural lógicos)
agrafia	Noun	agrafia f (uncountable)
memoria	Noun	memoria f (plural memorias)
note	Noun	note m (plural notes)
osteopatia	Noun	osteopatia f (plural osteopatias)
japonas	Noun	japonas
abactor	Noun	abactor m (plural abactores, feminine abactora, feminine plural abactoras)
vitiligo	Noun	vitiligo m (uncountable)
tinctura	Noun	tinctura f (plural tincturas)
vitrina	Noun	vitrina f (plural vitrinas)
tumor	Noun	tumor m (plural tumores)
fortuna	Noun	fortuna f (plural fortunas)
pás	Noun	pás
chili	Noun	chili m (plural chilis)
custos	Noun	custos
longa	Noun	longa f (plural longas)
banana	Noun	banana f (plural bananas)
smog	Noun	smog m (uncountable)
autor	Noun	autor m (plural autores, feminine autora, feminine plural autoras)
tempero	Noun	tempero m (plural temperos)
mester	Noun	mester m (plural mesteres)
aroma	Noun	aroma m (plural aromas)
entomologia	Noun	entomologia f (plural entomologias)
rani	Noun	rani f (plural ranis)
sinfonia	Noun	sinfonia f (plural sinfonias)
hip-hop	Noun	hip-hop m (uncountable)
bile	Noun	bile f (uncountable)
artista	Noun	artista m f (plural artistas)
jogos	Noun	jogos m pl
pólo	Noun	pólo m (plural pólos)
armada	Noun	armada f (plural armadas)
tribologia	Noun	tribologia f (uncountable)
hans	Noun	hans m pl
onda	Noun	onda f (plural ondas)
sedes	Noun	sedes
peri	Noun	peri m (plural peris)
arboricultor	Noun	arboricultor m (plural arboricultores)
batuta	Noun	batuta f (plural batutas)
onze	Noun	onze m (plural onzes)
leite	Noun	leite m (plural leites)
area	Noun	area f (plural areas)
nandu	Noun	nandu m (plural nandus)
outsourcing	Noun	outsourcing m (uncountable)
ideal	Noun	ideal m (plural ideais)
mes	Noun	mes m (plural meses)
pitom	Noun	pitom m (plural pitons)
porcelana	Noun	porcelana f (plural porcelanas)
androfobia	Noun	androfobia f (plural androfobias)
ato	Noun	ato m (plural atos)
fonologia	Noun	fonologia f (plural fonologias)
reverso	Noun	reverso m (plural reversos)
sul	Noun	sul m (plural suis)
blues	Noun	blues m (plural blues)
figura	Noun	figura f (plural figuras)
monitor	Noun	monitor m (plural monitores, feminine monitora, feminine plural monitoras)
monitor	Noun	monitor m (plural monitores, feminine monitora, feminine plural monitoras)
lindo	Noun	lindo m (plural lindos, feminine linda, feminine plural lindas)
pausa	Noun	pausa f (plural pausas)
professor	Noun	professor m (plural professores, feminine professora, feminine plural professoras)
morsa	Noun	morsa f (plural morsas)
serva	Noun	serva
piano	Noun	piano m (plural pianos)
rottweiler	Noun	rottweiler m f (plural rottweilers)
cursor	Noun	cursor m (plural cursores)
seta	Noun	seta f (plural setas)
til	Noun	til m (plural tis or tiles)
clausura	Noun	clausura f (plural clausuras)
funk	Noun	funk m (uncountable)
funk	Noun	funk m (plural funks)
Affenpinscher	Noun	Affenpinscher m (plural Affenpinschers)
turbina	Noun	turbina f (plural turbinas)
skate	Noun	skate m (plural skates)
exterior	Noun	exterior m (plural exteriores)
mouse	Noun	mouse m (plural mouses)
feijoa	Noun	feijoa f (plural feijoas)
vector	Noun	vector m (plural vectores)
tom	Noun	tom m (plural tons)
mandola	Noun	mandola f (plural mandolas)
arca	Noun	arca f (plural arcas)
consumo	Noun	consumo m (plural consumos)
vento	Noun	vento m (plural ventos)
rola	Noun	rola f (plural rolas)
velar	Noun	velar f (plural velares)
periferia	Noun	periferia f (plural periferias)
tandem	Noun	tandem m (plural tandens)
columna	Noun	columna f (plural columnas)
e-mail	Noun	e-mail m (plural e-mails)
costas	Noun	costas f pl (plurale tantum)
costas	Noun	costas
grave	Noun	grave f (plural graves)
via	Noun	via f (plural vias)
via	Noun	via f (plural vias)
pilota	Noun	pilota f (plural pilotas)
taka	Noun	taka m (plural takas)
perua	Noun	perua f (plural peruas)
singular	Noun	singular m (plural singulares)
japa	Noun	japa m f (plural japas)
piromania	Noun	piromania f (uncountable)
popular	Noun	popular m (plural populares)
popular	Noun	popular f (plural populares)
filial	Noun	filial f (plural filiais)
madame	Noun	madame f (plural madames)
lucerna	Noun	lucerna f (plural lucernas)
sodomita	Noun	sodomita m f (plural sodomitas)
puta	Noun	puta f (plural putas)
bolha	Noun	bolha f (plural bolhas)
tornado	Noun	tornado m (plural tornados)
memória	Noun	memória f (plural memórias)
dendrologia	Noun	dendrologia f (uncountable)
metionina	Noun	metionina f (plural metioninas)
testo	Noun	testo m (plural testos)
alanina	Noun	alanina f (plural alaninas)
faraó	Noun	faraó m (plural faraós)
marina	Noun	marina f (plural marinas)
bala	Noun	bala f (plural balas)
blenda	Noun	blenda f (plural blendas)
tweet	Noun	tweet m (plural tweets)
lema	Noun	lema m (plural lemas)
tanatologia	Noun	tanatologia f (uncountable)
presidente	Noun	presidente m f (plural presidentes, feminine presidente, feminine plural presidentes, feminine presidenta (nonstandard), feminine plural presidentas)
lux	Noun	lux m (plural lux or luxes)
pyra	Noun	pyra f (plural pyras)
gato	Noun	gato m (plural gatos, feminine gata, feminine plural gatas)
merda	Noun	merda f (plural merdas)
merda	Noun	merda m f (plural merdas)
Ansatz	Noun	Ansatz m (plural Ansatz)
diesel	Noun	diesel m (uncountable)
biopsia	Noun	biopsia f (plural biopsias)
brunch	Noun	brunch m (plural brunches)
embargo	Noun	embargo m (plural embargos)
asna	Noun	asna f (plural asnas)
acaju	Noun	acaju m (plural acajus)
lucta	Noun	lucta f (plural luctas)
mala	Noun	mala f (plural malas)
pastel	Noun	pastel m (plural pastéis)
pipi	Noun	pipi m (plural pipis)
aligator	Noun	aligator m (plural aligatores)
titular	Noun	titular m (plural titulares)
shampoo	Noun	shampoo m (plural shampoos)
deus	Noun	deus m (plural deuses, feminine deusa, feminine plural deusas, feminine deia (poetic), feminine plural deias)
antropofagia	Noun	antropofagia f (plural antropofagias)
yda	Noun	yda f (plural ydas)
gelada	Noun	gelada f (plural geladas)
gelada	Noun	gelada m (plural geladas)
metanol	Noun	metanol m (uncountable)
fés	Noun	fés f pl
matula	Noun	matula f (plural matulas)
iguana	Noun	iguana f (plural iguanas)
magistratura	Noun	magistratura f (plural magistraturas)
pilar	Noun	pilar m (plural pilares)
caverna	Noun	caverna f (plural cavernas)
subwoofer	Noun	subwoofer m (plural subwoofers)
CD	Noun	CD m (plural CDs)
hora	Noun	hora f (plural horas)
assado	Noun	assado m (plural assados)
bibliografia	Noun	bibliografia f (plural bibliografias)
rena	Noun	rena f (plural renas)
anestesia	Noun	anestesia f (plural anestesias)
sarna	Noun	sarna f (plural sarnas)
sarna	Noun	sarna m f (plural sarnas)
moto	Noun	moto f (plural motos)
lanterna	Noun	lanterna f (plural lanternas)
pomada	Noun	pomada f (plural pomadas)
epistemologia	Noun	epistemologia f (uncountable)
sashimi	Noun	sashimi m (plural sashimis)
litografia	Noun	litografia f (plural litografias)
litosfera	Noun	litosfera f (plural litosferas)
afrodisia	Noun	afrodisia f (plural afrodisias)
história	Noun	história f (plural histórias)
erre	Noun	erre m (plural erres)
script	Noun	script m (plural scripts)
pirata	Noun	pirata m f (plural piratas)
silva	Noun	silva f (plural silvas)
diabetes	Noun	diabetes m or f (in variation) (uncountable)
alma mater	Noun	alma mater f (plural alma mater)
i	Noun	i m (plural is)
epidemiologia	Noun	epidemiologia f (usually uncountable, plural epidemiologias)
ponto	Noun	ponto m (plural pontos)
rede	Noun	rede f (plural redes)
anatomia	Noun	anatomia f (plural anatomias)
bombarda	Noun	bombarda f (plural bombardas)
paremiologia	Noun	paremiologia f (uncountable)
kulak	Noun	kulak m (plural kulaks)
brado	Noun	brado m (plural brados)
tiro	Noun	tiro m (plural tiros)
bananas	Noun	bananas
reta	Noun	reta f (plural retas)
coxa	Noun	coxa f (plural coxas)
coxa	Noun	coxa m f (plural coxas)
mayo	Noun	mayo m (plural mayos)
gel	Noun	gel m (plural géis or geles (rare))
mister	Noun	mister m (plural misteres)
mister	Noun	mister m (plural misters)
propis	Noun	propis m
mortal	Noun	mortal m f (plural mortais)
juta	Noun	juta f (plural jutas)
umlaut	Noun	umlaut m (plural umlauts)
aulas	Noun	aulas f pl
anorexia nervosa	Noun	anorexia nervosa f (uncountable)
face	Noun	face f (plural faces)
temperatura	Noun	temperatura f (plural temperaturas)
civil	Noun	civil m f (plural civis)
gala	Noun	gala f (plural galas)
placenta	Noun	placenta f (plural placentas)
doping	Noun	doping m (plural dopings)
tato	Noun	tato m (plural tatos)
popa	Noun	popa f (plural popas)
ode	Noun	ode f (plural odes)
total	Noun	total m (plural totais)
Madeira	Noun	Madeira m (plural Madeiras)
pita	Noun	pita m (plural pitas)
pita	Noun	pita f (plural pitas)
decibel	Noun	decibel m (plural decibéis)
pega	Noun	pega f (plural pegas)
pega	Noun	pega f (plural pegas)
pega	Noun	pega f (Portugal) or m (Brazil) (plural pegas)
pega	Noun	pega f (plural pegas)
boda	Noun	boda f (plural bodas)
bandera	Noun	bandera f (plural banderas)
protector	Noun	protector m (plural protectores, feminine protectora, feminine plural protectoras)
furor	Noun	furor m (plural furores)
data	Noun	data f (plural datas)
fervor	Noun	fervor m (plural fervores)
dramaturgia	Noun	dramaturgia f (plural dramaturgias)
capella	Noun	capella f (plural capellas)
hiragana	Noun	hiragana m (uncountable)
metil	Noun	metil m (plural metis)
tomografia	Noun	tomografia f (plural tomografias)
lar	Noun	lar m (plural lares)
radiografia	Noun	radiografia f (plural radiografias)
arsina	Noun	arsina f (uncountable)
ministro	Noun	ministro m (plural ministros, feminine ministra, feminine plural ministras)
nora	Noun	nora f (plural noras)
nora	Noun	nora f (plural noras)
morfologia	Noun	morfologia f (plural morfologias)
vigor	Noun	vigor m (plural vigores)
triumpho	Noun	triumpho m (plural triumphos)
manta	Noun	manta f (plural mantas)
octaedros	Noun	octaedros
auditor	Noun	auditor m (plural auditores, feminine auditora, feminine plural auditoras)
romani	Noun	romani m f (plural romanis)
romani	Noun	romani m (uncountable)
saga	Noun	saga f (plural sagas)
cubo	Noun	cubo m (plural cubos)
usura	Noun	usura f (plural usuras)
flocos	Noun	flocos
phi	Noun	phi m (plural phi)
cameraman	Noun	cameraman m (plural cameramen)
aura	Noun	aura f (plural auras)
candela	Noun	candela f (plural candelas)
diner	Noun	diner m (plural diners)
sopa	Noun	sopa f (plural sopas)
moa	Noun	moa f (plural moas)
pogrom	Noun	pogrom m (plural pogrons)
vate	Noun	vate m f (plural vates)
aino	Noun	aino m (uncountable)
decimal	Noun	decimal m (plural decimais)
mama	Noun	mama f (plural mamas)
saber	Noun	saber m (plural saberes)
mico	Noun	mico m (plural micos)
ria	Noun	ria f (plural rias)
coma	Noun	coma m (plural comas)
coma	Noun	coma f (plural comas)
zebra	Noun	zebra f (plural zebras)
propaganda	Noun	propaganda f (plural propagandas)
atlas	Noun	atlas m (plural atlas)
impeto	Noun	impeto m (plural impetos)
protesto	Noun	protesto m (plural protestos)
marra	Noun	marra f (plural marras)
set	Noun	set m (plural sets)
hindustani	Noun	hindustani m (uncountable)
bislama	Noun	bislama m (uncountable)
testa	Noun	testa f (plural testas)
frio	Noun	frio m (uncountable)
hypotheca	Noun	hypotheca f (plural hypothecas)
ronda	Noun	ronda f (plural rondas)
merenda	Noun	merenda f (plural merendas)
norma	Noun	norma f (plural normas)
comanda	Noun	comanda f (plural comandas)
casa	Noun	casa f (plural casas)
factura	Noun	factura f (plural facturas)
s	Noun	s m (plural s)
abiotrofia	Noun	abiotrofia f (uncountable)
asa	Noun	asa f (plural asas)
neurastenia	Noun	neurastenia f (plural neurastenias)
ergonomia	Noun	ergonomia f (uncountable)
hepatites	Noun	hepatites
ovo	Noun	ovo m (plural ovos)
guano	Noun	guano m (uncountable)
pavimento	Noun	pavimento m (plural pavimentos)
bingo	Noun	bingo m (plural bingos)
ontologia	Noun	ontologia f (plural ontologias)
gnu	Noun	gnu m (plural gnus)
status	Noun	status m (plural status)
mando	Noun	mando m (plural mandos)
collega	Noun	collega m f (plural collegas)
epifania	Noun	epifania f (plural epifanias)
Danbo	Noun	Danbo m (uncountable)
feedback	Noun	feedback m (plural feedbacks)
limnologia	Noun	limnologia f (uncountable)
angelologia	Noun	angelologia f (uncountable)
zeitgeist	Noun	zeitgeist m (plural zeitgeists)
consultor	Noun	consultor m (plural consultores, feminine consultora, feminine plural consultoras)
genitor	Noun	genitor m (plural genitores, feminine genitora, feminine plural genitoras)
dominó	Noun	dominó m (plural dominós)
defensor	Noun	defensor m (plural defensores, feminine defensora, feminine plural defensoras)
ré	Noun	ré m (plural rés)
ré	Noun	ré f (plural rés)
ré	Noun	ré f (plural rés)
profano	Noun	profano m (plural profanos, feminine profana, feminine plural profanas)
flora	Noun	flora f (plural floras)
roda	Noun	roda f (plural rodas)
cerca	Noun	cerca f (plural cercas)
trom	Noun	trom m (plural trons)
TV	Noun	TV f (plural TVs)
mundo	Noun	mundo m (plural mundos)
soja	Noun	soja f (plural sojas)
vaga	Noun	vaga f (plural vagas)
focos	Noun	focos
barman	Noun	barman m (plural barmans)
albinos	Noun	albinos
boom	Noun	boom m (plural booms)
rapto	Noun	rapto m (plural raptos)
histologia	Noun	histologia f (usually uncountable, plural histologias)
teres	Noun	teres m (plural teres)
tonga	Noun	tonga m (uncountable)
laser	Noun	laser m (plural lasers)
drive	Noun	drive m (plural drives)
miga	Noun	miga f (plural migas)
miga	Noun	miga f (plural migas)
camara	Noun	camara f (plural camaras)
kelvin	Noun	kelvin m (plural kelvins)
cego	Noun	cego m (plural cegos, feminine cega, feminine plural cegas)
baile	Noun	baile m (plural bailes)
enthusiasta	Noun	enthusiasta m f (plural enthusiastas)
balde	Noun	balde m (plural baldes)
grau	Noun	grau m (plural graus)
lavabo	Noun	lavabo m (plural lavabos)
maca	Noun	maca f (plural macas)
porta	Noun	porta f (plural portas)
akita	Noun	akita m f (plural akitas)
sacro	Noun	sacro m (plural sacros)
cena	Noun	cena f (plural cenas)
salpa	Noun	salpa f (plural salpas)
celeuma	Noun	celeuma f (plural celeumas)
volt	Noun	volt m (plural volts)
rifa	Noun	rifa f (plural rifas)
poetas	Noun	poetas
venda	Noun	venda f (plural vendas)
venda	Noun	venda f (plural vendas)
sommelier	Noun	sommelier m f (plural sommeliers)
rotor	Noun	rotor m (plural rotores)
officio	Noun	officio m (plural officios)
puto	Noun	puto m (plural putos)
niqab	Noun	niqab m (plural niqabs)
incesto	Noun	incesto m (plural incestos)
rival	Noun	rival m f (plural rivais)
reggae	Noun	reggae m (uncountable)
crista	Noun	crista f (plural cristas)
alça	Noun	alça f (plural alças)
humor	Noun	humor m (plural humores)
chef	Noun	chef m f (plural chefs)
perla	Noun	perla f (plural perlas)
robot	Noun	robot m (plural robots)
consolo	Noun	consolo m (plural consolos)
auto	Noun	auto m (plural autos)
auto	Noun	auto m (plural autos)
baba	Noun	baba f (plural babas)
visita	Noun	visita f (plural visitas)
comporta	Noun	comporta f (plural comportas)
confisco	Noun	confisco m (plural confiscos)
flip-flop	Noun	flip-flop m (plural flip-flops)
stop	Noun	stop m (plural stops)
clientela	Noun	clientela f (plural clientelas)
tremor	Noun	tremor m (plural tremores)
analogia	Noun	analogia f (plural analogias)
mousse	Noun	mousse f or m (nonstandard) (plural mousses)
lateral	Noun	lateral f (plural laterais)
lateral	Noun	lateral m f (plural laterais)
circulo	Noun	circulo m (plural circulos)
astrologia	Noun	astrologia f (plural astrologias)
cagão	Noun	cagão m (plural cagões)
matta	Noun	matta f (plural mattas)
bacon	Noun	bacon m (plural bacons)
newari	Noun	newari m (uncountable)
admissor	Noun	admissor m (plural admissores, feminine admissora, feminine plural admissoras)
tanga	Noun	tanga f (plural tangas)
lepra	Noun	lepra f (uncountable)
sibilo	Noun	sibilo m (plural sibilos)
buffer	Noun	buffer m (plural buffers)
design	Noun	design m (plural designs)
teosofia	Noun	teosofia f (plural teosofias)
realista	Noun	realista m f (plural realistas)
pata	Noun	pata f (plural patas)
pata	Noun	pata f (plural patas)
etnografia	Noun	etnografia f (plural etnografias)
fundo	Noun	fundo m (plural fundos)
bongo	Noun	bongo m (plural bongos)
sim	Noun	sim m (plural sins)
curare	Noun	curare m (uncountable)
yeti	Noun	yeti m (plural yetis)
geografia	Noun	geografia f (plural geografias)
festival	Noun	festival m (plural festivais)
colar	Noun	colar m (plural colares)
bemol	Noun	bemol m (plural bemóis)
telepatia	Noun	telepatia f (plural telepatias)
volta	Noun	volta f (plural voltas)
sumo	Noun	sumo m (plural sumos)
sumo	Noun	sumo m (plural sumos)
sumo	Noun	sumo m (uncountable)
ululo	Noun	ululo m (plural ululos)
harakiri	Noun	harakiri m (plural harakiris)
for	Noun	for m (plural fors)
cura	Noun	cura f (plural curas)
anno	Noun	anno m (plural annos)
mambo	Noun	mambo m (plural mambos)
admin	Noun	admin m f (plural admins)
atrofia	Noun	atrofia f (plural atrofias)
begónia	Noun	begónia f (plural begónias) (European orthography)
zanga	Noun	zanga f (plural zangas)
concubina	Noun	concubina f (plural concubinas)
house	Noun	house m
quadriga	Noun	quadriga f (plural quadrigas)
poro	Noun	poro m (plural poros)
deicida	Noun	deicida m f (plural deicidas)
bambu	Noun	bambu m (plural bambus)
anis	Noun	anis m (plural anises)
pluma	Noun	pluma f (plural plumas)
bunda	Noun	bunda f (plural bundas)
ablaut	Noun	ablaut m (plural ablauts)
urina	Noun	urina f (plural urinas)
dono	Noun	dono m (plural donos, feminine dona, feminine plural donas)
aspecto	Noun	aspecto m (plural aspectos)
trigonometria	Noun	trigonometria f (plural trigonometrias)
metalurgia	Noun	metalurgia f (usually uncountable, plural metalurgias)
cano	Noun	cano m (plural canos)
narval	Noun	narval m (plural narvais)
plural	Noun	plural m (plural plurais)
terminologia	Noun	terminologia f (plural terminologias)
cabo	Noun	cabo m (plural cabos)
cabo	Noun	cabo m (plural cabos)
bomba	Noun	bomba f (plural bombas)
a	Noun	a m (plural as)
apogeus	Noun	apogeus m
idiota	Noun	idiota m f (plural idiotas)
colher	Noun	colher f (plural colheres)
variz	Noun	variz f (plural varizes)
grao	Noun	grao m (plural graos)
morfina	Noun	morfina f (plural morfinas)
chakra	Noun	chakra m (plural chakras)
concerto	Noun	concerto m (plural concertos)
hall	Noun	hall m (plural halls)
wikipedista	Noun	wikipedista m f (plural wikipedistas)
AIDS	Noun	AIDS f (usually uncountable, plural AIDS)
hiatus	Noun	hiatus m (plural hiatus)
tais	Noun	tais m (uncountable)
ruga	Noun	ruga f (plural rugas)
libido	Noun	libido f (plural libidos)
maltez	Noun	maltez m (plural maltezes, feminine malteza, feminine plural maltezas)
ave	Noun	ave f (plural aves)
peseta	Noun	peseta f (plural pesetas)
glória	Noun	glória f (plural glórias)
van	Noun	van f (plural vans)
tequila	Noun	tequila f (plural tequilas)
cosmologia	Noun	cosmologia f (usually uncountable, plural cosmologias)
Ares	Noun	Ares m
barato	Noun	barato m (plural baratos)
flegma	Noun	flegma m or f (in variation) (plural flegmas)
fedorento	Noun	fedorento m (plural fedorentos, feminine fedorenta, feminine plural fedorentas)
twist	Noun	twist m (uncountable)
go	Noun	go m (uncountable)
mica	Noun	mica f (plural micas)
ido	Noun	ido m (uncountable)
manga	Noun	manga f (plural mangas)
manga	Noun	manga f (plural mangas)
hematologia	Noun	hematologia f (uncountable)
faro	Noun	faro m (plural faros)
fotosfera	Noun	fotosfera f (plural fotosferas)
kurta	Noun	kurta f (plural kurtas)
rutilo	Noun	rutilo m (plural rutilos)
vela	Noun	vela f (plural velas)
vela	Noun	vela f (plural velas)
aromaterapia	Noun	aromaterapia f (plural aromaterapias)
gelo	Noun	gelo m (plural gelos)
biologia	Noun	biologia f (plural biologias)
avar	Noun	avar m (uncountable)
avar	Noun	avar m f (plural avares)
conflicto	Noun	conflicto m (plural conflictos)
analgesia	Noun	analgesia f (plural analgesias)
próis	Noun	próis m pl
adem	Noun	adem m (plural adens)
intro	Noun	intro f (plural intros)
conductor	Noun	conductor m (plural conductores, feminine conductora, feminine plural conductoras)
tupla	Noun	tupla f (plural tuplas)
fio	Noun	fio m (plural fios)
estrada	Noun	estrada f (plural estradas)
smiley	Noun	smiley m (plural smileys)
farad	Noun	farad m (plural farads)
basalto	Noun	basalto m (uncountable)
expert	Noun	expert m f (plural experts)
entardecer	Noun	entardecer m (plural entardeceres)
pós	Noun	pós f (plural poses)
pós	Noun	pós m
gens	Noun	gens f (plural gens)
boros	Noun	boros
piercing	Noun	piercing m (plural piercings)
legenda	Noun	legenda f (plural legendas)
salva	Noun	salva f (plural salvas)
salva	Noun	salva f (plural salvas)
Nero	Noun	Nero m (plural Neros)
promo	Noun	promo m (plural promos)
nota	Noun	nota f (plural notas)
casta	Noun	casta f (plural castas)
melodrama	Noun	melodrama m (plural melodramas)
terror	Noun	terror m (plural terrores)
WC	Noun	WC m (plural WCs)
juvenis	Noun	juvenis m pl
ironia	Noun	ironia f (plural ironias)
bá	Noun	bá f (plural bás)
swahili	Noun	swahili m (uncountable)
gama	Noun	gama m (plural gamas)
dedo	Noun	dedo m (plural dedos)
bode	Noun	bode m (plural bodes)
kra	Noun	kra m (plural kras)
ratto	Noun	ratto m (plural rattos, feminine ratta, feminine plural rattas)
messias	Noun	messias m (plural messias)
cana	Noun	cana f (plural canas)
cana	Noun	cana f (plural canas)
cana	Noun	cana m f (plural canas)
iglu	Noun	iglu m (plural iglus)
trompete	Noun	trompete m (plural trompetes)
maxilla	Noun	maxilla f (plural maxillas)
tweed	Noun	tweed m (uncountable)
sena	Noun	sena f (plural senas)
militar	Noun	militar m (plural militares)
albino	Noun	albino m (plural albinos, feminine albina, feminine plural albinas)
ABC	Noun	ABC m (plural ABCs)
fax	Noun	fax m (plural faxes or fax)
tela	Noun	tela f (plural telas)
glitter	Noun	glitter m (uncountable)
lamento	Noun	lamento m (plural lamentos)
coca	Noun	coca f (plural cocas)
franchising	Noun	franchising m (uncountable)
feto	Noun	feto m (plural fetos)
feto	Noun	feto m (plural fetos)
rito	Noun	rito m (plural ritos)
radiologia	Noun	radiologia f (usually uncountable, plural radiologias)
folder	Noun	folder m (plural folders or folderes (rare))
pago	Noun	pago m (plural pagos)
croissant	Noun	croissant m (plural croissants)
percussor	Noun	percussor m (plural percussores, feminine percussora, feminine plural percussoras)
agorafobia	Noun	agorafobia f (plural agorafobias)
baclava	Noun	baclava f (plural baclavas)
home	Noun	home m (plural homes)
salsa	Noun	salsa f (plural salsas)
salsa	Noun	salsa f (uncountable)
haver	Noun	haver m (plural haveres)
zeugma	Noun	zeugma m (plural zeugmas)
potas	Noun	potas
bíblia	Noun	bíblia f (plural bíblias)
caco	Noun	caco m (plural cacos)
pedofilia	Noun	pedofilia f (plural pedofilias)
ideologia	Noun	ideologia f (plural ideologias)
dialectos	Noun	dialectos
organista	Noun	organista m f (plural organistas)
calma	Noun	calma f (plural calmas)
mito	Noun	mito m (plural mitos)
perda	Noun	perda f (plural perdas)
MacBook	Noun	MacBook m (plural MacBooks)
ruptura	Noun	ruptura f (plural rupturas) (Brazilian orthography)
nahuatl	Noun	nahuatl m (uncountable)
nahuatl	Noun	nahuatl m f (plural nahuatl)
bonde	Noun	bonde m (plural bondes)
vulgo	Noun	vulgo m (plural vulgos)
testes	Noun	testes
marga	Noun	marga f (plural margas)
skinhead	Noun	skinhead m f (plural skinheads)
nazis	Noun	nazis m f
servo	Noun	servo m (plural servos, feminine serva, feminine plural servas)
paleontologia	Noun	paleontologia f (plural paleontologias)
ok	Noun	ok m (plural oks)
euro	Noun	euro m (plural euros)
borda	Noun	borda f (plural bordas)
entalpia	Noun	entalpia f (plural entalpias)
etapa	Noun	etapa f (plural etapas)
brandy	Noun	brandy m (uncountable)
bibliometria	Noun	bibliometria f (uncountable)
teca	Noun	teca f (plural tecas)
asteroide	Noun	asteroide m (plural asteroides)
kart	Noun	kart m (plural karts)
tinta	Noun	tinta f (plural tintas)
demonologia	Noun	demonologia f (uncountable)
ursa	Noun	ursa f (plural ursas)
pneumonia	Noun	pneumonia f (plural pneumonias)
partitura	Noun	partitura f (plural partituras)
pena	Noun	pena f (plural penas)
pena	Noun	pena f (plural penas)
androide	Noun	androide m (plural androides)
otalgia	Noun	otalgia f (plural otalgias)
ama	Noun	ama f (plural amas)
extra	Noun	extra m (plural extras)
extra	Noun	extra m f (plural extras)
antinomia	Noun	antinomia f (plural antinomias)
pilo	Noun	pilo m (plural pilos)
manjar	Noun	manjar m (plural manjares)
braille	Noun	braille m (plural brailles)
utopia	Noun	utopia f (plural utopias)
mufti	Noun	mufti m (plural muftis)
tsar	Noun	tsar m (plural tsares, feminine tsarina, feminine plural tsarinas)
lapso	Noun	lapso m (plural lapsos)
machina	Noun	machina f (plural machinas)
asas	Noun	asas
are	Noun	are m (plural ares)
sonatina	Noun	sonatina f (plural sonatinas)
boca	Noun	boca f (plural bocas)
astronomia	Noun	astronomia f (plural astronomias)
balela	Noun	balela f (plural balelas)
estreito	Noun	estreito m (plural estreitos)
advento	Noun	advento m (plural adventos)
sebe	Noun	sebe f (plural sebes)
mol	Noun	mol m (plural mols or moles)
podcast	Noun	podcast m (plural podcasts)
samica	Noun	samica m (plural samicas)
mula	Noun	mula f (plural mulas)
curso	Noun	curso m (plural cursos)
blogosfera	Noun	blogosfera f (plural blogosferas)
u	Noun	u m (plural us)
bibliopola	Noun	bibliopola m f (plural bibliopolas)
parça	Noun	parça m f (plural parças)
franchise	Noun	franchise m (plural franchises)
stress	Noun	stress m (uncountable)
fel	Noun	fel f (uncountable)
pé	Noun	pé m (plural pés)
catapulta	Noun	catapulta f (plural catapultas)
continua	Noun	continua m
ambrosia	Noun	ambrosia f (plural ambrosias)
bi	Noun	bi m f (plural bis)
ganga	Noun	ganga f (plural gangas)
ganga	Noun	ganga f (plural gangas)
intelligentsia	Noun	intelligentsia f (plural intelligentsias)
titio	Noun	titio m (plural titios)
ananás	Noun	ananás m (plural ananases)
poligamia	Noun	poligamia f (plural poligamias)
albedo	Noun	albedo m (plural albedos)
aro	Noun	aro m (plural aros)
aro	Noun	aro m (plural aros)
problema	Noun	problema m (plural problemas)
aborto	Noun	aborto m (plural abortos)
messe	Noun	messe f (plural messes)
filipino	Noun	filipino m (plural filipinos, feminine filipina, feminine plural filipinas)
sacristia	Noun	sacristia f (plural sacristias)
ohm	Noun	ohm m (plural ohms)
urna	Noun	urna f (plural urnas)
klingon	Noun	klingon m (uncountable)
herpetologia	Noun	herpetologia f (uncountable)
jacto	Noun	jacto m (plural jactos)
borra	Noun	borra f (plural borras)
meles	Noun	meles
ortopedia	Noun	ortopedia f (uncountable)
apoplexia	Noun	apoplexia f (plural apoplexias)
totem	Noun	totem m (plural totens)
astronauta	Noun	astronauta m f (plural astronautas)
acatalepsia	Noun	acatalepsia f (uncountable)
vizinho	Noun	vizinho m (plural vizinhos, feminine vizinha, feminine plural vizinhas)
chato	Noun	chato m (plural chatos)
neon	Noun	neon m (uncountable)
holografia	Noun	holografia f (plural holografias)
barista	Noun	barista m f (plural baristas)
caviar	Noun	caviar m (plural caviares)
média	Noun	média f (plural médias)
média	Noun	média m pl (plurale tantum)
achar	Noun	achar m (plural achares)
medicina	Noun	medicina f (uncountable)
nono	Noun	nono m (plural nonos, feminine nona, feminine plural nonas)
lupa	Noun	lupa f (plural lupas)
antecessor	Noun	antecessor m (plural antecessores, feminine antecessora, feminine plural antecessoras)
sestra	Noun	sestra f (plural sestras)
foda	Noun	foda f (plural fodas)
agonia	Noun	agonia f (plural agonias)
gene	Noun	gene m
poeta	Noun	poeta m (plural poetas, feminine poetisa, feminine plural poetisas)
grapa	Noun	grapa f (plural grapas)
papila	Noun	papila f (plural papilas)
pornografia	Noun	pornografia f (plural pornografias)
rapina	Noun	rapina f (plural rapinas)
drink	Noun	drink m (plural drinks)
categoria	Noun	categoria f (plural categorias)
monografia	Noun	monografia f (plural monografias)
haiku	Noun	haiku m (plural haikus)
magma	Noun	magma m (plural magmas)
biga	Noun	biga f (plural bigas)
planeta	Noun	planeta m (plural planetas)
oferta	Noun	oferta f (plural ofertas)
harpa	Noun	harpa f (plural harpas)
mora	Noun	mora f (plural moras)
gorila	Noun	gorila m (plural gorilas)
stand	Noun	stand m (plural stands)
copo	Noun	copo m (plural copos)
parcela	Noun	parcela f (plural parcelas)
mola	Noun	mola f (plural molas)
tese	Noun	tese f (plural teses)
metro	Noun	metro m (plural metros)
metro	Noun	metro m (plural metros)
laptop	Noun	laptop m (plural laptops)
ni	Noun	ni f (plural nis)
frontal	Noun	frontal m (plural frontais)
top	Noun	top m (plural tops)
muro	Noun	muro m (plural muros)
golfista	Noun	golfista m f (plural golfistas)
thema	Noun	thema m (plural themas)
suspiro	Noun	suspiro m (plural suspiros)
gramas	Noun	gramas m pl
gramas	Noun	gramas f pl
seyta	Noun	seyta f (plural seytas)
tundra	Noun	tundra f (plural tundras)
alces	Noun	alces
dália	Noun	dália f (plural dálias)
aloe	Noun	aloe f (plural aloes)
dalit	Noun	dalit m f (plural dalits)
xerox	Noun	xerox m (plural xerox or xeroxes)
censor	Noun	censor m (plural censores, feminine censora, feminine plural censoras)
urra	Noun	urra m (plural urras)
signo	Noun	signo m (plural signos)
zero	Noun	zero m (plural zeros)
box	Noun	box m (plural boxes)
liquens	Noun	liquens m pl
nós	Noun	nós m pl
mirra	Noun	mirra f (usually uncountable, plural mirras)
mirra	Noun	mirra m f (plural mirras)
mirra	Noun	mirra f (plural mirras)
proxy	Noun	proxy m (plural proxies)
anta	Noun	anta f (plural antas)
anta	Noun	anta f (plural antas)
mongol	Noun	mongol m f (plural mongóis)
mappa	Noun	mappa m (plural mappas)
linguajar	Noun	linguajar m (plural linguajares)
forró	Noun	forró m (plural forrós)
samba	Noun	samba m (plural sambas)
sudoku	Noun	sudoku m (uncountable)
terrorista	Noun	terrorista m f (plural terroristas)
duo	Noun	duo m (plural duos)
heap	Noun	heap m or f (in variation) (plural heaps)
bazar	Noun	bazar m (plural bazares)
exorcista	Noun	exorcista m f (plural exorcistas)
rota	Noun	rota f (plural rotas)
tarifa	Noun	tarifa f (plural tarifas)
carpa	Noun	carpa f (plural carpas)
circo	Noun	circo m (plural circos)
credo	Noun	credo m (plural credos)
pito	Noun	pito m (plural pitos)
pito	Noun	pito m (plural pitos)
elles	Noun	elles m
olhar	Noun	olhar m (plural olhares)
trem	Noun	trem m (plural trens)
grama	Noun	grama f (plural gramas)
grama	Noun	grama m or f (nonstandard) (plural gramas)
rapa	Noun	rapa m f (plural rapas)
lugar	Noun	lugar m (plural lugares)
darwinista	Noun	darwinista m f (plural darwinistas)
tautologia	Noun	tautologia f (plural tautologias)
alien	Noun	alien m (plural aliens)
cepa	Noun	cepa f (plural cepas)
cal	Noun	cal m (plural cales or cais)
greve	Noun	greve f (plural greves)
myrrha	Noun	myrrha f (usually uncountable, plural myrrhas)
pera	Noun	pera f (plural peras)
pugna	Noun	pugna f (plural pugnas)
arsenal	Noun	arsenal m (plural arsenais)
agami	Noun	agami m f (plural agamis)
claro	Noun	claro m (plural claros)
divisor	Noun	divisor m (plural divisores)
larva	Noun	larva f (plural larvas)
fauna	Noun	fauna f (plural faunas)
brigada	Noun	brigada f (plural brigadas)
gabardine	Noun	gabardine f (plural gabardines)
character	Noun	character m (plural characteres)
tabu	Noun	tabu m (plural tabus)
idolatria	Noun	idolatria f (plural idolatrias)
axioma	Noun	axioma m (plural axiomas)
gris	Noun	gris m (uncountable)
chassi	Noun	chassi m (plural chassis)
prece	Noun	prece f (plural preces)
pressa	Noun	pressa f (plural pressas)
monstro	Noun	monstro m (plural monstros)
topologia	Noun	topologia f (plural topologias)
thorax	Noun	thorax m (plural thoraxes)
wok	Noun	wok f or m (less common) (plural woks)
cem	Noun	cem m (plural cem)
flúor	Noun	flúor m
copia	Noun	copia f (plural copias)
ira	Noun	ira f (plural iras)
tv	Noun	tv f (plural tvs)
misantropia	Noun	misantropia f (plural misantropias)
tragédia	Noun	tragédia f (plural tragédias)
katakana	Noun	katakana m (uncountable)
odontologia	Noun	odontologia f (uncountable)
tara	Noun	tara f (plural taras)
pus	Noun	pus m (uncountable)
demo	Noun	demo m (plural demos)
demo	Noun	demo m (plural demos)
vista	Noun	vista f (plural vistas)
amor	Noun	amor m (plural amores)
panos	Noun	panos
phlegma	Noun	phlegma f (plural phlegmas)
manto	Noun	manto m (plural mantos)
trava	Noun	trava f (plural travas)
causa	Noun	causa f (plural causas)
dia	Noun	dia m (plural dias)
capital	Noun	capital f (plural capitais)
capital	Noun	capital m (plural capitais)
menestrel	Noun	menestrel m (plural menestréis)
gula	Noun	gula f (plural gulas)
jato	Noun	jato m (plural jatos)
ud	Noun	ud m (plural uds)
tempo	Noun	tempo m (plural tempos)
censura	Noun	censura f (uncountable)
soul	Noun	soul m (uncountable)
rixa	Noun	rixa f (plural rixas)
prostituta	Noun	prostituta f (plural prostitutas)
brinde	Noun	brinde m (plural brindes)
novena	Noun	novena f (plural novenas)
ária	Noun	ária f (plural árias)
burla	Noun	burla f (plural burlas)
tabela	Noun	tabela f (plural tabelas)
canto	Noun	canto m (plural cantos)
canto	Noun	canto m (plural cantos)
beta	Noun	beta f (plural betas)
beta	Noun	beta f (plural betas)
altimetria	Noun	altimetria f (plural altimetrias)
animar	Noun	animar m (plural animar)
morto	Noun	morto m (plural mortos, feminine morta, feminine plural mortas)
pijama	Noun	pijama m (plural pijamas)
hagiografia	Noun	hagiografia f (plural hagiografias)
psychiatra	Noun	psychiatra m f (plural psychiatras)
sake	Noun	sake m (plural sakes)
etiologia	Noun	etiologia f (plural etiologias)
spam	Noun	spam m (plural spans)
dysenteria	Noun	dysenteria f (plural dysenterias)
jantar	Noun	jantar m (plural jantares)
paleta	Noun	paleta f (plural paletas)
panorama	Noun	panorama m (plural panoramas)
machete	Noun	machete m (plural machetes)
agricultor	Noun	agricultor m (plural agricultores, feminine agricultora, feminine plural agricultoras)
oca	Noun	oca f (plural ocas)
orca	Noun	orca f (plural orcas)
dupla	Noun	dupla f (plural duplas)
balsa	Noun	balsa f (plural balsas)
hobbit	Noun	hobbit m f (plural hobbits)
molde	Noun	molde m (plural moldes)
predio	Noun	predio m (plural predios)
pista	Noun	pista f (plural pistas)
rupia	Noun	rupia f (plural rupias)
marxista	Noun	marxista m f (plural marxistas)
tesla	Noun	tesla m (plural teslas)
karaoke	Noun	karaoke m (plural karaokes)
janota	Noun	janota m f (plural janotas)
aikido	Noun	aikido m (uncountable)
trado	Noun	trado m (plural trados)
abasia	Noun	abasia f (plural abasias)
androceu	Noun	androceu m (plural androceus)
thing	Noun	thing m f (plural things)
papo	Noun	papo m (plural papos)
bar	Noun	bar m (plural bares)
bar	Noun	bar m (plural bars)
timer	Noun	timer m (plural timers)
kuna	Noun	kuna m or f (in variation) (plural kunas)
voz	Noun	voz f (plural vozes)
show	Noun	show m (plural shows)
manes	Noun	manes m pl (plurale tantum)
interesse	Noun	interesse m (plural interesses)
voos	Noun	voos
rua	Noun	rua f (plural ruas)
trilogia	Noun	trilogia f (plural trilogias)
luo	Noun	luo m (plural luo)
minimalista	Noun	minimalista m f (plural minimalistas)
jihad	Noun	jihad m (plural jihads)
turma	Noun	turma f (plural turmas)
mato	Noun	mato m (plural matos)
latrina	Noun	latrina f (plural latrinas)
agar-agar	Noun	agar-agar m (plural agar-agares)
amplexo	Noun	amplexo m (plural amplexos)
juvenil	Noun	juvenil m (plural juvenis)
turba	Noun	turba f (plural turbas)
gray	Noun	gray m (plural grays)
gray	Noun	gray m (plural grays)
alegoria	Noun	alegoria f (plural alegorias)
nim	Noun	nim m (plural nins)
nim	Noun	nim m (plural nins)
empatia	Noun	empatia f (plural empatias)
sova	Noun	sova f (plural sovas)
concurso	Noun	concurso m (plural concursos)
direito	Noun	direito m (plural direitos)
copta	Noun	copta m (uncountable)
copta	Noun	copta m f (plural coptas)
lata	Noun	lata f (plural latas)
tusa	Noun	tusa f (plural tusas)
tabella	Noun	tabella f (plural tabellas)
gerontologia	Noun	gerontologia f (uncountable)
tortas	Noun	tortas
bit	Noun	bit m (plural bits)
agrimensor	Noun	agrimensor m (plural agrimensores, feminine agrimensora, feminine plural agrimensoras)
iBook	Noun	iBook m (plural iBooks)
gangster	Noun	gangster m f (plural gangsters)
alternativa	Noun	alternativa f (plural alternativas)
ninja	Noun	ninja m f (plural ninjas)
cafeteria	Noun	cafeteria f (plural cafeterias)
pantomima	Noun	pantomima f (plural pantomimas)
alogia	Noun	alogia f (plural alogias)
sepultura	Noun	sepultura f (plural sepulturas)
mitologia	Noun	mitologia f (plural mitologias)
colo	Noun	colo m (plural colos)
colo	Noun	colo m (plural colos)
sola	Noun	sola f (plural solas)
creatura	Noun	creatura f (plural creaturas)
virtuoso	Noun	virtuoso m (plural virtuosos, feminine virtuosa, feminine plural virtuosas)
virtuoso	Noun	virtuoso m (plural virtuosos, feminine virtuosa, feminine plural virtuosas)
mano	Noun	mano m (plural manos, feminine mana, feminine plural manas)
tuga	Noun	tuga m f (plural tugas)
adutor	Noun	adutor m (plural adutores)
lua	Noun	lua f (plural luas)
aleta	Noun	aleta f (plural aletas)
calor	Noun	calor m (plural calores)
navajo	Noun	navajo m f (plural navajos)
navajo	Noun	navajo m (uncountable)
cais	Noun	cais m (plural cais)
cais	Noun	cais f
pop	Noun	pop m (uncountable)
aguona	Noun	aguona f (uncountable)
querela	Noun	querela f (plural querelas)
pila	Noun	pila f (plural pilas)
folk	Noun	folk m (uncountable)
meteorologia	Noun	meteorologia f (plural meteorologias)
freestyle	Noun	freestyle m (uncountable)
lictor	Noun	lictor m (plural lictores)
vinil	Noun	vinil m (plural vinis)
ayran	Noun	ayran m (plural ayrans)
sentina	Noun	sentina f (plural sentinas)
fobia	Noun	fobia f (plural fobias)
sol	Noun	sol m (plural sóis)
sol	Noun	sol m (plural sóis)
polícia	Noun	polícia f (plural polícias)
yurt	Noun	yurt f (plural yurts)
lutos	Noun	lutos
tolo	Noun	tolo m (plural tolos, feminine tola, feminine plural tolas)
bambus	Noun	bambus
caras	Noun	caras
repto	Noun	repto m (plural reptos)
kamikaze	Noun	kamikaze m (plural kamikazes)
determinado	Noun	determinado m (plural determinados)
patria	Noun	patria f (plural patrias)
nylon	Noun	nylon m (uncountable)
torta	Noun	torta f (plural tortas)
trol	Noun	trol m (plural trols)
oficial	Noun	oficial m (plural oficiais, feminine oficiala, feminine plural oficialas)
anoa	Noun	anoa m or f (in variation) (plural anoas)
bonito	Noun	bonito m (plural bonitos)
kiwi	Noun	kiwi m (plural kiwis)
carpo	Noun	carpo m (plural carpos)
demografia	Noun	demografia f (uncountable)
teste	Noun	teste m (plural testes)
teste	Noun	teste m (plural testes)
ainu	Noun	ainu m f (plural ainus)
efe	Noun	efe m (plural efes)
ó	Noun	ó m (plural ós)
antropometria	Noun	antropometria f (plural antropometrias)
golf	Noun	golf m (uncountable)
piratas	Noun	piratas
pastinaca	Noun	pastinaca f (plural pastinacas)
solas	Noun	solas f pl
buda	Noun	buda m (plural budas)
cautela	Noun	cautela f (plural cautelas)
galego	Noun	galego m (plural galegos, feminine galega, feminine plural galegas)
este	Noun	este m (uncountable)
maxillar	Noun	maxillar m (plural maxillares)
khat	Noun	khat m (plural khats)
pá	Noun	pá f (plural pás)
pá	Noun	pá m (uncountable)
telugu	Noun	telugu m (uncountable)
lama	Noun	lama f (uncountable)
lama	Noun	lama m (plural lamas)
lama	Noun	lama m or f (in variation) (plural lamas)
ghetto	Noun	ghetto m (plural ghettos)
planta	Noun	planta f (plural plantas)
manduco	Noun	manduco m (plural manducos)
manduco	Noun	manduco m (plural manducos)
festa	Noun	festa f (plural festas)
rial	Noun	rial m (plural riais)
aperto	Noun	aperto m (plural apertos)
vespera	Noun	vespera f (plural vesperas)
whisky	Noun	whisky m (plural whiskys)
kras	Noun	kras
bruma	Noun	bruma f (plural brumas)
elo	Noun	elo m (plural elos)
parentes	Noun	parentes
progenitor	Noun	progenitor m (plural progenitores, feminine progenitora, feminine plural progenitoras)
ionosfera	Noun	ionosfera f (plural ionosferas)
general	Noun	general m (plural generais, feminine generala, feminine plural generalas)
meses	Noun	meses
comer	Noun	comer m (plural comeres)
germanitas	Noun	germanitas
villa	Noun	villa f (plural villas)
azur	Noun	azur m (plural azures)
saite	Noun	saite m (plural saites)
maestro	Noun	maestro m (plural maestros)
lazer	Noun	lazer m (plural lazeres)
tilaka	Noun	tilaka f (plural tilakas)
modem	Noun	modem m (plural modems or modens)
cratera	Noun	cratera f (plural crateras)
fios	Noun	fios
amurca	Noun	amurca f (plural amurcas)
feio	Noun	feio m (plural feios, feminine feia, feminine plural feias)
roentgen	Noun	roentgen m (plural roentgens)
Hera	Noun	Hera f
piso	Noun	piso m (plural pisos)
droga	Noun	droga f (plural drogas)
leva	Noun	leva f (plural levas)
Gauleiter	Noun	Gauleiter m (plural Gauleiters or Gauleiter)
grego	Noun	grego m (plural gregos, feminine grega, feminine plural gregas)
seno	Noun	seno m (plural senos)
urologia	Noun	urologia f (uncountable)
conforto	Noun	conforto m (plural confortos)
runa	Noun	runa f (plural runas)
porre	Noun	porre m (plural porres)
decoro	Noun	decoro m (plural decoros)
wat	Noun	wat m (plural wats)
piti	Noun	piti m (plural pitis)
tumba	Noun	tumba f (plural tumbas)
cover	Noun	cover m or f (rare) (plural coveres)
alfa	Noun	alfa f (plural alfas)
valo	Noun	valo m (plural valos)
boa	Noun	boa f (plural boas)
boa	Noun	boa f (plural boas)
aurora	Noun	aurora f (plural auroras)
metodista	Noun	metodista m f (plural metodistas)
pária	Noun	pária m f (plural párias)
confessor	Noun	confessor m (plural confessores, feminine confessora, feminine plural confessoras)
missa	Noun	missa f (plural missas)
rosa	Noun	rosa f (plural rosas)
rosa	Noun	rosa m (plural rosas)
glutamina	Noun	glutamina f (plural glutaminas)
banjo	Noun	banjo m (plural banjos)
bibliotheca	Noun	bibliotheca f (plural bibliothecas)
quadro	Noun	quadro m (plural quadros)
pia	Noun	pia f (plural pias)
kaftan	Noun	kaftan m (plural kaftans)
heliolatria	Noun	heliolatria f (uncountable)
lista	Noun	lista f (plural listas)
euforia	Noun	euforia f (plural euforias)
mi	Noun	mi m (plural mis)
camembert	Noun	camembert m (plural camemberts)
ascensor	Noun	ascensor m (plural ascensores)
jugular	Noun	jugular f (plural jugulares)
local	Noun	local m (plural locais)
finale	Noun	finale m (plural finales)
mantra	Noun	mantra m (plural mantras)
apatia	Noun	apatia f (plural apatias)
strip	Noun	strip m (plural strips)
patriota	Noun	patriota m f (plural patriotas)
workshop	Noun	workshop m (plural workshops)
basenji	Noun	basenji m (plural basenjis)
abdominal	Noun	abdominal m (plural abdominais)
tremura	Noun	tremura f (plural tremuras)
carne	Noun	carne f (plural carnes)
lodo	Noun	lodo m (plural lodos)
avec	Noun	avec m f (plural avecs)
aspirinas	Noun	aspirinas
jade	Noun	jade m (plural jades)
gomo	Noun	gomo m (plural gomos)
valor	Noun	valor m (plural valores)
linda	Noun	linda f (plural lindas)
pomo	Noun	pomo m (plural pomos)
bicha	Noun	bicha f (plural bichas)
borrachas	Noun	borrachas f pl
slalom	Noun	slalom m (plural slaloms or slalons)
vina	Noun	vina f (plural vinas)
salamandra	Noun	salamandra f (plural salamandras)
iPhone	Noun	iPhone m (plural iPhones)
termos	Noun	termos
myrra	Noun	myrra f (usually uncountable, plural myrras)
brana	Noun	brana f (plural branas)
tinnitus	Noun	tinnitus m (uncountable)
mais	Noun	mais m (plural mais)
scanner	Noun	scanner m (plural scanners)
valva	Noun	valva f (plural valvas)
peso	Noun	peso m (plural pesos)
peso	Noun	peso m (plural pesos)
lambda	Noun	lambda m (plural lambdas)
pavor	Noun	pavor m (plural pavores)
litania	Noun	litania f (plural litanias)
escuro	Noun	escuro m (uncountable)
sina	Noun	sina f (plural sinas)
wombat	Noun	wombat m (plural wombats)
fera	Noun	fera f (plural feras)
seu	Noun	seu m (uncountable)
physica	Noun	physica f (plural physicas)
sal	Noun	sal m (plural sais)
sal	Noun	sal m (plural sais)
perus	Noun	perus
abulia	Noun	abulia f (uncountable)
mata	Noun	mata f (plural matas)
herpes	Noun	herpes m or f (in variation) (plural herpes)
imperial	Noun	imperial f (plural imperiais)
gospel	Noun	gospel m (uncountable)
azul	Noun	azul m (plural azuis)
joker	Noun	joker m (plural jokers)
grosa	Noun	grosa f (plural grosas)
princesa	Noun	princesa f (plural princesas)
rand	Noun	rand m (plural rands)
homicida	Noun	homicida m f (plural homicidas)
hard rock	Noun	hard rock m (uncountable)
post	Noun	post m (plural posts)
masto	Noun	masto m (plural mastos)
barba	Noun	barba f (plural barbas)
neuralgia	Noun	neuralgia f (plural neuralgias)
morfema	Noun	morfema m (plural morfemas)
praxe	Noun	praxe f (plural praxes)
web	Noun	web f (uncountable)
cantor	Noun	cantor m (plural cantores, feminine cantora, feminine plural cantoras)
islamofobia	Noun	islamofobia f (plural islamofobias)
corpus	Noun	corpus m (plural corpora or corpus)
bengali	Noun	bengali m f (plural bengalis)
meme	Noun	meme m (plural memes)
lei	Noun	lei f (plural leis)
tuba	Noun	tuba f (plural tubas)
novella	Noun	novella f (plural novellas)
baga	Noun	baga f (plural bagas)
zebras	Noun	zebras
agito	Noun	agito m (plural agitos)
pedagogia	Noun	pedagogia f (uncountable)
rum	Noun	rum m (plural runs)
damno	Noun	damno m (plural damnos)
selfie	Noun	selfie f or m (less common) (plural selfies)
arteriotomia	Noun	arteriotomia f (plural arteriotomias)
pillar	Noun	pillar m (plural pillares)
vella	Noun	vella f (plural vellas)
horda	Noun	horda f (plural hordas)
armagnac	Noun	armagnac m (uncountable)
era	Noun	era f (plural eras)
cherokee	Noun	cherokee m f (plural cherokees)
cherokee	Noun	cherokee m (uncountable)
panca	Noun	panca f (plural pancas)
pederastia	Noun	pederastia f (plural pederastias)
hot dog	Noun	hot dog m (plural hot dogs)
futurologia	Noun	futurologia f (usually uncountable, plural futurologias)
pala	Noun	pala f (plural palas)
dicto	Noun	dicto m (plural dictos)
algologia	Noun	algologia f (uncountable)
pastor	Noun	pastor m (plural pastores, feminine pastora, feminine plural pastoras)
beck	Noun	beck m (plural becks)
appello	Noun	appello m (plural appellos)
maga	Noun	maga f (plural magas)
viela	Noun	viela f (plural vielas)
viela	Noun	viela f (plural vielas)
viela	Noun	viela f (plural vielas)
sari	Noun	sari m (plural saris)
savana	Noun	savana f (plural savanas)
absurdo	Noun	absurdo m (plural absurdos)
squash	Noun	squash m (uncountable)
dom	Noun	dom m (plural dons)
striptease	Noun	striptease m (plural stripteases)
apiol	Noun	apiol m (uncountable)
hotel	Noun	hotel m (plural hotéis)
jota	Noun	jota m (plural jotas)
jota	Noun	jota f (plural jotas)
histopatologia	Noun	histopatologia f (usually uncountable, plural histopatologias)
arbusto	Noun	arbusto m (plural arbustos)
veste	Noun	veste f (plural vestes)
kernel	Noun	kernel m (plural kernels)
cona	Noun	cona f (plural conas)
trauma	Noun	trauma m (plural traumas)
pizza	Noun	pizza f (plural pizzas)
troco	Noun	troco m (plural trocos)
mundial	Noun	mundial m (plural mundiais)
tricolor	Noun	tricolor m (plural tricolores)
exaspero	Noun	exaspero m (plural exasperos)
canis	Noun	canis m pl
senda	Noun	senda f (plural sendas)
sefardi	Noun	sefardi m f (plural sefardis)
mahjong	Noun	mahjong m (uncountable)
flor	Noun	flor f (plural flores)
glasnost	Noun	glasnost f or m (rare) (uncountable)
pitu	Noun	pitu m (plural pitus)
eremita	Noun	eremita m f (plural eremitas)
andar	Noun	andar m (plural andares)
sinagoga	Noun	sinagoga f (plural sinagogas)
kebab	Noun	kebab m (plural kebabs)
salto	Noun	salto m (plural saltos)
perca	Noun	perca f (plural percas)
perca	Noun	perca f (plural percas)
sintagma	Noun	sintagma m (plural sintagmas)
neutrino	Noun	neutrino m (plural neutrinos)
akan	Noun	akan m (uncountable)
thesaurus	Noun	thesaurus m (plural thesauri or thesaurus)
ligatura	Noun	ligatura f (plural ligaturas)
cesto	Noun	cesto m (plural cestos)
penas	Noun	penas f pl
ramen	Noun	ramen m (uncountable)
dever	Noun	dever m (plural deveres)
tiara	Noun	tiara f (plural tiaras)
felonia	Noun	felonia f (plural felonias)
hemoglobina	Noun	hemoglobina f (plural hemoglobinas)
tau	Noun	tau m (plural taus)
facto	Noun	facto m (plural factos) (European orthography)
seca	Noun	seca f (plural secas)
virago	Noun	virago f (plural viragos)
tragedia	Noun	tragedia f (plural tragedias)
bokmal	Noun	bokmal m (uncountable)
driver	Noun	driver m (plural drivers)
rego	Noun	rego m (plural regos)
rego	Noun	rego m (plural regos)
firma	Noun	firma f (plural firmas)
pointer	Noun	pointer m (plural pointers)
fila	Noun	fila f (plural filas)
mu	Noun	mu m (plural mus)
agon	Noun	agon m (plural agons or agones)
animal	Noun	animal m (plural animais)
ambient	Noun	ambient m (uncountable)
maori	Noun	maori m f (plural maoris)
karma	Noun	karma m (plural karmas)
varas	Noun	varas
celta	Noun	celta m f (plural celtas)
epigrafia	Noun	epigrafia f (uncountable)
szlachta	Noun	szlachta f (uncountable)
fita	Noun	fita f (plural fitas)
fita	Noun	fita f (plural fitas)
hashtag	Noun	hashtag f or m (in variation) (plural hashtags)
poliglota	Noun	poliglota m f (plural poliglotas)
macho	Noun	macho m (plural machos)
lunar	Noun	lunar m (plural lunares)
aerofobia	Noun	aerofobia f (uncountable)
albor	Noun	albor m (plural albores)
bola	Noun	bola f (plural bolas)
optimista	Noun	optimista m f (plural optimistas)
finalista	Noun	finalista m f (plural finalistas)
weber	Noun	weber m (plural webers)
sushi	Noun	sushi m (plural sushis)
portulaca	Noun	portulaca f (plural portulacas)
horror	Noun	horror m (plural horrores)
homologia	Noun	homologia f (plural homologias)
esperanto	Noun	esperanto m (usually uncountable, plural esperantos)
instructor	Noun	instructor m (plural instructores, feminine instructora, feminine plural instructoras)
apto	Noun	apto m (plural aptos)
taro	Noun	taro m (plural taros)
zoopatologia	Noun	zoopatologia f (uncountable)
insulina	Noun	insulina f (plural insulinas)
hemofilia	Noun	hemofilia f (plural hemofilias)
sons	Noun	sons m pl
autista	Noun	autista m f (plural autistas)
gesto	Noun	gesto m (plural gestos)
rigor	Noun	rigor m (plural rigores)
fusa	Noun	fusa f (plural fusas)
fariseus	Noun	fariseus m
sapan	Noun	sapan m (plural sapans)
horologia	Noun	horologia f (uncountable)
fé	Noun	fé f (plural fés)
condor	Noun	condor m (plural condores)
grota	Noun	grota f (plural grotas)
menu	Noun	menu m (plural menus)
multa	Noun	multa f (plural multas)
historia	Noun	historia f (plural historias)
tarja	Noun	tarja f (plural tarjas)
völva	Noun	völva f (plural völvas)
lambada	Noun	lambada f (plural lambadas)
Hermes	Noun	Hermes m
béquer	Noun	béquer m (plural béqueres)
pateo	Noun	pateo m (plural pateos)
donos	Noun	donos m pl
zoofilia	Noun	zoofilia f (plural zoofilias)
biografia	Noun	biografia f (plural biografias)
vulva	Noun	vulva f (plural vulvas)
tutor	Noun	tutor m (plural tutores, feminine tutora, feminine plural tutoras)
disparo	Noun	disparo m (plural disparos)
pederasta	Noun	pederasta m (plural pederastas)
mina	Noun	mina f (plural minas)
mina	Noun	mina f (plural minas)
anilina	Noun	anilina f (uncountable)
gulyás	Noun	gulyás m (uncountable)
pleroma	Noun	pleroma m (uncountable)
plasma	Noun	plasma m (uncountable)
muffin	Noun	muffin m (plural muffins)
D	Noun	D m
paradigma	Noun	paradigma m (plural paradigmas)
pira	Noun	pira f (plural piras)
parada	Noun	parada f (plural paradas)
marketing	Noun	marketing m (usually uncountable, plural marketings)
abadia	Noun	abadia f (plural abadias)
toga	Noun	toga f (plural togas)
ceva	Noun	ceva f (plural cevas)
carabina	Noun	carabina f (plural carabinas)
pesar	Noun	pesar m (plural pesares)
glosa	Noun	glosa f (plural glosas)
estrangeiro	Noun	estrangeiro m (plural estrangeiros, feminine estrangeira, feminine plural estrangeiras)
uro	Noun	uro m (plural uros)
pio	Noun	pio m (plural pios)
root	Noun	root m (plural roots)
biblioterapia	Noun	biblioterapia f (plural biblioterapias)
sério	Noun	sério m (uncountable)
atropina	Noun	atropina f (usually uncountable, plural atropinas)
terapia	Noun	terapia f (plural terapias)
tagetes	Noun	tagetes f (plural tagetes)
newton	Noun	newton m (plural newtons)
czar	Noun	czar m (plural czares, feminine czarina, feminine plural czarinas)
mentor	Noun	mentor m (plural mentores, feminine mentora, feminine plural mentoras)
milhar	Noun	milhar m (plural milhares)
frei	Noun	frei m (plural freis)
pediatra	Noun	pediatra m f (plural pediatras)
beatnik	Noun	beatnik m f (plural beatniks)
infanticida	Noun	infanticida m f (plural infanticidas)
dica	Noun	dica f (plural dicas)
hamster	Noun	hamster m (plural hamsters or hamsteres (rare))
azeri	Noun	azeri m f (plural azeri)
mamba	Noun	mamba f (plural mambas)
hospital	Noun	hospital m (plural hospitais)
parlamentar	Noun	parlamentar m f (plural parlamentares)
transistor	Noun	transistor m (plural transistores)
stor	Noun	stor m (plural stores, feminine stora, feminine plural storas)
vagina	Noun	vagina f (plural vaginas)
funis	Noun	funis m
fenestra	Noun	fenestra f (plural fenestras)
emir	Noun	emir m (plural emires)
metodologia	Noun	metodologia f (plural metodologias)
DVD	Noun	DVD m (plural DVDs)
echo	Noun	echo m (plural echos)
pipo	Noun	pipo m (plural pipos)
nada	Noun	nada m (uncountable)
porto	Noun	porto m (plural portos)
porto	Noun	porto m (plural portos)
final	Noun	final m (plural finais)
final	Noun	final f (plural finais)
epilepsia	Noun	epilepsia f (plural epilepsias)
matador	Noun	matador m (plural matadores, feminine matadora, feminine plural matadoras)
novo	Noun	novo m (uncountable)
motor	Noun	motor m (plural motores)
lava	Noun	lava f (plural lavas)
animus	Noun	animus m (uncountable)
zona	Noun	zona f (plural zonas)
adrenalina	Noun	adrenalina f (plural adrenalinas)
troll	Noun	troll m (plural trolls)
torres	Noun	torres f
toda	Noun	toda f (plural todas)
toda	Noun	toda m f (plural todas)
toda	Noun	toda m (uncountable)
samovar	Noun	samovar m (plural samovares)
carta	Noun	carta f (plural cartas)
territorio	Noun	territorio m (plural territorios)
boxer	Noun	boxer m (plural boxers)
cheddar	Noun	cheddar m (plural cheddars)
tutu	Noun	tutu m (plural tutus)
arma	Noun	arma f (plural armas)
cipó	Noun	cipó m (plural cipós)
sutra	Noun	sutra m (plural sutras)
mols	Noun	mols
limonada	Noun	limonada f (plural limonadas)
hansa	Noun	hansa f (plural hansas)
Führer	Noun	Führer m (plural Führer or Führers)
nodo	Noun	nodo m (plural nodos)
acha	Noun	acha f (plural achas)
acha	Noun	acha f (plural achas)
patricida	Noun	patricida m f (plural patricidas)
impala	Noun	impala m f (plural impalas)
ethos	Noun	ethos m (plural ethos)
password	Noun	password f (plural passwords)
cisterna	Noun	cisterna f (plural cisternas)
mayonnaise	Noun	mayonnaise f (plural mayonnaises)
handicap	Noun	handicap m (uncountable)
dona	Noun	dona f (plural donas)
lira	Noun	lira f (plural liras)
lira	Noun	lira f (plural liras)
laço	Noun	laço m (plural laços)
blog	Noun	blog m (plural blogs)
giro	Noun	giro m (plural giros)
filosofia	Noun	filosofia f (plural filosofias)
lapa	Noun	lapa f (plural lapas)
mariscos	Noun	mariscos m pl
polca	Noun	polca f (plural polcas)
dolina	Noun	dolina f (plural dolinas)
dieta	Noun	dieta f (plural dietas)
anomalia	Noun	anomalia f (plural anomalias)
endívia	Noun	endívia f (plural endívias)
ardor	Noun	ardor m (plural ardores)
lás	Noun	lás
pingo	Noun	pingo m (plural pingos)
verbena	Noun	verbena f (plural verbenas)
nana	Noun	nana f (plural nanas)
cometa	Noun	cometa m (plural cometas)
ornitologia	Noun	ornitologia f (uncountable)
tapa	Noun	tapa m (plural tapas)
farol	Noun	farol m (plural faróis)
torr	Noun	torr m (plural torrs)
amina	Noun	amina f (plural aminas)
verdes	Noun	verdes m pl
drama	Noun	drama m (plural dramas)
mantissa	Noun	mantissa f (plural mantissas)
gang	Noun	gang m (Portugal) or f (Brazil) (plural gangs)
veneno	Noun	veneno m (plural venenos)
familia	Noun	familia f (plural familias)
animista	Noun	animista m f (plural animistas)
sanitas	Noun	sanitas
dumping	Noun	dumping m (plural dumpings)
hiena	Noun	hiena f (plural hienas)
fada	Noun	fada f (plural fadas)
patos	Noun	patos m
patos	Noun	patos m (uncountable)
almas	Noun	almas
circular	Noun	circular f (plural circulares)
circular	Noun	circular m (plural circulares)
tons	Noun	tons m
idioma	Noun	idioma m (plural idiomas)
rasca	Noun	rasca f (plural rascas)
ex	Noun	ex m f (plural ex)
propiska	Noun	propiska f (uncountable)
numero	Noun	numero m (plural numeros)
baht	Noun	baht m (plural bahts)
orla	Noun	orla f (plural orlas)
prova	Noun	prova f (plural provas)
crawl	Noun	crawl m (uncountable)
árum	Noun	árum m (plural áruns)
agronomia	Noun	agronomia f (plural agronomias)
fumo	Noun	fumo m (plural fumos)
campus	Noun	campus m (plural campi or campus (nonstandard))
bege	Noun	bege m (plural beges)
internet	Noun	internet f (uncountable)
aros	Noun	aros
disco	Noun	disco m (plural discos)
burka	Noun	burka f (plural burkas)
host	Noun	host m (plural hosts)
platina	Noun	platina f (plural platinas)
remake	Noun	remake m (plural remakes)
bilabial	Noun	bilabial f (plural bilabiais)
onomatopeia	Noun	onomatopeia f (plural onomatopeias)
afemia	Noun	afemia f (uncountable)
alveolar	Noun	alveolar f (plural alveolares)
astronautas	Noun	astronautas
amas	Noun	amas
fobofobia	Noun	fobofobia f (uncountable)
homotopia	Noun	homotopia f (plural homotopias)
trance	Noun	trance m (uncountable)
trance	Noun	trance m (plural trances)
fondue	Noun	fondue m or f (in variation) (plural fondues)
cú	Noun	cú m
reto	Noun	reto m (plural retos)
andante	Noun	andante m f (plural andantes)
andante	Noun	andante m (plural andantes)
pandeiro	Noun	pandeiro m (plural pandeiros)
angiografia	Noun	angiografia f (plural angiografias)
papel	Noun	papel m (plural papéis)
exemplar	Noun	exemplar m (plural exemplares)
misericordia	Noun	misericordia f (plural misericordias)
time	Noun	time m (plural times)
cortina	Noun	cortina f (plural cortinas)
protoplasma	Noun	protoplasma m (plural protoplasmas)
sistema	Noun	sistema m (plural sistemas)
nafta	Noun	nafta f (plural naftas)
led	Noun	led m (plural leds)
amanhecer	Noun	amanhecer m (plural amanheceres)
volapük	Noun	volapük m (uncountable)
pino	Noun	pino m (plural pinos)
passa	Noun	passa f (plural passas)
leis	Noun	leis
gás	Noun	gás m (plural gases)
homofobia	Noun	homofobia f (plural homofobias)
malta	Noun	malta f (plural maltas)
vale	Noun	vale m (plural vales)
vale	Noun	vale m (plural vales)
palma	Noun	palma f (plural palmas)
pontos	Noun	pontos
diagonal	Noun	diagonal f (plural diagonais)
bougainvillea	Noun	bougainvillea f (plural bougainvilleas)
literatura	Noun	literatura f (plural literaturas)
piscina	Noun	piscina f (plural piscinas)
autonomia	Noun	autonomia f
agnosia	Noun	agnosia f (uncountable)
terrier	Noun	terrier m f (plural terriers)
maya	Noun	maya m f (plural mayas)
gata	Noun	gata f (plural gatas)
rosé	Noun	rosé m (plural rosés)
falar	Noun	falar m (plural falares)
adorno	Noun	adorno m (plural adornos)
kimono	Noun	kimono m (plural kimonos)
agricultura	Noun	agricultura f (plural agriculturas)
tripla	Noun	tripla f (plural triplas)
rey	Noun	rey m (plural reys)
soma	Noun	soma f (plural somas)
soma	Noun	soma m (plural somas)
soma	Noun	soma m (plural somas)
etnologia	Noun	etnologia f (plural etnologias)
aio	Noun	aio m (plural aios, feminine aia, feminine plural aias)
agressor	Noun	agressor m (plural agressores, feminine agressora, feminine plural agressoras)
laranja	Noun	laranja f (plural laranjas)
logo	Noun	logo m (plural logos)
sangria	Noun	sangria f (plural sangrias)
juro	Noun	juro m (plural juros)
tribunal	Noun	tribunal m (plural tribunais)
erro	Noun	erro m (plural erros)
napalm	Noun	napalm m (plural napalms)
judo	Noun	judo m (uncountable)
vinis	Noun	vinis
industria	Noun	industria f (plural industrias)
gazel	Noun	gazel m (plural gazéis)
frisbee	Noun	frisbee m (plural frisbees)
jaguar	Noun	jaguar m (plural jaguares)
byte	Noun	byte m (plural bytes)
retentor	Noun	retentor m (plural retentores)
hacker	Noun	hacker m f (plural hackers)
aerobiologia	Noun	aerobiologia f (uncountable)
dor	Noun	dor f (plural dores)
metal	Noun	metal m (plural metais)
nata	Noun	nata f (plural natas)
marca	Noun	marca f (plural marcas)
marca	Noun	marca f (plural marcas)
concha	Noun	concha f (plural conchas)
ampere	Noun	ampere m (plural amperes)
astral	Noun	astral m (plural astrais)
anime	Noun	anime m (plural animes)
dito	Noun	dito m (plural ditos)
bambara	Noun	bambara m (uncountable)
pastoral	Noun	pastoral f (plural pastorais)
suvenir	Noun	suvenir m (plural suvenires)
narina	Noun	narina f (plural narinas)
kibutz	Noun	kibutz m (plural kibutzim or kibutzes or kibutz (rare))
avatar	Noun	avatar m
victoria	Noun	victoria f (plural victorias)
variável	Noun	variável f (plural variáveis)
trio	Noun	trio m (plural trios)
taiga	Noun	taiga f (plural taigas)
disciplina	Noun	disciplina f (plural disciplinas)
