concreto	Adjective	concreto m (feminine singular concreta, masculine plural concretos, feminine plural concretas, comparable)
tres	Adjective	tres
alva	Adjective	alva f sg
ritual	Adjective	ritual m, f (plural rituais, comparable)
aguado	Adjective	aguado m (feminine singular aguada, masculine plural aguados, feminine plural aguadas, comparable)
prudente	Adjective	prudente m, f (plural prudentes, comparable)
bota	Adjective	bota f sg
int	Adjective	int (invariable, comparable)
enferrujado	Adjective	enferrujado m (feminine singular enferrujada, masculine plural enferrujados, feminine plural enferrujadas, comparable)
peitudo	Adjective	peitudo m (feminine singular peituda, masculine plural peitudos, feminine plural peitudas, comparable)
adnato	Adjective	adnato m (feminine singular adnata, masculine plural adnatos, feminine plural adnatas, comparable)
imaginativo	Adjective	imaginativo m (feminine singular imaginativa, masculine plural imaginativos, feminine plural imaginativas, comparable)
só	Adjective	só m f (plural só or (obsolete) sós)
só	Adjective	só (plural sós, comparable)
caro	Adjective	caro m (feminine singular cara, masculine plural caros, feminine plural caras, comparable)
sensorial	Adjective	sensorial m, f (plural sensoriais, comparable)
fino	Adjective	fino m (feminine singular fina, masculine plural finos, feminine plural finas, comparable)
bufo	Adjective	bufo m (feminine singular bufa, masculine plural bufos, feminine plural bufas, comparable)
global	Adjective	global m, f (plural globais, comparable)
global	Adjective	global m, f (plural globais, comparable)
plena	Adjective	plena f sg
mijão	Adjective	mijão m (feminine singular mijona, masculine plural mijões, feminine plural mijonas, comparable)
ad hoc	Adjective	ad hoc (invariable, comparable)
avassalador	Adjective	avassalador m (feminine singular avassaladora, masculine plural avassaladores, feminine plural avassaladoras, comparable)
social	Adjective	social m, f (plural sociais, comparable)
estranho	Adjective	estranho m (feminine singular estranha, masculine plural estranhos, feminine plural estranhas, comparable)
ilegal	Adjective	ilegal m, f (plural ilegais, comparable)
areal	Adjective	areal m, f (plural areais, comparable)
mediana	Adjective	mediana f sg
cuidadoso	Adjective	cuidadoso m (feminine singular cuidadosa, masculine plural cuidadosos, feminine plural cuidadosas, comparable)
imprevisível	Adjective	imprevisível m, f (plural imprevisíveis, comparable)
poderoso	Adjective	poderoso m (feminine singular poderosa, masculine plural poderosos, feminine plural poderosas, comparable)
cento	Adjective	cento m, f
velho	Adjective	velho m (feminine singular velha, masculine plural velhos, feminine plural velhas, comparable)
mole	Adjective	mole m, f (plural moles, comparable)
visível	Adjective	visível m, f (plural visíveis, comparable)
bravo	Adjective	bravo m (feminine singular brava, masculine plural bravos, feminine plural bravas, comparable)
vazio	Adjective	vazio m (feminine singular vazia, masculine plural vazios, feminine plural vazias, comparable)
cremoso	Adjective	cremoso m (feminine singular cremosa, masculine plural cremosos, feminine plural cremosas, comparable)
surdo	Adjective	surdo m (feminine singular surda, masculine plural surdos, feminine plural surdas, comparable)
sexy	Adjective	sexy (invariable, comparable)
perpetuo	Adjective	perpetuo m (feminine singular perpetua, masculine plural perpetuos, feminine plural perpetuas, comparable)
administrativa	Adjective	administrativa f sg
quieto	Adjective	quieto m (feminine singular quieta, masculine plural quietos, feminine plural quietas, comparable)
moles	Adjective	moles m f pl
duradouro	Adjective	duradouro m (feminine singular duradoura, masculine plural duradouros, feminine plural duradouras, comparable)
malcheiroso	Adjective	malcheiroso m (feminine singular malcheirosa, masculine plural malcheirosos, feminine plural malcheirosas, comparable)
hakka	Adjective	hakka (plural hakka, comparable)
bom	Adjective	bom (feminine boa, masculine plural bons, feminine plural boas)
pequeno	Adjective	pequeno m (feminine singular pequena, masculine plural pequenos, feminine plural pequenas, comparable)
malandrino	Adjective	malandrino m (feminine singular malandrina, masculine plural malandrinos, feminine plural malandrinas, comparable)
sonso	Adjective	sonso m (feminine singular sonsa, masculine plural sonsos, feminine plural sonsas, comparable)
consular	Adjective	consular m, f (plural consulares, comparable)
sanguino	Adjective	sanguino m (feminine singular sanguina, masculine plural sanguinos, feminine plural sanguinas, comparable)
principal	Adjective	principal m, f (plural principais, comparable)
inscrito	Adjective	inscrito m (feminine singular inscrita, masculine plural inscritos, feminine plural inscritas, not comparable)
anual	Adjective	anual m, f (plural anuais, not comparable)
zen	Adjective	zen (plural zen, comparable)
cruas	Adjective	cruas f pl
vario	Adjective	vario m (feminine singular varia, masculine plural varios, feminine plural varias, comparable)
injuriado	Adjective	injuriado m (feminine singular injuriada, masculine plural injuriados, feminine plural injuriadas, comparable)
territorial	Adjective	territorial m, f (plural territoriais, not comparable)
tola	Adjective	tola f sg
verde	Adjective	verde m, f (plural verdes)
simpatizante	Adjective	simpatizante m, f (plural simpatizantes, comparable)
solar	Adjective	solar m, f (plural solares, comparable)
muda	Adjective	muda f sg
particular	Adjective	particular m, f (plural particulares, comparable)
fedido	Adjective	fedido m (feminine singular fedida, masculine plural fedidos, feminine plural fedidas, comparable)
bestial	Adjective	bestial m, f (plural bestiais, comparable)
belga	Adjective	belga m, f (plural belgas, comparable)
normal	Adjective	normal m, f (plural normais, comparable)
folhado	Adjective	folhado m (feminine singular folhada, masculine plural folhados, feminine plural folhadas, comparable)
tabular	Adjective	tabular m, f (plural tabulares, comparable)
boboca	Adjective	boboca m, f (plural bobocas, comparable)
desonesto	Adjective	desonesto m (feminine singular desonesta, masculine plural desonestos, feminine plural desonestas, comparable)
amigável	Adjective	amigável m, f (plural amigáveis, comparable)
semita	Adjective	semita m, f (plural semitas, comparable)
intercalar	Adjective	intercalar (plural intercalares, comparable)
perigoso	Adjective	perigoso m (feminine singular perigosa, masculine plural perigosos, feminine plural perigosas, comparable)
infernal	Adjective	infernal m, f (plural infernais, comparable)
franco	Adjective	franco m (feminine singular franca, masculine plural francos, feminine plural francas, comparable)
implacável	Adjective	implacável m, f (plural implacáveis, comparable)
formal	Adjective	formal m, f (plural formais, comparable)
material	Adjective	material m, f (plural materiais, comparable)
satanista	Adjective	satanista m, f (plural satanistas, comparable)
abstruso	Adjective	abstruso m (feminine singular abstrusa, masculine plural abstrusos, feminine plural abstrusas, comparable)
somali	Adjective	somali (plural somalis, not comparable)
descritivo	Adjective	descritivo m (feminine singular descritiva, masculine plural descritivos, feminine plural descritivas, comparable)
floral	Adjective	floral m, f (plural florais, not comparable)
tridimensional	Adjective	tridimensional m, f (plural tridimensionais, comparable)
moderna	Adjective	moderna f sg
árabe	Adjective	árabe (feminine singular árabe, plural, comparable)
irado	Adjective	irado m (feminine singular irada, masculine plural irados, feminine plural iradas, comparable)
ledo	Adjective	ledo m (feminine singular leda, masculine plural ledos, feminine plural ledas, comparable)
mongo	Adjective	mongo m (feminine singular monga, masculine plural mongos, feminine plural mongas, comparable)
todo ouvidos	Adjective	todo ouvidos (feminine singular toda ouvidos, plural todos ouvidos, comparable)
abrupto	Adjective	abrupto m (feminine singular abrupta, masculine plural abruptos, feminine plural abruptas, comparable)
nacionalista	Adjective	nacionalista m, f (plural nacionalistas, comparable)
hexagonal	Adjective	hexagonal m, f (plural hexagonais, comparable)
inacreditável	Adjective	inacreditável m, f (plural inacreditáveis, comparable)
vil	Adjective	vil m, f (plural vis, comparable)
transgressor	Adjective	transgressor m (feminine singular transgressora, masculine plural transgressores, feminine plural transgressoras, comparable)
mor	Adjective	mor m, f (plural mores, comparable)
varoa	Adjective	varoa f sg
fodido	Adjective	fodido m (feminine singular fodida, masculine plural fodidos, feminine plural fodidas, comparable)
conjugal	Adjective	conjugal m, f (plural conjugais, comparable)
maroto	Adjective	maroto m (feminine singular marota, masculine plural marotos, feminine plural marotas, comparable)
irrefutável	Adjective	irrefutável m, f (plural irrefutáveis, comparable)
favorável	Adjective	favorável m, f (plural favoráveis, comparable)
transversal	Adjective	transversal m, f (plural transversais, comparable)
dada	Adjective	dada
viva	Adjective	viva f sg
alta	Adjective	alta f sg
aceso	Adjective	aceso m (feminine singular acesa, masculine plural acesos, feminine plural acesas, comparable)
comprido	Adjective	comprido m (feminine singular comprida, masculine plural compridos, feminine plural compridas, comparable)
afamado	Adjective	afamado m (feminine singular afamada, masculine plural afamados, feminine plural afamadas, comparable)
chata	Adjective	chata f sg
mudo	Adjective	mudo m (feminine singular muda, masculine plural mudos, feminine plural mudas, not comparable)
negro	Adjective	negro m (feminine singular negra, masculine plural negros, feminine plural negras, comparable)
atento	Adjective	atento m (feminine singular atenta, masculine plural atentos, feminine plural atentas, comparable)
vago	Adjective	vago m (feminine singular vaga, masculine plural vagos, feminine plural vagas, comparable)
vago	Adjective	vago m (feminine singular vaga, masculine plural vagos, feminine plural vagas, comparable)
verbal	Adjective	verbal m, f (plural verbais, comparable)
agradável	Adjective	agradável m, f (plural agradáveis, comparable)
mal	Adjective	mal
intencional	Adjective	intencional m, f (plural intencionais, comparable)
triste	Adjective	triste m, f (plural tristes, comparable)
mineral	Adjective	mineral m, f (plural minerais, comparable)
mil	Adjective	mil m, f
sapiente	Adjective	sapiente m, f (plural sapientes, comparable)
apagado	Adjective	apagado m (feminine singular apagada, masculine plural apagados, feminine plural apagadas, sometimes comparable)
abominável	Adjective	abominável m, f (plural abomináveis, comparable)
ralo	Adjective	ralo m (feminine singular rala, masculine plural ralos, feminine plural ralas, comparable)
uno	Adjective	uno m (feminine singular una, masculine plural unos, feminine plural unas, comparable)
dialectal	Adjective	dialectal m, f (plural dialectais, comparable) (European orthography)
malina	Adjective	malina f sg
nado	Adjective	nado m (feminine singular nada, masculine plural nados, feminine plural nadas, comparable)
triangular	Adjective	triangular m, f (plural triangulares, comparable)
nazista	Adjective	nazista m f (plural nazistas)
caótico	Adjective	caótico m (feminine singular caótica, masculine plural caóticos, feminine plural caóticas, comparable)
guarani	Adjective	guarani (plural guaranis, comparable)
morena	Adjective	morena f sg
horrível	Adjective	horrível m, f (plural horríveis, comparable)
maus	Adjective	maus m pl
acurado	Adjective	acurado m (feminine singular acurada, masculine plural acurados, feminine plural acuradas, comparable)
delgado	Adjective	delgado m (feminine singular delgada, masculine plural delgados, feminine plural delgadas, comparable)
afebril	Adjective	afebril m, f (plural afebris, comparable)
analfabeto	Adjective	analfabeto m (feminine singular analfabeta, masculine plural analfabetos, feminine plural analfabetas, comparable)
irritado	Adjective	irritado m (feminine singular irritada, masculine plural irritados, feminine plural irritadas, comparable)
sedutor	Adjective	sedutor m (feminine singular sedutora, masculine plural sedutores, feminine plural sedutoras, comparable)
aberto	Adjective	aberto m (feminine singular aberta, masculine plural abertos, feminine plural abertas, comparable)
viking	Adjective	viking m f (plural vikings or viking)
apetitoso	Adjective	apetitoso m (feminine singular apetitosa, masculine plural apetitosos, feminine plural apetitosas, comparable)
cultural	Adjective	cultural m, f (plural culturais, comparable)
sós	Adjective	sós m pl
certa	Adjective	certa f sg
forte	Adjective	forte m, f (plural fortes, comparable)
rica	Adjective	rica f sg
sarcástico	Adjective	sarcástico m (feminine singular sarcástica, masculine plural sarcásticos, feminine plural sarcásticas, comparable)
palatal	Adjective	palatal m, f (plural palatais, comparable)
complexo	Adjective	complexo m (feminine singular complexa, masculine plural complexos, feminine plural complexas, comparable)
bem-disposto	Adjective	bem-disposto m (feminine singular bem-disposta, masculine plural bem-dispostos, feminine plural bem-dispostas, comparable)
literal	Adjective	literal m, f (plural literais, comparable)
orbital	Adjective	orbital m, f (plural orbitais, comparable)
legal	Adjective	legal m, f (plural legais, comparable)
gram	Adjective	gram
cardinal	Adjective	cardinal m, f (plural cardinais, comparable)
improvável	Adjective	improvável m, f (plural improváveis, comparable)
aguçado	Adjective	aguçado m (feminine singular aguçada, masculine plural aguçados, feminine plural aguçadas, comparable)
adocicado	Adjective	adocicado m (feminine singular adocicada, masculine plural adocicados, feminine plural adocicadas, comparable)
branda	Adjective	branda f sg
exausto	Adjective	exausto m (feminine singular exausta, masculine plural exaustos, feminine plural exaustas, comparable)
alegre	Adjective	alegre m, f (plural alegres, comparable)
khmer	Adjective	khmer (invariable, not comparable)
integral	Adjective	integral m, f (plural integrais, comparable)
rom	Adjective	rom (plural rom, comparable)
peralta	Adjective	peralta m, f (plural peraltas, comparable)
puro	Adjective	puro m (feminine singular pura, masculine plural puros, feminine plural puras, comparable)
mafioso	Adjective	mafioso m (feminine singular mafiosa, masculine plural mafiosos, feminine plural mafiosas, comparable)
impressionável	Adjective	impressionável m, f (plural impressionáveis, comparable)
anular	Adjective	anular m, f (plural anulares, comparable)
alambicado	Adjective	alambicado m (feminine singular alambicada, masculine plural alambicados, feminine plural alambicadas, comparable)
denso	Adjective	denso (feminine singular densa, plural, comparable)
digital	Adjective	digital m, f (plural digitais, comparable)
abençoado	Adjective	abençoado m (feminine singular abençoada, masculine plural abençoados, feminine plural abençoadas, comparable)
más	Adjective	más f pl
francez	Adjective	francez m (feminine singular franceza, masculine plural francezes, feminine plural francezas, comparable)
cara	Adjective	cara f sg
semiletrado	Adjective	semiletrado m (feminine singular semiletrada, masculine plural semiletrados, feminine plural semiletradas, comparable)
quebrado	Adjective	quebrado m (feminine singular quebrada, masculine plural quebrados, feminine plural quebradas, comparable)
branca	Adjective	branca f sg
secreto	Adjective	secreto m (feminine singular secreta, masculine plural secretos, feminine plural secretas, comparable)
malvado	Adjective	malvado m (feminine singular malvada, masculine plural malvados, feminine plural malvadas, comparable)
acabado	Adjective	acabado m (feminine singular acabada, masculine plural acabados, feminine plural acabadas, sometimes comparable)
coxo	Adjective	coxo m (feminine singular coxa, masculine plural coxos, feminine plural coxas, comparable)
gay	Adjective	gay (plural gays, comparable)
criativo	Adjective	criativo m (feminine singular criativa, masculine plural criativos, feminine plural criativas, comparable)
genial	Adjective	genial m, f (plural geniais, comparable)
impulsor	Adjective	impulsor m, f (plural impulsores, comparable)
doido	Adjective	doido m (feminine singular doida, masculine plural doidos, feminine plural doidas, comparable)
previsível	Adjective	previsível m, f (plural previsíveis, comparable)
valada	Adjective	valada f
falisca	Adjective	falisca f sg
magyar	Adjective	magyar m, f (plural magyares, comparable)
santo	Adjective	santo m (feminine singular santa, masculine plural santos, feminine plural santas, comparable)
super	Adjective	super (invariable, comparable)
febril	Adjective	febril m, f (plural febris, comparable)
saami	Adjective	saami (plural saami, comparable)
rubi	Adjective	rubi (invariable, comparable)
nítido	Adjective	nítido m (feminine singular nítida, masculine plural nítidos, feminine plural nítidas, comparable)
irlandez	Adjective	irlandez m (feminine singular irlandeza, masculine plural irlandezes, feminine plural irlandezas, not comparable)
folgado	Adjective	folgado m (feminine singular folgada, masculine plural folgados, feminine plural folgadas, comparable)
alto	Adjective	alto m (feminine singular alta, masculine plural altos, feminine plural altas, comparable)
musical	Adjective	musical m, f (plural musicais, comparable)
imprestável	Adjective	imprestável m, f (plural imprestáveis, comparable)
han	Adjective	han (invariable, comparable)
tranquillo	Adjective	tranquillo m (feminine singular tranquilla, masculine plural tranquillos, feminine plural tranquillas, comparable)
pasmo	Adjective	pasmo m (feminine singular pasma, masculine plural pasmos, feminine plural pasmas, comparable)
privado	Adjective	privado m (feminine singular privada, masculine plural privados, feminine plural privadas, sometimes comparable)
interior	Adjective	interior (plural interiores, comparable)
interno	Adjective	interno m (feminine singular interna, masculine plural internos, feminine plural internas, sometimes comparable)
unicolor	Adjective	unicolor m, f (plural unicolores, comparable)
perineal	Adjective	perineal (plural perineais, comparable)
foderoso	Adjective	foderoso m (feminine singular foderosa, masculine plural foderosos, feminine plural foderosas, comparable)
cansado	Adjective	cansado m (feminine singular cansada, masculine plural cansados, feminine plural cansadas, comparable)
piramidal	Adjective	piramidal m, f (plural piramidais, comparable)
magenta	Adjective	magenta (plural magenta, comparable)
minucioso	Adjective	minucioso m (feminine singular minuciosa, masculine plural minuciosos, feminine plural minuciosas, comparable)
especial	Adjective	especial m, f (plural especiais, comparable)
trivial	Adjective	trivial m, f (plural triviais, comparable)
acanhado	Adjective	acanhado m (feminine singular acanhada, masculine plural acanhados, feminine plural acanhadas, comparable)
zulu	Adjective	zulu (plural zulus, not comparable)
erótico	Adjective	erótico m (feminine singular erótica, masculine plural eróticos, feminine plural eróticas, comparable)
limpa	Adjective	limpa f sg
encharcado	Adjective	encharcado m (feminine singular encharcada, masculine plural encharcados, feminine plural encharcadas, comparable)
desavergonhado	Adjective	desavergonhado m (feminine singular desavergonhada, masculine plural desavergonhados, feminine plural desavergonhadas, comparable)
augusto	Adjective	augusto m (feminine singular augusta, masculine plural augustos, feminine plural augustas, comparable)
anal	Adjective	anal m, f (plural anais, comparable)
anal	Adjective	anal m, f (plural anais, comparable)
gracioso	Adjective	gracioso m (feminine singular graciosa, masculine plural graciosos, feminine plural graciosas, comparable)
apertado	Adjective	apertado m (feminine singular apertada, masculine plural apertados, feminine plural apertadas, comparable)
mista	Adjective	mista f sg
semelhante	Adjective	semelhante m, f (plural semelhantes, comparable)
esquecido	Adjective	esquecido m (feminine singular esquecida, masculine plural esquecidos, feminine plural esquecidas, comparable)
terminal	Adjective	terminal m, f (plural terminais, comparable)
manual	Adjective	manual m, f (plural manuais, comparable)
real	Adjective	real m, f (plural reais, comparable)
real	Adjective	real m, f (plural reais, comparable)
pura	Adjective	pura f sg
sussa	Adjective	sussa (plural, comparable)
superior	Adjective	superior m, f (plural superiores, comparable)
amoroso	Adjective	amoroso m (feminine singular amorosa, masculine plural amorosos, feminine plural amorosas, comparable)
sobejo	Adjective	sobejo m (feminine singular sobeja, masculine plural sobejos, feminine plural sobejas, comparable)
deprimido	Adjective	deprimido m (feminine singular deprimida, masculine plural deprimidos, feminine plural deprimidas, comparable)
feminino	Adjective	feminino m (feminine singular feminina, masculine plural femininos, feminine plural femininas, sometimes comparable)
fundamental	Adjective	fundamental m, f (plural fundamentais, comparable)
una	Adjective	una f sg
illegal	Adjective	illegal (plural illegaes, comparable)
popozudo	Adjective	popozudo m (feminine singular popozuda, masculine plural popozudos, feminine plural popozudas, comparable)
bobas	Adjective	bobas f pl
gentil	Adjective	gentil m, f (plural gentis, comparable)
federal	Adjective	federal m, f (plural federais, comparable)
amarelo	Adjective	amarelo m (feminine singular amarela, masculine plural amarelos, feminine plural amarelas, comparable)
dextra	Adjective	dextra f sg
massa	Adjective	massa m, f (plural massas, comparable)
culpado	Adjective	culpado m (feminine singular culpada, masculine plural culpados, feminine plural culpadas, comparable)
gordo	Adjective	gordo m (feminine singular gorda, masculine plural gordos, feminine plural gordas, comparable)
vinda	Adjective	vinda f sg
oco	Adjective	oco m (feminine singular oca, masculine plural ocos, feminine plural ocas, comparable)
instrumental	Adjective	instrumental m, f (plural instrumentais, comparable)
grande	Adjective	grande m, f (plural grandes, comparable)
senil	Adjective	senil m, f (plural senis, comparable)
organizável	Adjective	organizável m, f (plural organizáveis, comparable)
salina	Adjective	salina f sg
narigudo	Adjective	narigudo m (feminine singular nariguda, masculine plural narigudos, feminine plural narigudas, comparable)
conhecedor	Adjective	conhecedor m (feminine singular conhecedora, masculine plural conhecedores, feminine plural conhecedoras, comparable)
habilidoso	Adjective	habilidoso m (feminine singular habilidosa, masculine plural habilidosos, feminine plural habilidosas, comparable)
paradoxal	Adjective	paradoxal m, f (plural paradoxais, comparable)
regional	Adjective	regional m, f (plural regionais, comparable)
vistas	Adjective	vistas f pl
meio	Adjective	meio m (feminine singular meia, masculine plural meios, feminine plural meias, not comparable)
temporal	Adjective	temporal m, f (plural temporais, not comparable)
funda	Adjective	funda f sg
tranquilo	Adjective	tranquilo m (feminine singular tranquila, masculine plural tranquilos, feminine plural tranquilas, comparable)
marginal	Adjective	marginal m, f (plural marginais, comparable)
central	Adjective	central m, f (plural centrais, comparable)
amarelado	Adjective	amarelado m (feminine singular amarelada, masculine plural amarelados, feminine plural amareladas, comparable)
sebenta	Adjective	sebenta f sg
vogal	Adjective	vogal m, f (plural vogais, not comparable)
par	Adjective	par m, f (plural pares, not comparable)
durável	Adjective	durável m, f (plural duráveis, comparable)
potencial	Adjective	potencial m, f (plural potenciais, comparable)
harmonioso	Adjective	harmonioso m (feminine singular harmoniosa, masculine plural harmoniosos, feminine plural harmoniosas, comparable)
acelerado	Adjective	acelerado m (feminine singular acelerada, masculine plural acelerados, feminine plural aceleradas, comparable)
bentos	Adjective	bentos m pl
lógico	Adjective	lógico m (feminine singular lógica, masculine plural lógicos, feminine plural lógicas, sometimes comparable)
crua	Adjective	crua f sg
in	Adjective	in (plural in, comparable)
anti	Adjective	anti (invariable, comparable)
acordado	Adjective	acordado m (feminine singular acordada, masculine plural acordados, feminine plural acordadas, comparable)
longa	Adjective	longa f sg
submarinas	Adjective	submarinas f pl
mester	Adjective	mester (plural mester, comparable)
inclinado	Adjective	inclinado m (feminine singular inclinada, masculine plural inclinados, feminine plural inclinadas, comparable)
liberal	Adjective	liberal m, f (plural liberais, comparable)
letal	Adjective	letal (plural letais, comparable)
armada	Adjective	armada f sg
panaca	Adjective	panaca m, f (plural panacas, comparable)
complementar	Adjective	complementar m, f (plural complementares, comparable)
escondido	Adjective	escondido m (feminine singular escondida, masculine plural escondidos, feminine plural escondidas, comparable)
fluvial	Adjective	fluvial m, f (plural fluviais, comparable)
batuta	Adjective	batuta m, f (plural batutas, comparable)
ideal	Adjective	ideal m, f (plural ideais, comparable)
mundano	Adjective	mundano m (feminine singular mundana, masculine plural mundanos, feminine plural mundanas, comparable)
zeloso	Adjective	zeloso m (feminine singular zelosa, masculine plural zelosos, feminine plural zelosas, comparable)
activa	Adjective	activa f sg
reverso	Adjective	reverso m (feminine singular reversa, masculine plural reversos, feminine plural reversas, not comparable)
rude	Adjective	rude m, f (plural rudes, comparable)
lindo	Adjective	lindo m (feminine singular linda, masculine plural lindos, feminine plural lindas, comparable)
afro	Adjective	afro (plural afro, comparable)
serva	Adjective	serva
piano	Adjective	piano
famoso	Adjective	famoso m (feminine singular famosa, masculine plural famosos, feminine plural famosas, comparable)
exterior	Adjective	exterior m, f (plural exteriores, comparable)
ti	Adjective	ti (invariable, comparable)
elegante	Adjective	elegante m, f (plural elegantes, comparable)
vero	Adjective	vero m (feminine singular vera, masculine plural veros, feminine plural veras, comparable)
intestinal	Adjective	intestinal m, f (plural intestinais, comparable)
obscuro	Adjective	obscuro m (feminine singular obscura, masculine plural obscuros, feminine plural obscuras, comparable)
burra	Adjective	burra f sg
velar	Adjective	velar m, f (plural velares, comparable)
grave	Adjective	grave m, f (plural graves, comparable)
parelho	Adjective	parelho m (feminine singular parelha, masculine plural parelhos, feminine plural parelhas, comparable)
roma	Adjective	roma (plural roma, comparable)
embaraçoso	Adjective	embaraçoso m (feminine singular embaraçosa, masculine plural embaraçosos, feminine plural embaraçosas, comparable)
singular	Adjective	singular m, f (plural singulares, comparable)
japa	Adjective	japa m, f (plural japas, comparable)
popular	Adjective	popular m, f (plural populares, comparable)
filial	Adjective	filial m, f (plural filiais, comparable)
puta	Adjective	puta (plural, comparable)
vasto	Adjective	vasto m (feminine singular vasta, masculine plural vastos, feminine plural vastas, comparable)
divertido	Adjective	divertido m (feminine singular divertida, masculine plural divertidos, feminine plural divertidas, comparable)
seco	Adjective	seco m (feminine singular seca, masculine plural secos, feminine plural secas, comparable)
presidente	Adjective	presidente m, f (plural presidentes, not comparable)
sincero	Adjective	sincero m (feminine singular sincera, masculine plural sinceros, feminine plural sinceras, comparable)
falsa	Adjective	falsa f sg
gato	Adjective	gato m (feminine singular gata, masculine plural gatos, feminine plural gatas, comparable)
lato	Adjective	lato m (feminine singular lata, masculine plural latos, feminine plural latas, comparable)
barulhento	Adjective	barulhento m (feminine singular barulhenta, masculine plural barulhentos, feminine plural barulhentas, comparable)
titular	Adjective	titular m, f (plural titulares, comparable)
alinhado	Adjective	alinhado m (feminine singular alinhada, masculine plural alinhados, feminine plural alinhadas, comparable)
gelada	Adjective	gelada f sg
honestas	Adjective	honestas f pl
intelectual	Adjective	intelectual m, f (plural intelectuais, comparable)
assado	Adjective	assado m (feminine singular assada, masculine plural assados, feminine plural assadas, comparable)
sarna	Adjective	sarna m, f (plural sarnas, comparable)
fodástico	Adjective	fodástico m (feminine singular fodástica, masculine plural fodásticos, feminine plural fodásticas, comparable)
invejoso	Adjective	invejoso m (feminine singular invejosa, masculine plural invejosos, feminine plural invejosas, comparable)
animado	Adjective	animado m (feminine singular animada, masculine plural animados, feminine plural animadas, sometimes comparable)
dimensional	Adjective	dimensional (plural, comparable)
acidentado	Adjective	acidentado m (feminine singular acidentada, masculine plural acidentados, feminine plural acidentadas, comparable)
alba	Adjective	alba (plural albas, comparable)
desagradável	Adjective	desagradável m, f (plural desagradáveis, comparable)
santa	Adjective	santa f sg
reta	Adjective	reta f sg
coxa	Adjective	coxa (invariable, comparable)
coxa	Adjective	coxa f sg
mister	Adjective	mister (plural mister, comparable)
mortal	Adjective	mortal m, f (plural mortais, sometimes comparable)
civil	Adjective	civil m, f (plural civis, comparable)
angla	Adjective	angla f sg
educado	Adjective	educado m (feminine singular educada, masculine plural educados, feminine plural educadas, comparable)
total	Adjective	total m, f (plural totais, comparable)
protector	Adjective	protector m (feminine singular protectora, masculine plural protectores, feminine plural protectoras, comparable)
distal	Adjective	distal m, f (plural distais, comparable)
provável	Adjective	provável m, f (plural prováveis, comparable)
afiado	Adjective	afiado m (feminine singular afiada, masculine plural afiados, feminine plural afiadas, comparable)
invejável	Adjective	invejável m, f (plural invejáveis, comparable)
nato	Adjective	nato m (feminine singular nata, masculine plural natos, feminine plural natas, comparable)
romani	Adjective	romani (plural romani, comparable)
azedo	Adjective	azedo m (feminine singular azeda, masculine plural azedos, feminine plural azedas, comparable)
honorável	Adjective	honorável m, f (plural honoráveis, comparable)
aino	Adjective	aino m (feminine singular aina, masculine plural ainos, feminine plural ainas, comparable)
decimal	Adjective	decimal m, f (plural decimais, comparable)
subtil	Adjective	subtil m, f (plural subtis, comparable) (European orthography)
frouxo	Adjective	frouxo m (feminine singular frouxa, masculine plural frouxos, feminine plural frouxas, comparable)
funcional	Adjective	funcional m, f (plural funcionais, comparable)
angular	Adjective	angular m, f (plural angulares, comparable)
hindustani	Adjective	hindustani (plural hindustani, comparable)
frio	Adjective	frio m (feminine singular fria, masculine plural frios, feminine plural frias, comparable)
acostumado	Adjective	acostumado m (feminine singular acostumada, masculine plural acostumados, feminine plural acostumadas, comparable)
punheteiro	Adjective	punheteiro m (feminine singular punheteira, masculine plural punheteiros, feminine plural punheteiras, comparable)
comestível	Adjective	comestível m, f (plural comestíveis, comparable)
incorreto	Adjective	incorreto m (feminine singular incorreta, masculine plural incorretos, feminine plural incorretas, comparable)
cervical	Adjective	cervical m, f (plural cervicais, comparable)
servis	Adjective	servis m f pl
modular	Adjective	modular m, f (plural modulares, comparable)
ré	Adjective	ré f sg
solto	Adjective	solto m (feminine singular solta, masculine plural soltos, feminine plural soltas, comparable)
profano	Adjective	profano m (feminine singular profana, masculine plural profanos, feminine plural profanas, comparable)
piedoso	Adjective	piedoso m (feminine singular piedosa, masculine plural piedosos, feminine plural piedosas, comparable)
vaga	Adjective	vaga f sg
testicular	Adjective	testicular (plural testiculares, comparable)
domiciliar	Adjective	domiciliar m, f (plural domiciliares, comparable)
paranormal	Adjective	paranormal m, f (plural paranormais, comparable)
leiga	Adjective	leiga f sg
abrangente	Adjective	abrangente m, f (plural abrangentes, comparable)
surreal	Adjective	surreal m, f (plural surreais, comparable)
fixa	Adjective	fixa f sg
aspero	Adjective	aspero m (feminine singular aspera, masculine plural asperos, feminine plural asperas, comparable)
lamentável	Adjective	lamentável m, f (plural lamentáveis, comparable)
imundo	Adjective	imundo m (feminine singular imunda, masculine plural imundos, feminine plural imundas, comparable)
cego	Adjective	cego m (feminine singular cega, masculine plural cegos, feminine plural cegas, sometimes comparable)
enthusiasta	Adjective	enthusiasta m, f (plural enthusiastas, comparable)
elementar	Adjective	elementar m, f (plural elementares, comparable)
problemático	Adjective	problemático m (feminine singular problemática, masculine plural problemáticos, feminine plural problemáticas, comparable)
sacro	Adjective	sacro m (feminine singular sacra, masculine plural sacros, feminine plural sacras, comparable)
puto	Adjective	puto m (feminine singular puta, masculine plural putos, feminine plural putas, comparable)
rival	Adjective	rival m, f (plural rivais, comparable)
oculto	Adjective	oculto m (feminine singular oculta, masculine plural ocultos, feminine plural ocultas, comparable)
maldisposto	Adjective	maldisposto m (feminine singular maldisposta, masculine plural maldispostos, feminine plural maldispostas, comparable)
sereno	Adjective	sereno m (feminine singular serena, masculine plural serenos, feminine plural serenas, comparable)
lateral	Adjective	lateral m, f (plural laterais, comparable)
apropriado	Adjective	apropriado m (feminine singular apropriada, masculine plural apropriados, feminine plural apropriadas, comparable)
cagão	Adjective	cagão m (feminine singular cagona, masculine plural cagões, feminine plural cagonas, comparable)
admissor	Adjective	admissor m (feminine singular admissora, masculine plural admissores, feminine plural admissoras, comparable)
irracional	Adjective	irracional m, f (plural irracionais, sometimes comparable)
fundo	Adjective	fundo m (feminine singular funda, masculine plural fundos, feminine plural fundas, comparable)
bemol	Adjective	bemol (plural bemóis, not comparable)
abacial	Adjective	abacial m, f (plural abaciais, comparable)
focal	Adjective	focal m, f (plural focais, comparable)
sumo	Adjective	sumo m (feminine singular suma, masculine plural sumos, feminine plural sumas, comparable)
guloso	Adjective	guloso m (feminine singular gulosa, masculine plural gulosos, feminine plural gulosas, comparable)
alimentar	Adjective	alimentar m, f (plural alimentares, comparable)
anis	Adjective	anis
oral	Adjective	oral m, f (plural orais, comparable)
plural	Adjective	plural m, f (plural plurais, comparable)
idiota	Adjective	idiota (plural, comparable)
malcomportado	Adjective	malcomportado m (feminine singular malcomportada, masculine plural malcomportados, feminine plural malcomportadas, comparable)
atrapalhado	Adjective	atrapalhado m (feminine singular atrapalhada, masculine plural atrapalhados, feminine plural atrapalhadas, comparable)
interessante	Adjective	interessante m, f (plural interessantes, comparable)
digno	Adjective	digno m (feminine singular digna, masculine plural dignos, feminine plural dignas, comparable)
maltez	Adjective	maltez m (feminine singular malteza, masculine plural maltezes, feminine plural maltezas, not comparable)
casto	Adjective	casto m (feminine singular casta, masculine plural castos, feminine plural castas, comparable)
barato	Adjective	barato m (feminine singular barata, masculine plural baratos, feminine plural baratas, comparable)
fedorento	Adjective	fedorento m (feminine singular fedorenta, masculine plural fedorentos, feminine plural fedorentas, comparable)
venerável	Adjective	venerável m, f (plural veneráveis, comparable)
esquecível	Adjective	esquecível m, f (plural esquecíveis, comparable)
mayor	Adjective	mayor m, f (plural mayores, comparable)
bebido	Adjective	bebido m (feminine singular bebida, masculine plural bebidos, feminine plural bebidas, comparable)
excitado	Adjective	excitado m (feminine singular excitada, masculine plural excitados, feminine plural excitadas, comparable)
caros	Adjective	caros m pl
gelo	Adjective	gelo (invariable, comparable)
piroso	Adjective	piroso m (feminine singular pirosa, masculine plural pirosos, feminine plural pirosas, comparable)
gradual	Adjective	gradual m, f (plural graduais, comparable)
avar	Adjective	avar m, f (plural avares, comparable)
plácido	Adjective	plácido m (feminine singular plácida, masculine plural plácidos, feminine plural plácidas, comparable)
atrasado	Adjective	atrasado m (feminine singular atrasada, masculine plural atrasados, feminine plural atrasadas, comparable)
desasseado	Adjective	desasseado m (feminine singular desasseada, masculine plural desasseados, feminine plural desasseadas, comparable)
defensável	Adjective	defensável m, f (plural defensáveis, comparable)
molhável	Adjective	molhável m, f (plural molháveis, comparable)
ventral	Adjective	ventral m, f (plural ventrais, comparable)
salva	Adjective	salva f sg
casta	Adjective	casta f sg
atrevido	Adjective	atrevido m (feminine singular atrevida, masculine plural atrevidos, feminine plural atrevidas, comparable)
coclear	Adjective	coclear m, f (plural cocleares, comparable)
juvenis	Adjective	juvenis m f pl
swahili	Adjective	swahili (plural swahili, not comparable)
promissor	Adjective	promissor m (feminine singular promissora, masculine plural promissores, feminine plural promissoras, comparable)
formular	Adjective	formular (plural formulares, comparable)
desumano	Adjective	desumano m (feminine singular desumana, masculine plural desumanos, feminine plural desumanas, comparable)
moral	Adjective	moral m, f (plural morais, comparable)
probo	Adjective	probo m (feminine singular proba, masculine plural probos, feminine plural probas, comparable)
militar	Adjective	militar m, f (plural militares, comparable)
albino	Adjective	albino m (feminine singular albina, masculine plural albinos, feminine plural albinas, comparable)
limpo	Adjective	limpo m (feminine singular limpa, masculine plural limpos, feminine plural limpas, comparable)
leve	Adjective	leve m, f (plural leves, comparable)
nova	Adjective	nova f sg
pago	Adjective	pago m (feminine singular paga, masculine plural pagos, feminine plural pagas, comparable)
definido	Adjective	definido m (feminine singular definida, masculine plural definidos, feminine plural definidas, comparable)
brava	Adjective	brava f sg
percussor	Adjective	percussor m (feminine singular percussora, masculine plural percussores, feminine plural percussoras, comparable)
adverbial	Adjective	adverbial m, f (plural adverbiais, comparable)
calma	Adjective	calma f sg
violento	Adjective	violento m (feminine singular violenta, masculine plural violentos, feminine plural violentas, comparable)
nazis	Adjective	nazis m pl, f pl
satisfeito	Adjective	satisfeito m (feminine singular satisfeita, masculine plural satisfeitos, feminine plural satisfeitas, comparable)
gira	Adjective	gira f sg
tinta	Adjective	tinta f sg
flutuável	Adjective	flutuável m, f (plural flutuáveis, comparable)
azulado	Adjective	azulado m (feminine singular azulada, masculine plural azulados, feminine plural azuladas, comparable)
vulgar	Adjective	vulgar (plural vulgares, comparable)
proba	Adjective	proba f sg
extra	Adjective	extra m, f (plural extras, comparable)
desajeitado	Adjective	desajeitado m (feminine singular desajeitada, masculine plural desajeitados, feminine plural desajeitadas, comparable)
estreito	Adjective	estreito m (feminine singular estreita, masculine plural estreitos, feminine plural estreitas, comparable)
extraordinário	Adjective	extraordinário m (feminine singular extraordinária, masculine plural extraordinários, feminine plural extraordinárias, comparable)
graúdo	Adjective	graúdo m (feminine singular graúda, masculine plural graúdos, feminine plural graúdas, comparable)
descontente	Adjective	descontente m, f (plural descontentes, comparable)
bi	Adjective	bi (plural bi, comparable)
saudável	Adjective	saudável m, f (plural saudáveis, comparable)
remoto	Adjective	remoto m (feminine singular remota, masculine plural remotos, feminine plural remotas, comparable)
belo	Adjective	belo m (feminine singular bela, masculine plural belos, feminine plural belas, comparable)
falso	Adjective	falso m (feminine singular falsa, masculine plural falsos, feminine plural falsas, comparable)
filipino	Adjective	filipino m (feminine singular filipina, masculine plural filipinos, feminine plural filipinas, comparable)
unilateral	Adjective	unilateral m, f (plural unilaterais, comparable)
formoso	Adjective	formoso m (feminine singular formosa, masculine plural formosos, feminine plural formosas, comparable)
vizinho	Adjective	vizinho m (feminine singular vizinha, masculine plural vizinhos, feminine plural vizinhas, comparable)
chato	Adjective	chato m (feminine singular chata, masculine plural chatos, feminine plural chatas, comparable)
fusco	Adjective	fusco m (feminine singular fusca, masculine plural fuscos, feminine plural fuscas, comparable)
média	Adjective	média f sg
fatal	Adjective	fatal m, f (plural fatais, comparable)
sestra	Adjective	sestra f sg
foda	Adjective	foda m, f (plural fodas, comparable)
curvo	Adjective	curvo m (feminine singular curva, masculine plural curvos, feminine plural curvas, comparable)
imbecil	Adjective	imbecil m, f (plural imbecis, comparable)
nuclear	Adjective	nuclear m, f (plural nucleares, comparable)
universal	Adjective	universal m, f (plural universais, comparable)
doentio	Adjective	doentio m (feminine singular doentia, masculine plural doentios, feminine plural doentias, comparable)
lasso	Adjective	lasso m (feminine singular lassa, masculine plural lassos, feminine plural lassas, comparable)
frontal	Adjective	frontal m, f (plural frontais, comparable)
top	Adjective	top (invariable, comparable)
adaxial	Adjective	adaxial m, f (plural adaxiais, comparable)
maligno	Adjective	maligno m (feminine singular maligna, masculine plural malignos, feminine plural malignas, comparable)
sensual	Adjective	sensual m, f (plural sensuais, comparable)
cheiroso	Adjective	cheiroso m (feminine singular cheirosa, masculine plural cheirosos, feminine plural cheirosas, comparable)
má	Adjective	má
zero	Adjective	zero m f pl
metaphysica	Adjective	metaphysica f sg
movediço	Adjective	movediço m (feminine singular movediça, masculine plural movediços, feminine plural movediças, comparable)
pueril	Adjective	pueril (plural pueris, comparable)
episcopal	Adjective	episcopal m, f (plural episcopais, comparable)
recente	Adjective	recente m, f (plural recentes, comparable)
mongol	Adjective	mongol (plural mongóis, not comparable)
terrorista	Adjective	terrorista m, f (plural terroristas, not comparable)
dental	Adjective	dental m, f (plural dentais, comparable)
rota	Adjective	rota f sg
terna	Adjective	terna f sg
raro	Adjective	raro m (feminine singular rara, masculine plural raros, feminine plural raras, comparable)
tagarela	Adjective	tagarela m, f (plural tagarelas, comparable)
darwinista	Adjective	darwinista m, f (plural darwinistas, comparable)
irreparável	Adjective	irreparável m, f (plural irreparáveis, comparable)
arrogante	Adjective	arrogante m, f (plural arrogantes, comparable)
dual	Adjective	dual m, f (plural duais, comparable)
claro	Adjective	claro m (feminine singular clara, masculine plural claros, feminine plural claras, comparable)
tabu	Adjective	tabu (plural tabu, comparable)
gris	Adjective	gris (plural gris, comparable)
insincero	Adjective	insincero m (feminine singular insincera, masculine plural insinceros, feminine plural insinceras, comparable)
monstro	Adjective	monstro m (feminine singular monstra, masculine plural monstros, feminine plural monstras, comparable)
racista	Adjective	racista m, f (plural racistas, comparable)
linear	Adjective	linear m, f (plural lineares, comparable)
cem	Adjective	cem m, f
rés	Adjective	rés (invariable, comparable)
gritante	Adjective	gritante m, f (plural gritantes, comparable)
rural	Adjective	rural m, f (plural rurais, comparable)
anterior	Adjective	anterior (plural anteriores, comparable)
demo	Adjective	demo (plural demos, not comparable)
vista	Adjective	vista f sg
imaginável	Adjective	imaginável m, f (plural imagináveis, comparable)
capital	Adjective	capital m, f (plural capitais, comparable)
findo	Adjective	findo m (feminine singular finda, masculine plural findos, feminine plural findas, comparable)
expressivo	Adjective	expressivo m (feminine singular expressiva, masculine plural expressivos, feminine plural expressivas, comparable)
meticuloso	Adjective	meticuloso m (feminine singular meticulosa, masculine plural meticulosos, feminine plural meticulosas, comparable)
morto	Adjective	morto m (feminine singular morta, masculine plural mortos, feminine plural mortas, sometimes comparable)
peidorreiro	Adjective	peidorreiro m (feminine singular peidorreira, masculine plural peidorreiros, feminine plural peidorreiras, comparable)
engenhoso	Adjective	engenhoso m (feminine singular engenhosa, masculine plural engenhosos, feminine plural engenhosas, comparable)
hindu	Adjective	hindu (plural hindus, comparable)
delicado	Adjective	delicado m (feminine singular delicada, masculine plural delicados, feminine plural delicadas, comparable)
oca	Adjective	oca f sg
dupla	Adjective	dupla f sg
bonitas	Adjective	bonitas f pl
vasta	Adjective	vasta f sg
marxista	Adjective	marxista m, f (plural marxistas, comparable)
janota	Adjective	janota m, f (plural janotas, comparable)
balear	Adjective	balear (plural baleares, comparable)
aceitável	Adjective	aceitável m, f (plural aceitáveis, comparable)
jeitoso	Adjective	jeitoso m (feminine singular jeitosa, masculine plural jeitosos, feminine plural jeitosas, comparable)
meigo	Adjective	meigo m (feminine singular meiga, masculine plural meigos, feminine plural meigas, comparable)
show	Adjective	show (invariable, comparable)
pretendido	Adjective	pretendido m (feminine singular pretendida, masculine plural pretendidos, feminine plural pretendidas, comparable)
gostoso	Adjective	gostoso m (feminine singular gostosa, masculine plural gostosos, feminine plural gostosas, comparable)
minimalista	Adjective	minimalista m, f (plural minimalistas, comparable)
lenta	Adjective	lenta f sg
juvenil	Adjective	juvenil m, f (plural juvenis, comparable)
direito	Adjective	direito m (feminine singular direita, masculine plural direitos, feminine plural direitas, comparable)
acerbo	Adjective	acerbo m (feminine singular acerba, masculine plural acerbos, feminine plural acerbas, comparable)
copta	Adjective	copta m, f (plural coptas, comparable)
iletrado	Adjective	iletrado m (feminine singular iletrada, masculine plural iletrados, feminine plural iletradas, comparable)
aqueus	Adjective	aqueus m pl
subversivo	Adjective	subversivo m (feminine singular subversiva, masculine plural subversivos, feminine plural subversivas, comparable)
alternativa	Adjective	alternativa f sg
maltrapilho	Adjective	maltrapilho m (feminine singular maltrapilha, masculine plural maltrapilhos, feminine plural maltrapilhas, comparable)
nua	Adjective	nua f sg
boreal	Adjective	boreal m, f (plural boreais, comparable)
virtuoso	Adjective	virtuoso m (feminine singular virtuosa, masculine plural virtuosos, feminine plural virtuosas, comparable)
virtuoso	Adjective	virtuoso m (feminine singular virtuosa, masculine plural virtuosos, feminine plural virtuosas, comparable)
tuga	Adjective	tuga m, f (plural tugas, not comparable)
adutor	Adjective	adutor m (feminine singular adutora, masculine plural adutores, feminine plural adutoras, comparable)
continental	Adjective	continental m, f (plural continentais, comparable)
puras	Adjective	puras f pl
navajo	Adjective	navajo (plural navajo, comparable)
halal	Adjective	halal (plural halal, comparable)
vital	Adjective	vital m, f (plural vitais, comparable)
retais	Adjective	retais m f pl
auxiliar	Adjective	auxiliar (plural auxiliares, comparable)
tolo	Adjective	tolo m (feminine singular tola, masculine plural tolos, feminine plural tolas, comparable)
kamikaze	Adjective	kamikaze m, f (plural kamikazes, comparable)
anormal	Adjective	anormal m, f (plural anormais, comparable)
determinado	Adjective	determinado m (feminine singular determinada, masculine plural determinados, feminine plural determinadas, comparable)
torta	Adjective	torta f sg
oficial	Adjective	oficial m, f (plural oficiais, comparable)
desprezível	Adjective	desprezível m, f (plural desprezíveis, comparable)
bonito	Adjective	bonito m (feminine singular bonita, masculine plural bonitos, feminine plural bonitas, comparable)
evidente	Adjective	evidente m, f (plural evidentes, comparable)
ainu	Adjective	ainu (plural, not comparable)
galego	Adjective	galego m (feminine singular galega, masculine plural galegos, feminine plural galegas, not comparable)
este	Adjective	este m, f (plural estes, comparable)
maxillar	Adjective	maxillar m, f (plural maxillares, not comparable)
peludo	Adjective	peludo m (feminine singular peluda, masculine plural peludos, feminine plural peludas, comparable)
rítmico	Adjective	rítmico m (feminine singular rítmica, masculine plural rítmicos, feminine plural rítmicas, comparable)
diferente	Adjective	diferente m, f (plural diferentes, comparable)
certo	Adjective	certo m (feminine singular certa, masculine plural certos, feminine plural certas, comparable)
confortável	Adjective	confortável m, f (plural confortáveis, comparable)
inflamável	Adjective	inflamável m, f (plural inflamáveis, comparable)
adverso	Adjective	adverso m (feminine singular adversa, masculine plural adversos, feminine plural adversas, comparable)
sorridente	Adjective	sorridente m, f (plural sorridentes, comparable)
maldito	Adjective	maldito m (feminine singular maldita, masculine plural malditos, feminine plural malditas, comparable)
preguiçoso	Adjective	preguiçoso m (feminine singular preguiçosa, masculine plural preguiçosos, feminine plural preguiçosas, comparable)
crus	Adjective	crus m pl
feio	Adjective	feio m (feminine singular feia, masculine plural feios, feminine plural feias, comparable)
criminal	Adjective	criminal m, f (plural criminais, not comparable)
bello	Adjective	bello (plural bellos, comparable)
vivo	Adjective	vivo m (feminine singular viva, masculine plural vivos, feminine plural vivas, comparable)
grego	Adjective	grego m (feminine singular grega, masculine plural gregos, feminine plural gregas, comparable)
alar	Adjective	alar m, f (plural alares, comparable)
macio	Adjective	macio m (feminine singular macia, masculine plural macios, feminine plural macias, comparable)
gratuitas	Adjective	gratuitas f pl
banal	Adjective	banal m, f (plural banais, comparable)
boa	Adjective	boa f sg
horizontal	Adjective	horizontal m, f (plural horizontais, not comparable)
metodista	Adjective	metodista m, f (plural medotistas, comparable)
rosa	Adjective	rosa (plural rosa, comparable)
dura	Adjective	dura f sg
atraente	Adjective	atraente m, f (plural atraentes, comparable)
surda	Adjective	surda f sg
jugular	Adjective	jugular m, f (plural jugulares, comparable)
local	Adjective	local m, f (plural locais, comparable)
patriota	Adjective	patriota m, f (plural patriotas, comparable)
molhado	Adjective	molhado m (feminine singular molhada, masculine plural molhados, feminine plural molhadas, comparable)
abdominal	Adjective	abdominal m, f (plural abdominais, not comparable)
esquerdo	Adjective	esquerdo m (feminine singular esquerda, masculine plural esquerdos, feminine plural esquerdas, comparable)
exigente	Adjective	exigente m, f (plural exigentes, comparable)
linda	Adjective	linda f sg
bicha	Adjective	bicha m, f (plural bichas, sometimes comparable)
porrado	Adjective	porrado m (feminine singular porrada, masculine plural porrados, feminine plural porradas, comparable)
desleal	Adjective	desleal (plural desleais, comparable)
escuro	Adjective	escuro m (feminine singular escura, masculine plural escuros, feminine plural escuras, comparable)
atencioso	Adjective	atencioso m (feminine singular atenciosa, masculine plural atenciosos, feminine plural atenciosas, comparable)
physica	Adjective	physica f sg
cerebral	Adjective	cerebral m, f (plural cerebrais, comparable)
vetustas	Adjective	vetustas f pl
cuspido	Adjective	cuspido m (feminine singular cuspida, masculine plural cuspidos, feminine plural cuspidas, comparable)
regular	Adjective	regular m, f (plural regulares, comparable)
estipular	Adjective	estipular m, f (plural estipulares, comparable)
feroz	Adjective	feroz m, f (plural ferozes, comparable)
imperial	Adjective	imperial m, f (plural imperiais, comparable)
marista	Adjective	marista m, f (plural maristas, comparable)
viscoso	Adjective	viscoso m (feminine singular viscosa, masculine plural viscosos, feminine plural viscosas, comparable)
azul	Adjective	azul m, f (plural azuis, comparable)
plana	Adjective	plana f sg
curto	Adjective	curto m (feminine singular curta, masculine plural curtos, feminine plural curtas, comparable)
honesto	Adjective	honesto m (feminine singular honesta, masculine plural honestos, feminine plural honestas, comparable)
amado	Adjective	amado m (feminine singular amada, masculine plural amados, feminine plural amadas, comparable)
bengali	Adjective	bengali (plural, not comparable)
lento	Adjective	lento m (feminine singular lenta, masculine plural lentos, feminine plural lentas, comparable)
fofo	Adjective	fofo m (feminine singular fofa, masculine plural fofos, feminine plural fofas, comparable)
tímido	Adjective	tímido m (feminine singular tímida, masculine plural tímidos, feminine plural tímidas, comparable)
podre	Adjective	podre m, f (plural podres, comparable)
mental	Adjective	mental m, f (plural mentais, comparable)
sentimental	Adjective	sentimental m, f (plural sentimentais, comparable)
proposital	Adjective	proposital m, f (plural propositais, comparable)
sedento	Adjective	sedento m (feminine singular sedenta, masculine plural sedentos, feminine plural sedentas, comparable)
dicto	Adjective	dicto m (feminine singular dicta, masculine plural dictos, feminine plural dictas, comparable)
infantil	Adjective	infantil m, f (plural infantis, comparable)
binocular	Adjective	binocular m, f (plural binoculares, comparable)
aboral	Adjective	aboral m, f (plural aborais, comparable)
absurdo	Adjective	absurdo m (feminine singular absurda, masculine plural absurdos, feminine plural absurdas, comparable)
ruim	Adjective	ruim (plural ruins, comparable)
pronto	Adjective	pronto m (feminine singular pronta, masculine plural prontos, feminine plural prontas, comparable)
conversível	Adjective	conversível m, f (plural conversíveis, comparable)
simpático	Adjective	simpático m (feminine singular simpática, masculine plural simpáticos, feminine plural simpáticas, comparable)
fluente	Adjective	fluente m, f (plural fluentes, comparable)
mundial	Adjective	mundial m, f (plural mundiais, comparable)
tricolor	Adjective	tricolor (plural tricolores, comparable)
escalar	Adjective	escalar m, f (plural escalares, comparable)
sefardi	Adjective	sefardi (plural sefardis, not comparable)
abstrato	Adjective	abstrato m (feminine singular abstrata, masculine plural abstratos, feminine plural abstratas, comparable)
frágil	Adjective	frágil m, f (plural frágeis, comparable)
sedimentar	Adjective	sedimentar m, f (plural sedimentares, comparable)
justo	Adjective	justo m (feminine singular justa, masculine plural justos, feminine plural justas, comparable)
cheio	Adjective	cheio m (feminine singular cheia, masculine plural cheios, feminine plural cheias, comparable)
crítico	Adjective	crítico m (feminine singular crítica, masculine plural críticos, feminine plural críticas, comparable)
grilado	Adjective	grilado m (feminine singular grilada, masculine plural grilados, feminine plural griladas, comparable)
considerável	Adjective	considerável m, f (plural consideráveis, comparable)
analfabeta	Adjective	analfabeta f sg
animal	Adjective	animal m, f (plural animais, comparable)
maori	Adjective	maori (plural maoris, comparable)
celta	Adjective	celta m, f (plural celtas, comparable)
sujo	Adjective	sujo m (feminine singular suja, masculine plural sujos, feminine plural sujas, comparable)
acirrado	Adjective	acirrado m (feminine singular acirrada, masculine plural acirrados, feminine plural acirradas, comparable)
melado	Adjective	melado m (feminine singular melada, masculine plural melados, feminine plural meladas, comparable)
melado	Adjective	melado m (feminine singular melada, masculine plural melados, feminine plural meladas, comparable)
poliglota	Adjective	poliglota m, f (plural poliglotas, comparable)
feudal	Adjective	feudal m, f (plural feudais)
macho	Adjective	macho m
queimado	Adjective	queimado m (feminine singular queimada, masculine plural queimados, feminine plural queimadas, comparable)
lunar	Adjective	lunar (plural lunares, comparable)
relaxado	Adjective	relaxado m (feminine singular relaxada, masculine plural relaxados, feminine plural relaxadas, comparable)
optimista	Adjective	optimista m, f (plural optimistas, comparable)
modal	Adjective	modal m, f (plural modais, comparable)
apto	Adjective	apto m (feminine singular apta, masculine plural aptos, feminine plural aptas, comparable)
ovular	Adjective	ovular m, f (plural ovulares, comparable)
vis	Adjective	vis m f pl
autista	Adjective	autista m, f (plural autistas, comparable)
rotundo	Adjective	rotundo m (feminine singular rotunda, masculine plural rotundos, feminine plural rotundas, comparable)
insensível	Adjective	insensível m, f (plural insensíveis, comparable)
nominal	Adjective	nominal m, f (plural nominais, comparable)
viral	Adjective	viral m, f (plural virais, comparable)
invariável	Adjective	invariável m, f (plural invariáveis, comparable)
dorsal	Adjective	dorsal m, f (plural dorsais, comparable)
parada	Adjective	parada f sg
contente	Adjective	contente m, f (plural contentes, comparable)
pesado	Adjective	pesado m (feminine singular pesada, masculine plural pesados, feminine plural pesadas, comparable)
rija	Adjective	rija f sg
abafado	Adjective	abafado m (feminine singular abafada, masculine plural abafados, feminine plural abafadas, comparable)
estrangeiro	Adjective	estrangeiro m (feminine singular estrangeira, masculine plural estrangeiros, feminine plural estrangeiras, sometimes comparable)
pio	Adjective	pio m (feminine singular pia, masculine plural pios, feminine plural pias, comparable)
sério	Adjective	sério m (feminine singular séria, masculine plural sérios, feminine plural sérias, comparable)
sexual	Adjective	sexual m, f (plural sexuais, comparable)
azeri	Adjective	azeri (plural azeri, comparable)
parlamentar	Adjective	parlamentar m, f (plural parlamentares, comparable)
planas	Adjective	planas f pl
errado	Adjective	errado m (feminine singular errada, masculine plural errados, feminine plural erradas, comparable)
conceituado	Adjective	conceituado m (feminine singular conceituada, masculine plural conceituados, feminine plural conceituadas, comparable)
nada	Adjective	nada f sg
final	Adjective	final m, f (plural finais, comparable)
matador	Adjective	matador m (feminine singular matadora, masculine plural matadores, feminine plural matadoras, comparable)
seria	Adjective	seria f sg
novo	Adjective	novo m (feminine singular nova, masculine plural novos, feminine plural novas, comparable)
motor	Adjective	motor m (feminine singular motora, masculine plural motores, feminine plural motoras, comparable)
delicioso	Adjective	delicioso m (feminine singular deliciosa, masculine plural deliciosos, feminine plural deliciosas, comparable)
toda	Adjective	toda f sg
toda	Adjective	toda m, f (plural todas, not comparable)
disponível	Adjective	disponível m, f (plural disponíveis, comparable)
sonolento	Adjective	sonolento m (feminine singular sonolenta, masculine plural sonolentos, feminine plural sonolentas, comparable)
duro	Adjective	duro m (feminine singular dura, masculine plural duros, feminine plural duras, comparable)
limonada	Adjective	limonada f sg
anglas	Adjective	anglas f pl
elevado	Adjective	elevado m (feminine singular elevada, masculine plural elevados, feminine plural elevadas, comparable)
giro	Adjective	giro m (feminine singular gira, masculine plural giros, feminine plural giras, comparable)
ocas	Adjective	ocas f pl
brando	Adjective	brando m (feminine singular branda, masculine plural brandos, feminine plural brandas, comparable)
fria	Adjective	fria f sg
acutilante	Adjective	acutilante m, f (plural acutilantes, comparable)
bundudo	Adjective	bundudo m (feminine singular bunduda, masculine plural bundudos, feminine plural bundudas, comparable)
verdes	Adjective	verdes m f pl
primordial	Adjective	primordial m, f (plural primordiais, comparable)
farto	Adjective	farto m (feminine singular farta, masculine plural fartos, feminine plural fartas, comparable)
circular	Adjective	circular m, f (plural circulares, comparable)
bipolar	Adjective	bipolar m, f (plural bipolares, comparable)
original	Adjective	original m, f (plural originais, comparable)
rasca	Adjective	rasca m, f (plural rascas, comparable)
grosso	Adjective	grosso m (feminine singular grossa, masculine plural grossos, feminine plural grossas, comparable)
multicolor	Adjective	multicolor m, f (plural multicolores, comparable)
ensonado	Adjective	ensonado m (feminine singular ensonada, masculine plural ensonados, feminine plural ensonadas, comparable)
preocupado	Adjective	preocupado m (feminine singular preocupada, masculine plural preocupados, feminine plural preocupadas, comparable)
abaxial	Adjective	abaxial m, f (plural abaxiais, comparable)
severo	Adjective	severo m (feminine singular severa, masculine plural severos, feminine plural severas, comparable)
asseado	Adjective	asseado m (feminine singular asseada, masculine plural asseados, feminine plural asseadas, comparable)
atonal	Adjective	atonal m, f (plural atonais, comparable)
nojento	Adjective	nojento m (feminine singular nojenta, masculine plural nojentos, feminine plural nojentas, comparable)
bilabial	Adjective	bilabial m, f (plural bilabiais, comparable)
alveolar	Adjective	alveolar m, f (plural alveolares, comparable)
papal	Adjective	papal m, f (plural papais, comparable)
amável	Adjective	amável m, f (plural amáveis, comparable)
reto	Adjective	reto m (feminine singular reta, masculine plural retos, feminine plural retas, comparable)
andante	Adjective	andante m, f (plural andantes, comparable)
andante	Adjective	andante m, f (plural andantes, comparable)
exemplar	Adjective	exemplar m, f (plural exemplares, comparable)
maior	Adjective	maior (plural maiores, comparable)
apimentado	Adjective	apimentado m (feminine singular apimentada, masculine plural apimentados, feminine plural apimentadas, comparable)
disposto	Adjective	disposto m (feminine singular disposta, masculine plural dispostos, feminine plural dispostas, comparable)
divino	Adjective	divino m (feminine singular divina, masculine plural divinos, feminine plural divinas, comparable)
retardado	Adjective	retardado m (feminine singular retardada, masculine plural retardados, feminine plural retardadas, comparable)
abrasivo	Adjective	abrasivo m (feminine singular abrasiva, masculine plural abrasivos, feminine plural abrasivas, comparable)
terrível	Adjective	terrível m, f (plural terríveis, comparable)
diagonal	Adjective	diagonal m, f (plural diagonais, comparable)
viril	Adjective	viril (plural viris, comparable)
maleável	Adjective	maleável m, f (plural maleáveis, comparable)
posterior	Adjective	posterior m, f (plural posteriores, comparable)
vaginal	Adjective	vaginal m, f (plural vaginais, comparable)
maya	Adjective	maya m, f (plural mayas, not comparable)
inferior	Adjective	inferior m, f (plural inferiores, comparable)
calamitoso	Adjective	calamitoso m (feminine singular calamitosa, masculine plural calamitosos, feminine plural calamitosas, comparable)
tripla	Adjective	tripla f sg
laranja	Adjective	laranja (plural, comparable)
homo	Adjective	homo (plural homo, comparable)
suplementar	Adjective	suplementar m, f (plural suplementares, comparable)
profundo	Adjective	profundo m (feminine singular profunda, masculine plural profundos, feminine plural profundas, comparable)
retentor	Adjective	retentor m (feminine singular retentora, masculine plural retentores, feminine plural retentoras, comparable)
impune	Adjective	impune m, f (plural impunes, comparable)
brutal	Adjective	brutal m, f (plural brutais, comparable)
astral	Adjective	astral m, f (plural astrais, comparable)
dito	Adjective	dito m (feminine singular dita, masculine plural ditos, feminine plural ditas, comparable)
bianual	Adjective	bianual m, f (plural bianuais, not comparable)
aborrecido	Adjective	aborrecido m (feminine singular aborrecida, masculine plural aborrecidos, feminine plural aborrecidas, comparable)
pastoral	Adjective	pastoral m, f (plural pastorais, comparable)
diet	Adjective	diet (plural diet, comparable)
variável	Adjective	variável m, f (plural variáveis, comparable)
incrível	Adjective	incrível m, f (plural incríveis, comparable)
rasa	Adjective	rasa f sg
leal	Adjective	leal (plural leais, comparable)
cansativo	Adjective	cansativo m (feminine singular cansativa, masculine plural cansativos, feminine plural cansativas, comparable)
apaixonado	Adjective	apaixonado m (feminine singular apaixonada, masculine plural apaixonados, feminine plural apaixonadas, comparable)
