баскетбол	Noun	баскетбол • (basketbol)
интернет	Noun	интернет • (internet)
при́нтер	Noun	при́нтер • (prínter)
гол	Noun	гол • (gol) (plural голҳо)
кинематография	Noun	кинематография • (kinematografiya)
ҳамсоя	Noun	ҳамсоя • (hamsoya) (plural ҳамсоягон or ҳамсояҳо)
дуҷинсгаро	Noun	дуҷинсгаро • (dujinsgaro) (plural дуҷинсгароён)
сифат	Noun	сифат • (sifat) (plural сифатҳо or сифот)
калима	Noun	калима • (kalima) (plural калимаҳо)
тоҷик	Noun	тоҷик • (tojik) (plural тоҷикон)
дар	Noun	дар • (dar)
журналистика	Noun	журналистика • (žurnalistika)
нур	Noun	нур • (nur)
ватан	Noun	ватан • (vatan)
бародар	Noun	бародар • (barodar) (plural бародарон or бародарҳо)
рибофлавин	Noun	рибофлавин • (riboflavin)
дигарҷинсгаро	Noun	дигарҷинсгаро • (digarjinsgaro) (plural дигарҷинсгароён)
поезд	Noun	поезд • (poyezd)
гараж	Noun	гараж • (garaž)
вожа	Noun	вожа • (voža) (plural вожагон or вожаҳо)
дуд	Noun	дуд • (dud)
ангушт	Noun	ангушт • (angušt) (plural ангуштон)
парранда	Noun	парранда • (parranda) (plural паррандагон or паррандаҳо)
май	Noun	май • (may)
сир	Noun	сир • (sir)
нанотехнология	Noun	нанотехнология • (nanotexnologiya)
педагогика	Noun	педагогика • (pedagogika) f
бум	Noun	бум • (bum)
август	Noun	август • (avgust)
тут	Noun	тут • (tut)
луғат	Noun	луғат • (luġat) (plural луғатҳо)
кабел	Noun	кабел • (kabel)
хук	Noun	хук • (xuk)
дин	Noun	дин • (din) (plural динҳо)
спонсор	Noun	спонсор • (sponsor)
директор	Noun	директор • (direktor)
модар	Noun	модар • (modar) (plural модарон or модарҳо)
ҷазира	Noun	ҷазира • (jazira) (plural ҷазираҳо)
абстракт	Noun	абстракт • (abstrakt)
бадан	Noun	бадан • (badan)
алгоритм	Noun	алгоритм • (algoritm)
картошка	Noun	картошка • (kartoška)
хар	Noun	хар • (xar)
ҳамҷинсгаро	Noun	ҳамҷинсгаро • (hamjinsgaro) (plural ҳамҷинсгароён)
банан	Noun	банан • (banan)
самъ	Noun	самъ • (samʾ)
музей	Noun	музей • (muzey)
фурӯшанда	Noun	фурӯшанда • (furüšanda) (plural фурӯшандагон or фурӯшандаҳо)
тир	Noun	тир • (tir)
уқоб	Noun	уқоб • (uqob) (plural уқобон or уқобҳо)
