mart	Noun	mart (definite accusative marty, plural martlar)
ze	Noun	ze (definite accusative ?, plural ?)
altyn	Noun	altyn (definite accusative altyny, plural altynlar)
disket	Noun	disket (definite accusative ?, plural ?)
aprel	Noun	aprel (definite accusative apreli, plural apreller)
anna	Noun	anna (definite accusative annany, plural annalar)
paradoks	Noun	paradoks
penjire	Noun	penjire (definite accusative penjirepenjiräni, plural penjireler)
çempion	Noun	çempion (definite accusative çempiony, plural çempionlar)
hat	Noun	hat (definite accusative ?, plural ?)
žurnal	Noun	žurnal (definite accusative žurnaly, plural žurnallar)
otly	Noun	otly (definite accusative otlyny, plural otlylar)
paýtagt	Noun	paýtagt (definite accusative ?, plural ?)
bugdaý	Noun	bugdaý (definite accusative bugdaýy, plural)
buz	Noun	buz (definite accusative buzbuzu, plural buzlar)
metal	Noun	metal (definite accusative ?, plural ?)
ýüz	Noun	ýüz (definite accusative ýüzi, plural ýüzler)
köpek	Noun	köpek (definite accusative köpekköpegi, plural köpekler)
ýyl	Noun	ýyl (definite accusative ýyly, plural ýyllar)
dag	Noun	dag (definite accusative dagy, plural daglar)
göz	Noun	göz (definite accusative gözgözü, plural gözler)
gatyk	Noun	gatyk (definite accusative gatykgatygy, plural gatyklar)
köçe	Noun	köçe (definite accusative köçeni, plural köçeler)
böwürslen	Noun	böwürslen (definite accusative böwürsleni, plural böwürslenler)
ot	Noun	ot (definite accusative otu, plural otlar)
ot	Noun	ot (definite accusative otu, plural otlar)
gylyç	Noun	gylyç (definite accusative gylyçgylyjy, plural gylyçlar)
birlik	Noun	birlik (definite accusative birliki, plural birlikler)
fewral	Noun	fewral (definite accusative fewraly, plural fewrallar)
öý	Noun	öý (definite accusative öýi, plural öýler)
žurnalist	Noun	žurnalist (definite accusative žurnalisti, plural žurnalistler)
harp	Noun	harp (definite accusative harpy, plural harplar)
aý	Noun	aý (definite accusative aýy, plural aýlar)
ruçka	Noun	ruçka (definite accusative ruçkany, plural ruçkalar)
kartoşka	Noun	kartoşka (definite accusative kartoşkany, plural kartoşkalar)
çörek	Noun	çörek (definite accusative çörekçöregi, plural çörekçörekler)
žurnalistika	Noun	žurnalistika (definite accusative žurnalistikany, uncountable žurnalistika-)
we	Noun	we (definite accusative ?, plural ?)
akula	Noun	akula (definite accusative akulany, plural akulalar)
mebel	Noun	mebel (definite accusative mebeli, plural mebeller)
agaç	Noun	agaç (definite accusative agaçagajy, plural agaçagaçlar)
isim	Noun	isim (definite accusative isimi, plural isimler)
eşek	Noun	eşek (definite accusative eşekeşegi, plural eşekler)
öküz	Noun	öküz
bal	Noun	bal (definite accusative baly, plural ballar)
ördek	Noun	ördek (definite accusative ördekördegi, plural ördekler)
köşk	Noun	köşk (definite accusative ?, plural ?)
bit	Noun	bit (definite accusative bitbidi, plural bitbitler)
klawiatura	Noun	klawiatura (definite accusative ?, plural ?)
diş	Noun	diş (definite accusative dişi, plural dişler)
kaka	Noun	kaka (definite accusative kakany, plural kakalar)
mif	Noun	mif (definite accusative mifi, plural mifler)
muzeý	Noun	muzeý (definite accusative muzeýi, plural muzeýler)
aýak	Noun	aýak (definite accusative aýakaýagy, plural aýakaýaklar)
gar	Noun	gar (definite accusative ?, plural ?)
gan	Noun	gan (definite accusative gany, plural ganlar)
suw	Noun	suw (definite accusative suwy, plural suwlar)
pişik	Noun	pişik (definite accusative pişikpişigi, plural pişikler)
wertolýot	Noun	wertolýot (definite accusative wertolýoty, plural wertolýotlar)
iş	Noun	iş (definite accusative işi, plural işler)
at	Noun	at (definite accusative atady, plural atlar)
at	Noun	at (definite accusative atady, plural atlar)
aýy	Noun	aýy (definite accusative aýyny, plural aýylar)
aýy	Noun	aýy
çöl	Noun	çöl (definite accusative ?, plural ?)
dekabr	Noun	dekabr (definite accusative dekabry, plural dekabrlar)
agyz	Noun	agyz (definite accusative agyzagzy, plural agyzlar)
banan	Noun	banan (definite accusative banany, plural bananlar)
balyk	Noun	balyk (definite accusative balykbalagy, plural balyklar)
süňk	Noun	süňk (definite accusative süňki, plural süňkler)
fe	Noun	fe (definite accusative feni, plural feler)
манат	Noun	манат (manat)
şugundyr	Noun	şugundyr (definite accusative şugundyry, plural şugundyrlar)
piwo	Noun	piwo (definite accusative piwony, plural piwolar)
žonglýor	Noun	žonglýor (definite accusative žonglýory, plural žonglýorlar)
daş	Noun	daş (definite accusative daşy, plural daşlar)
je	Noun	je (definite accusative jeni, plural jeler)
гарпыз	Noun	гарпыз (transliteration needed)
köl	Noun	köl (definite accusative köli, plural köller)
gün	Noun	gün (definite accusative güngünü, plural günler)
etaž	Noun	etaž (definite accusative etažy, plural etažlar)
manat	Noun	manat (definite accusative manatmanady, plural manatmanatlar)
şalgam	Noun	şalgam (definite accusative şalgamy, plural şalgamlar)
garynja	Noun	garynja (definite accusative garynjany, plural garynjalar)
kitap	Noun	kitap (definite accusative kitapkitaby, plural kitaplar)
bulut	Noun	bulut (definite accusative bulutbuludu, plural bulutlar)
söz	Noun	söz (definite accusative sözi, plural sözler)
ýüzük	Noun	ýüzük (definite accusative ýüzükýüzügi, plural ýüzükler)
gamburger	Noun	gamburger (definite accusative gamburgeri, plural gamburgerler)
kükürt	Noun	kükürt (definite accusative kükürtü, plural)
sygyr	Noun	sygyr (definite accusative sygyrsygry, plural sygyrlar)
ge	Noun	ge (definite accusative geni, plural geler)
gul	Noun	gul (definite accusative guly, plural gullar)
habar	Noun	habar (definite accusative ?, plural ?)
ajy	Noun	ajy (definite accusative ajyny, plural ajylar)
gül	Noun	gül (definite accusative gülgülü, plural)
kit	Noun	kit (definite accusative kitkidi, plural kitler)
ýyldyz	Noun	ýyldyz (definite accusative ýyldyzy, plural ýyldyzlar)
yel	Noun	yel
ýürek	Noun	ýürek (definite accusative ýürekýüregi, plural ýürekler)
baş	Noun	baş (definite accusative başy, plural başlar)
baş	Noun	baş (definite accusative başy, plural başlar)
käşir	Noun	käşir (definite accusative käşiri, plural käşirler)
pagta	Noun	pagta (definite accusative pagtany, plural pagtalar)
burun	Noun	burun (definite accusative burunburunu, plural burunlar)
bag	Noun	bag (definite accusative bagy, plural baglar)
akademiýa	Noun	akademiýa (definite accusative akademiýany, plural akademiýalar)
furgon	Noun	furgon (definite accusative furgonfurgonu, plural furgonfurgonlar)
günä	Noun	günä (definite accusative günäni, plural günäler)
kanun	Noun	kanun (definite accusative kanuny, plural kanunlar)
fabrik	Noun	fabrik (definite accusative fabrigi, plural fabrikler)
ýara	Noun	ýara (definite accusative ýarany, plural ýaralar)
kümüş	Noun	kümüş (definite accusative kümüşkümşü, plural kümüşler)
gulak	Noun	gulak (definite accusative gulakgulagy, plural gulaklar)
žandarm	Noun	žandarm (definite accusative žandarmy, plural žandarmlar)
te	Noun	te (definite accusative ?, plural ?)
korol	Noun	korol (definite accusative koroly, plural korollar)
ÿüz	Noun	ÿüz (definite accusative ÿüzi, plural ÿüzler)
duşman	Noun	duşman (definite accusative duşmany, plural duşmanlar)
pissa	Noun	pissa (definite accusative pissany, plural pissalar)
gije	Noun	gije (definite accusative gijeni, plural gijeler)
nokat	Noun	nokat (definite accusative ?, plural ?)
it	Noun	it (definite accusative itidi, plural itler)
ýazyjy	Noun	ýazyjy (definite accusative ýazyjyny, plural ýazyjylar)
pe	Noun	pe (definite accusative ?, plural ?)
barmak	Noun	barmak (definite accusative barmakbarmagy, plural barmaklar)
gyz	Noun	gyz (definite accusative gyzy, plural gyzlar)
kitaphana	Noun	kitaphana (definite accusative kitaphanany, plural kitaphanalar)
vagt	Noun	vagt (definite accusative ?, plural ?)
