غائب	Adjective	غائب • (ġā'yab) or ġā'ib) — Hindi spelling: ग़ायब (ġāyab)
تولد	Adjective	تولد • (tavallud) 
نر	Adjective	نر • (nar) m — Hindi spelling: नर (nar)
سماق	Adjective	سماق • (sumāq) 
زرد	Adjective	زرد • (zard) — Hindi spelling: ज़र्द (zard)
عام	Adjective	عام • ('āmm) — Hindi spelling: आम्म (āmma)
مضبوط	Adjective	مضبوط • (mazbūt) m — Hindi spelling: मज़बूत (mazbūt)
بھورا	Adjective	بھورا • (bhūrā) — Hindi spelling: भूरा (bhūrā)
عشقیہ	Adjective	عشقیہ • (ishqiyā) 
مخصوص	Adjective	مخصوص • (transliteration needed) 
شريف	Adjective	شريف • (śarīf) — Hindi spelling: शरीफ़ (śarīf)
دور	Adjective	دور • (dūr) — Hindi spelling: दूर (dūr)
پہلا	Adjective	پہلا • (pehlā) — Hindi spelling: पहला (pahlā)
سر	Adjective	سر • (sar) — Hindi spelling: सर (sar)
سابق	Adjective	سابق • (sābiq) m — Hindi spelling: साबिक़ (sābiq)
اکیلا	Adjective	اکیلا • (akelā) m — Hindi spelling: अकेला (akelā)
سرخ	Adjective	سرخ • (surx) — Hindi spelling: सुर्ख़ (surx)
عالم	Adjective	عالم • ('ālim) — Hindi spelling: आलिम (ālim)
حرم	Adjective	حرم • (ħaram) 
اندھیرا	Adjective	اندھیرا • (andherā) m — Hindi spelling: अन्धेरा (andherā)
دین	Adjective	دین • (dīn) — Hindi spelling: दीन (dīn)
دین	Adjective	دین • (dain) — Hindi spelling: दैन (dain)
نیا	Adjective	نیا • (nayā) m — Hindi spelling: नया (nayā)
ذرا	Adjective	ذرا • (zarā) — Hindi spelling: ज़रा (zarā)
بد	Adjective	بد • (bad) — Hindi spelling: बद (bad)
ناظر	Adjective	ناظر • (nāzir) 
بڑا	Adjective	بڑا • (baṛā) m — Hindi spelling: बड़ा (baṛā)
فحش	Adjective	فحش • (fuħš) 
جوان	Adjective	جوان • (javān or juvān) — Hindi spelling: जवान (javān)
ننگا	Adjective	ننگا • (nãṅgā) m — Hindi spelling: नंगा (naṅgā)
آوارہ	Adjective	آوارہ • (āvārā) — Hindi spelling: आवारा (āvārā)
اگلا	Adjective	اگلا • (aglā) m — Hindi spelling: अगला (aglā)
اتنا	Adjective	اتنا • (itnā) 
اتنا	Adjective	اتنا • (utnā) — Hindi spelling: उतना (utnā)
شریر	Adjective	شریر • (šarīr) 
ختم	Adjective	ختم • (xatm) — Hindi spelling: ख़त्म (xatma)
غلط	Adjective	غلط • (ġalat) — Hindi spelling: ग़लत (ġalat)
مہنگا	Adjective	مہنگا • (mahãṅgā) m — Hindi spelling: महँगा (mahãgā)
کھڑا	Adjective	کھڑا • (khaṛā) m — Hindi spelling: खड़ा (khaṛā)
سستا	Adjective	سستا • (sastā) m 
مردن	Adjective	مردن • (mardan) — Hindi spelling: मर्दन (mardan)
گیلا	Adjective	گیلا • (gīlā) m — Hindi spelling: गीला (gīlā)
اچھا	Adjective	اچھا • (acchā) m — Hindi spelling: अच्छा (acchā)
کور	Adjective	کور • (kor, kūr) — Hindi spelling: कोर (kor), कूर (kūr)
کور	Adjective	کور • (kūr) — Hindi spelling: कूर (kūr)
خوش	Adjective	خوش • (xuš) — Hindi spelling: ख़ुश (xuś)
حافظ	Adjective	حافظ • (hāfiz) — Hindi spelling: ह़ाफ़िज़ (ह़āfiz)
پرمکھ	Adjective	پرمکھ • (pramukh) m — Hindi spelling: प्रमुख (pramukh)
ثابت	Adjective	ثابت • (sābit) — Hindi spelling: साबित (sābit)
اسم	Adjective	اسم • (asam) — Hindi spelling: असम (asam)
بزرگ	Adjective	بزرگ • (buzurg) — Hindi spelling: बुज़ुर्ग (buzurg)
آباد	Adjective	آباد • (ābād) — Hindi spelling: आबाद (ābād)
خاصّ	Adjective	خاصّ • (xāṣṣ) — Hindi spelling: ख़ास (xās)
کالا	Adjective	کالا • (kālā) m — Hindi spelling: काला (kālā)
غریب	Adjective	غریب • (ġarīb) — Hindi spelling: ग़रीब (ġarīb)
دوار	Adjective	دوار • (davvār) — Hindi spelling: दव्वार (davvār)
لمبا	Adjective	لمبا • (lambā) m — Hindi spelling: लम्बा (lambā), लंबा (lambā)
