vö	Noun	vö
tomu	Noun	tomu
vero	Noun	vero
küdu	Noun	küdu
rega	Noun	rega
udištada	Noun	udištada
tähtaztedomez'	Noun	tähtaztedomez'
sorm	Noun	sorm
sal'm	Noun	sal'm
sulaku	Noun	sulaku
imperativ	Noun	imperativ
kodi	Noun	kodi
jumal	Noun	jumal
hol'	Noun	hol'
küzu	Noun	küzu
rida	Noun	rida
jagai	Noun	jagai
uništai	Noun	uništai
nem'	Noun	nem'
südäivezi	Noun	südäivezi
läžui	Noun	läžui
zel'l'antedomez'	Noun	zel'l'antedomez'
vel'l'	Noun	vel'l'
sija	Noun	sija
puzu	Noun	puzu
suvi	Noun	suvi
pedai	Noun	pedai
riža	Noun	riža
puno	Noun	puno
kund	Noun	kund
huiged	Noun	huiged
tühj	Noun	tühj
tonna	Noun	tonna
il'm	Noun	il'm
čuru	Noun	čuru
pormoi	Noun	pormoi
kävui	Noun	kävui
sägu	Noun	sägu
laba	Noun	laba
pölü	Noun	pölü
meri	Noun	meri
fortepiano	Noun	fortepiano
semendku	Noun	semendku
sol'	Noun	sol'
murendai	Noun	murendai
kudo	Noun	kudo
viri	Noun	viri
voz'	Noun	voz'
veza	Noun	veza
toi	Noun	toi
mecoi	Noun	mecoi
vestai	Noun	vestai
rusked	Noun	rusked
lumi	Noun	lumi
kändai	Noun	kändai
viha	Noun	viha
pel'	Noun	pel'
oiktuz'	Noun	oiktuz'
tera	Noun	tera
magu	Noun	magu
hama	Noun	hama
näl'g	Noun	näl'g
kino	Noun	kino
söi	Noun	söi
loim	Noun	loim
londuz	Noun	londuz
avokado	Noun	avokado
ura	Noun	ura
tütär	Noun	tütär
tora	Noun	tora
lendai	Noun	lendai
tädi	Noun	tädi
komitativ	Noun	komitativ
päiväine	Noun	päiväine
kubu	Noun	kubu
sel'g	Noun	sel'g
kodirand	Noun	kodirand
manzikaine	Noun	manzikaine
ero	Noun	ero
eloku	Noun	eloku
veneh	Noun	veneh
liha	Noun	liha
hihtäi	Noun	hihtäi
mezi	Noun	mezi
voi	Noun	voi
vihand	Noun	vihand
pohj	Noun	pohj
poig	Noun	poig
egzamen	Noun	egzamen
harj	Noun	harj
kera	Noun	kera
inessiv	Noun	inessiv
keza	Noun	keza
kobu	Noun	kobu
soudai	Noun	soudai
soja	Noun	soja
sen'	Noun	sen'
pullo	Noun	pullo
valičii	Noun	valičii
vilu	Noun	vilu
keng'	Noun	keng'
numeral'	Noun	numeral'
kaivai	Noun	kaivai
kagl	Noun	kagl
so	Noun	so
ühthevedo	Noun	ühthevedo
külä	Noun	külä
katuz	Noun	katuz
laho	Noun	laho
oja	Noun	oja
kudmaine	Noun	kudmaine
paja	Noun	paja
roza	Noun	roza
pal'l'	Noun	pal'l'
pal'l'	Noun	pal'l'
sügüz'	Noun	sügüz'
taba	Noun	taba
labid	Noun	labid
kala	Noun	kala
pü	Noun	pü
translativ	Noun	translativ
povi	Noun	povi
kidžu	Noun	kidžu
häčöi	Noun	häčöi
lagi	Noun	lagi
konsonant	Noun	konsonant
mašin	Noun	mašin
razv	Noun	razv
kadag	Noun	kadag
jäniš	Noun	jäniš
kida	Noun	kida
puga	Noun	puga
teta	Noun	teta
tüvi	Noun	tüvi
moduz	Noun	moduz
kel'	Noun	kel'
proza	Noun	proza
häda	Noun	häda
pajo	Noun	pajo
sistem	Noun	sistem
kormadai	Noun	kormadai
abessiv	Noun	abessiv
kaiv	Noun	kaiv
šuhaidai	Noun	šuhaidai
tavu	Noun	tavu
lind	Noun	lind
muna	Noun	muna
randišt	Noun	randišt
änestai	Noun	änestai
keradai	Noun	keradai
vezi	Noun	vezi
kazvišttedomez'	Noun	kazvišttedomez'
säru	Noun	säru
radio	Noun	radio
kondi	Noun	kondi
sötai	Noun	sötai
ezitai	Noun	ezitai
kazvatuztedo	Noun	kazvatuztedo
sima	Noun	sima
püdai	Noun	püdai
koir	Noun	koir
sidelii	Noun	sidelii
akkuzativ	Noun	akkuzativ
jago	Noun	jago
habuk	Noun	habuk
ribu	Noun	ribu
kogodai	Noun	kogodai
hel'm	Noun	hel'm
pöudtedo	Noun	pöudtedo
meren emä	Noun	meren emä
pauk	Noun	pauk
mado	Noun	mado
rivi	Noun	rivi
lemboi	Noun	lemboi
kaži	Noun	kaži
igin	Noun	igin
lämoi	Noun	lämoi
čibu	Noun	čibu
mantedo	Noun	mantedo
leib	Noun	leib
hala	Noun	hala
kagr	Noun	kagr
näd	Noun	näd
tullei	Noun	tullei
üläh	Noun	üläh
kesk	Noun	kesk
londuztedo	Noun	londuztedo
kunigaz	Noun	kunigaz
regi	Noun	regi
kirj	Noun	kirj
čuhu	Noun	čuhu
ap	Noun	ap
pudr	Noun	pudr
pudr	Noun	pudr
adjektiv	Noun	adjektiv
abu	Noun	abu
alang	Noun	alang
korv	Noun	korv
viluku	Noun	viluku
adessiv	Noun	adessiv
päskhaine	Noun	päskhaine
sätedotuz	Noun	sätedotuz
hago	Noun	hago
maid	Noun	maid
painai	Noun	painai
pronomin	Noun	pronomin
haju	Noun	haju
muda	Noun	muda
prolativ	Noun	prolativ
uks'	Noun	uks'
härg	Noun	härg
jaug	Noun	jaug
hambaz	Noun	hambaz
koumanz'päiv	Noun	koumanz'päiv
nogi	Noun	nogi
udištai	Noun	udištai
käre	Noun	käre
vokal'	Noun	vokal'
tävu	Noun	tävu
nägo	Noun	nägo
hüde	Noun	hüde
tort	Noun	tort
hebo	Noun	hebo
judu	Noun	judu
pi	Noun	pi
živattedomez'	Noun	živattedomez'
pöud	Noun	pöud
sagud	Noun	sagud
edenoi	Noun	edenoi
ekzamen	Noun	ekzamen
higo	Noun	higo
bur	Noun	bur
su	Noun	su
openduzvoz'	Noun	openduzvoz'
sep	Noun	sep
partitiv	Noun	partitiv
hein	Noun	hein
rogo	Noun	rogo
sana	Noun	sana
kužu	Noun	kužu
verai	Noun	verai
mez'	Noun	mez'
elo	Noun	elo
uhoku	Noun	uhoku
ragiž	Noun	ragiž
kurg	Noun	kurg
vaza	Noun	vaza
tuli	Noun	tuli
kinktuz'	Noun	kinktuz'
vezipolo	Noun	vezipolo
evro	Noun	evro
babu	Noun	babu
živat	Noun	živat
il'bez	Noun	il'bez
hahmoi	Noun	hahmoi
foto	Noun	foto
approksimativ	Noun	approksimativ
Biblii	Noun	Biblii
läm'	Noun	läm'
soba	Noun	soba
sauvoi	Noun	sauvoi
sideg	Noun	sideg
matk	Noun	matk
nero	Noun	nero
savu	Noun	savu
uk	Noun	uk
lohi	Noun	lohi
heinku	Noun	heinku
jügu	Noun	jügu
eläi	Noun	eläi
tagarai	Noun	tagarai
moda	Noun	moda
nimi	Noun	nimi
vald	Noun	vald
gardalei	Noun	gardalei
čikoi	Noun	čikoi
egressiv	Noun	egressiv
taivaz	Noun	taivaz
trio	Noun	trio
naine	Noun	naine
järv	Noun	järv
vask	Noun	vask
kibu	Noun	kibu
sä	Noun	sä
čoga	Noun	čoga
koza	Noun	koza
lev	Noun	lev
himo	Noun	himo
kulo	Noun	kulo
lidn	Noun	lidn
endištai	Noun	endištai
pu	Noun	pu
röstai	Noun	röstai
soda	Noun	soda
ö	Noun	ö
pago	Noun	pago
aig	Noun	aig
sil'm	Noun	sil'm
kaste	Noun	kaste
ruzu	Noun	ruzu
vižu	Noun	vižu
naba	Noun	naba
grammatik	Noun	grammatik
kingituzsideg	Noun	kingituzsideg
aditiv	Noun	aditiv
idu	Noun	idu
benzintäutim	Noun	benzintäutim
päivkodi	Noun	päivkodi
kingituz	Noun	kingituz
muhu	Noun	muhu
änik	Noun	änik
rand	Noun	rand
veič	Noun	veič
dedoi	Noun	dedoi
munarič	Noun	munarič
käzi	Noun	käzi
illativ	Noun	illativ
orav	Noun	orav
mec	Noun	mec
homen	Noun	homen
katkaidai	Noun	katkaidai
veri	Noun	veri
pirg	Noun	pirg
pidäi	Noun	pidäi
kü	Noun	kü
starinoičii	Noun	starinoičii
kogo	Noun	kogo
polo	Noun	polo
azj	Noun	azj
joudai	Noun	joudai
tugi	Noun	tugi
nevoi	Noun	nevoi
igä	Noun	igä
rova	Noun	rova
adverb	Noun	adverb
tozi	Noun	tozi
hahk	Noun	hahk
drama	Noun	drama
koiverdelii	Noun	koiverdelii
lodu	Noun	lodu
kacui	Noun	kacui
rai	Noun	rai
mela	Noun	mela
assamblei	Noun	assamblei
keitäi	Noun	keitäi
mecantedo	Noun	mecantedo
kazvatuz	Noun	kazvatuz
sorz	Noun	sorz
än'kulund	Noun	än'kulund
essiv-instruktiv	Noun	essiv-instruktiv
lugu	Noun	lugu
muru	Noun	muru
mel'	Noun	mel'
hir'	Noun	hir'
muju	Noun	muju
bukoi	Noun	bukoi
pimed	Noun	pimed
kondicional	Noun	kondicional
semendai	Noun	semendai
künz'	Noun	künz'
pövu	Noun	pövu
maks	Noun	maks
maks	Noun	maks
sügüz'ku	Noun	sügüz'ku
nägu	Noun	nägu
koda	Noun	koda
sai	Noun	sai
tedr	Noun	tedr
kuzi	Noun	kuzi
tom'	Noun	tom'
majak	Noun	majak
kulund	Noun	kulund
bibu	Noun	bibu
živattedo	Noun	živattedo
hobed	Noun	hobed
täutim	Noun	täutim
hibjantedo	Noun	hibjantedo
sebr	Noun	sebr
keväz'ku	Noun	keväz'ku
taza	Noun	taza
semen	Noun	semen
suga	Noun	suga
pol'	Noun	pol'
sugu	Noun	sugu
kel'tedo	Noun	kel'tedo
kivi	Noun	kivi
genitiv	Noun	genitiv
mantedomez'	Noun	mantedomez'
kandai	Noun	kandai
makondi	Noun	makondi
uru	Noun	uru
elativ	Noun	elativ
kuro	Noun	kuro
vei	Noun	vei
leht	Noun	leht
kodžu	Noun	kodžu
särg	Noun	särg
mezikämen	Noun	mezikämen
substantiv	Noun	substantiv
lem'	Noun	lem'
tedo	Noun	tedo
säntedo	Noun	säntedo
vauged	Noun	vauged
sar'	Noun	sar'
eht	Noun	eht
piduz'	Noun	piduz'
oigendai	Noun	oigendai
allativ	Noun	allativ
kodima	Noun	kodima
terminativ	Noun	terminativ
sofa	Noun	sofa
oza	Noun	oza
taksi	Noun	taksi
ma	Noun	ma
pühäpäiv	Noun	pühäpäiv
kudoi	Noun	kudoi
lu	Noun	lu
kuz'	Noun	kuz'
pühänik	Noun	pühänik
kego	Noun	kego
sobat	Noun	sobat
kezaku	Noun	kezaku
piano	Noun	piano
ohjandai	Noun	ohjandai
čapai	Noun	čapai
priha	Noun	priha
kana	Noun	kana
ujui	Noun	ujui
videnz'päiv	Noun	videnz'päiv
video	Noun	video
viza	Noun	viza
büro	Noun	büro
žüri	Noun	žüri
šohu	Noun	šohu
verb	Noun	verb
muzei	Noun	muzei
ol'g	Noun	ol'g
tedotuz	Noun	tedotuz
reduku	Noun	reduku
tego	Noun	tego
tö	Noun	tö
än'	Noun	än'
kazvišt	Noun	kazvišt
käbu	Noun	käbu
vara	Noun	vara
lezi	Noun	lezi
kuha	Noun	kuha
hapanmaid	Noun	hapanmaid
sü	Noun	sü
zel'l'antedo	Noun	zel'l'antedo
kilo	Noun	kilo
mir	Noun	mir
reboi	Noun	reboi
nellänz'päiv	Noun	nellänz'päiv
edahuz'	Noun	edahuz'
ruga	Noun	ruga
oc	Noun	oc
lebu	Noun	lebu
händikaz	Noun	händikaz
valdkund	Noun	valdkund
siga	Noun	siga
aid	Noun	aid
oranž	Noun	oranž
südäin	Noun	südäin
puru	Noun	puru
ku	Noun	ku
raud	Noun	raud
gad	Noun	gad
todištai	Noun	todištai
haug'	Noun	haug'
lodo	Noun	lodo
jä	Noun	jä
ablativ	Noun	ablativ
möi	Noun	möi
seba	Noun	seba
abai	Noun	abai
täi	Noun	täi
terv	Noun	terv
vihm	Noun	vihm
olut	Noun	olut
pakuine	Noun	pakuine
pada	Noun	pada
nado	Noun	nado
opendai	Noun	opendai
noid	Noun	noid
raha	Noun	raha
hil'	Noun	hil'
gor'a	Noun	gor'a
kalu	Noun	kalu
pol'v	Noun	pol'v
oks	Noun	oks
baboi	Noun	baboi
čai	Noun	čai
pätnič	Noun	pätnič
jauh	Noun	jauh
lambaz	Noun	lambaz
nena	Noun	nena
jubilei	Noun	jubilei
uho	Noun	uho
tramvai	Noun	tramvai
tat	Noun	tat
jänoi	Noun	jänoi
potencial	Noun	potencial
kel'tedomez'	Noun	kel'tedomez'
turu	Noun	turu
varu	Noun	varu
laineh	Noun	laineh
tedomašin	Noun	tedomašin
meladai	Noun	meladai
lampankatuz	Noun	lampankatuz
jur'	Noun	jur'
lüpsai	Noun	lüpsai
tähtaztedo	Noun	tähtaztedo
arboi	Noun	arboi
vävu	Noun	vävu
ezmärg	Noun	ezmärg
tundui	Noun	tundui
astui	Noun	astui
tedotuzlaud	Noun	tedotuzlaud
jono	Noun	jono
löug	Noun	löug
sinine	Noun	sinine
ilo	Noun	ilo
valatai	Noun	valatai
mamoi	Noun	mamoi
keväz'	Noun	keväz'
hibj	Noun	hibj
ad	Noun	ad
tožnarg	Noun	tožnarg
mail'm	Noun	mail'm
kuvadai	Noun	kuvadai
pino	Noun	pino
nižu	Noun	nižu
ak	Noun	ak
vin	Noun	vin
viga	Noun	viga
buraidai	Noun	buraidai
lesk	Noun	lesk
päiv	Noun	päiv
pätai	Noun	pätai
kirvez	Noun	kirvez
sätkulund	Noun	sätkulund
laud	Noun	laud
tuho	Noun	tuho
tal'vku	Noun	tal'vku
päč	Noun	päč
känd	Noun	känd
vedäi	Noun	vedäi
kägi	Noun	kägi
vägi	Noun	vägi
kazvišttedo	Noun	kazvišttedo
vaha	Noun	vaha
te	Noun	te
ot	Noun	ot
tedotai	Noun	tedotai
nagriž	Noun	nagriž
tähk	Noun	tähk
sizar	Noun	sizar
must	Noun	must
laps'	Noun	laps'
sega	Noun	sega
sara	Noun	sara
südu	Noun	südu
pilu	Noun	pilu
rozme	Noun	rozme
purde	Noun	purde
long'	Noun	long'
lehm	Noun	lehm
kofe	Noun	kofe
kündal'	Noun	kündal'
vepsläine	Noun	vepsläine
pökoi	Noun	pökoi
pala	Noun	pala
händ	Noun	händ
zel'l'	Noun	zel'l'
kuva	Noun	kuva
kenguru	Noun	kenguru
arv	Noun	arv
tervhuz'tedo	Noun	tervhuz'tedo
uhu	Noun	uhu
vago	Noun	vago
openduz	Noun	openduz
nova	Noun	nova
raba	Noun	raba
son'	Noun	son'
openik	Noun	openik
čura	Noun	čura
runo	Noun	runo
pä	Noun	pä
savi	Noun	savi
pil'v	Noun	pil'v
üläopenik	Noun	üläopenik
pido	Noun	pido
popugai	Noun	popugai
lava	Noun	lava
valdmeri	Noun	valdmeri
pöudtedomez'	Noun	pöudtedomez'
säzi	Noun	säzi
samvar	Noun	samvar
kroikoi	Noun	kroikoi
kirjamišt	Noun	kirjamišt
redu	Noun	redu
kündai	Noun	kündai
uni	Noun	uni
rubl'	Noun	rubl'
tedotand	Noun	tedotand
hab	Noun	hab
ülüz	Noun	ülüz
čud	Noun	čud
lamp	Noun	lamp
kezi	Noun	kezi
kalaidai	Noun	kalaidai
naitai	Noun	naitai
rama	Noun	rama
koiv	Noun	koiv
kor'	Noun	kor'
diftong	Noun	diftong
korktuz'	Noun	korktuz'
oiktuz'tedo	Noun	oiktuz'tedo
rubi	Noun	rubi
sädai	Noun	sädai
drocei	Noun	drocei
satai	Noun	satai
ostai	Noun	ostai
metro	Noun	metro
sündui	Noun	sündui
happu	Noun	happu
negativ	Noun	negativ
mägi	Noun	mägi
heng	Noun	heng
kara	Noun	kara
tela	Noun	tela
jogi	Noun	jogi
laht	Noun	laht
jablok	Noun	jablok
tal'v	Noun	tal'v
avtomašin	Noun	avtomašin
rikoi	Noun	rikoi
avto	Noun	avto
faza	Noun	faza
hirb'	Noun	hirb'
rahnoi	Noun	rahnoi
vändai	Noun	vändai
nominativ	Noun	nominativ
kukoi	Noun	kukoi
ahven	Noun	ahven
hibuz	Noun	hibuz
peza	Noun	peza
omištai	Noun	omištai
tervhuz'	Noun	tervhuz'
pera	Noun	pera
kosk	Noun	kosk
benzin	Noun	benzin
nima	Noun	nima
lehtez	Noun	lehtez
liža	Noun	liža
tähtaz	Noun	tähtaz
kül'mku	Noun	kül'mku
tedotelend	Noun	tedotelend
rigo	Noun	rigo
indikativ	Noun	indikativ
mod	Noun	mod
taho	Noun	taho
