izo	Adjective	izo
jagamatoi	Adjective	jagamatoi
harv	Adjective	harv
armahtamatoi	Adjective	armahtamatoi
ripmatoi	Adjective	ripmatoi
sur'	Adjective	sur'
pidämatoi	Adjective	pidämatoi
kolmatoi	Adjective	kolmatoi
rohtmatoi	Adjective	rohtmatoi
pit'k	Adjective	pit'k (comparative pidemb, superlative kaikiš pidemb, equative pitte)
jalo	Adjective	jalo
tärged	Adjective	tärged
čoma	Adjective	čoma (comparative čomemb, superlative kaikiš čomemb, equative čomutte)
endustamatoi	Adjective	endustamatoi
personaline	Adjective	personaline
homaičematoi	Adjective	homaičematoi
huiged	Adjective	huiged
tühj	Adjective	tühj
jädumatoi	Adjective	jädumatoi
pühä	Adjective	pühä
oiged	Adjective	oiged
väzumatoi	Adjective	väzumatoi
uskmatoi	Adjective	uskmatoi
randaline	Adjective	randaline
rusked	Adjective	rusked
laskmatoi	Adjective	laskmatoi
sula	Adjective	sula
paks	Adjective	paks
saged	Adjective	saged
uz'	Adjective	uz'
pal'l'az	Adjective	pal'l'az
tervehtumatoi	Adjective	tervehtumatoi
vihand	Adjective	vihand
ehtmatoi	Adjective	ehtmatoi
sistematoi	Adjective	sistematoi
sanged	Adjective	sanged (equative sankte)
kundlematoi	Adjective	kundlematoi
vilu	Adjective	vilu
lugematoi	Adjective	lugematoi
kištai	Adjective	kištai
vahv	Adjective	vahv
tedotoi	Adjective	tedotoi
kudmaine	Adjective	kudmaine
odav	Adjective	odav
sabustamatoi	Adjective	sabustamatoi
mahtmatoi	Adjective	mahtmatoi
paha	Adjective	paha
täuz'	Adjective	täuz'
sidomatoi	Adjective	sidomatoi
varastamatoi	Adjective	varastamatoi
küzumatoi	Adjective	küzumatoi
tahtoimatoi	Adjective	tahtoimatoi
kazvišttedoline	Adjective	kazvišttedoline
hen	Adjective	hen
tedoline	Adjective	tedoline
toštmatoi	Adjective	toštmatoi
sel'genzoitmatoi	Adjective	sel'genzoitmatoi
tetab	Adjective	tetab
indefinitine	Adjective	indefinitine
küps	Adjective	küps
negativine	Adjective	negativine
iznesimatoi	Adjective	iznesimatoi
kirjav	Adjective	kirjav
parahim	Adjective	parahim
pördutamatoi	Adjective	pördutamatoi
vastustamatoi	Adjective	vastustamatoi
kändlematoi	Adjective	kändlematoi
ruza	Adjective	ruza
lopmatoi	Adjective	lopmatoi
kül'dümatoi	Adjective	kül'dümatoi
käskmatoi	Adjective	käskmatoi
ridelmatoi	Adjective	ridelmatoi
korged	Adjective	korged (equative kortte)
holimatoi	Adjective	holimatoi
märičematoi	Adjective	märičematoi
arvostamatoi	Adjective	arvostamatoi
tehmatoi	Adjective	tehmatoi
elämatoi	Adjective	elämatoi
meletamatoi	Adjective	meletamatoi
vanh	Adjective	vanh
bur	Adjective	bur
kova	Adjective	kova
kanged	Adjective	kanged
maksmatoi	Adjective	maksmatoi
kadotamatoi	Adjective	kadotamatoi
azotamatoi	Adjective	azotamatoi
läm'	Adjective	läm'
muza	Adjective	muza
koumanz'	Adjective	koumanz'
žalleičematoi	Adjective	žalleičematoi
kulu	Adjective	kulu
kebn	Adjective	kebn
ustavzoitmatoi	Adjective	ustavzoitmatoi
armaz	Adjective	armaz
tähtaztedoline	Adjective	tähtaztedoline
holetoi	Adjective	holetoi
roho	Adjective	roho
kahesanz'	Adjective	kahesanz'
kuhmoi	Adjective	kuhmoi
täutmatoi	Adjective	täutmatoi
tedištamatoi	Adjective	tedištamatoi
tün'	Adjective	tün'
randatoi	Adjective	randatoi
refleksivine	Adjective	refleksivine
kitmatoi	Adjective	kitmatoi
pitte	Adjective	pitte
el'gendamatoi	Adjective	el'gendamatoi
joudai	Adjective	joudai
pidemb	Adjective	pidemb
nügu	Adjective	nügu
sel'ged	Adjective	sel'ged
jüged	Adjective	jüged
hahk	Adjective	hahk
toine	Adjective	toine
huiktelmatoi	Adjective	huiktelmatoi
kacmatoi	Adjective	kacmatoi
kül'm	Adjective	kül'm
nor'	Adjective	nor'
tazo	Adjective	tazo
pimed	Adjective	pimed
nägumatoi	Adjective	nägumatoi
mured	Adjective	mured
pehmed	Adjective	pehmed
relativine	Adjective	relativine
luja	Adjective	luja
hobed	Adjective	hobed
meletoi	Adjective	meletoi
kinged	Adjective	kinged
naimatoi	Adjective	naimatoi
ruma	Adjective	ruma
opendamatoi	Adjective	opendamatoi
väl'l'	Adjective	väl'l'
vauged	Adjective	vauged
rän'	Adjective	rän'
sättumatoi	Adjective	sättumatoi
ezmäine	Adjective	ezmäine
pakičematoi	Adjective	pakičematoi
nähmatoi	Adjective	nähmatoi
soged	Adjective	soged
kudmatoi	Adjective	kudmatoi
kalliž	Adjective	kalliž
edahaine	Adjective	edahaine
interrogativine	Adjective	interrogativine
terveh	Adjective	terveh
tutab	Adjective	tutab
oranž	Adjective	oranž
hil'l'	Adjective	hil'l'
karged	Adjective	karged
pakuine	Adjective	pakuine
ülev	Adjective	ülev
nüga	Adjective	nüga
lühüd	Adjective	lühüd
huba	Adjective	huba
demonstrativine	Adjective	demonstrativine
tirpmatoi	Adjective	tirpmatoi
paremb	Adjective	paremb
södab	Adjective	södab
palab	Adjective	palab
hüvä	Adjective	hüvä (comparative paremb, superlative parahim)
maho	Adjective	maho
kauged	Adjective	kauged
maged	Adjective	maged
eläb	Adjective	eläb
sinine	Adjective	sinine
muiged	Adjective	muiged
unohtamatoi	Adjective	unohtamatoi
videnz'	Adjective	videnz'
hoik	Adjective	hoik
varaidamatoi	Adjective	varaidamatoi
nellänz'	Adjective	nellänz'
augotamatoi	Adjective	augotamatoi
erigoitmatoi	Adjective	erigoitmatoi
kožumatoi	Adjective	kožumatoi
koskmatoi	Adjective	koskmatoi
pen'	Adjective	pen'
vezo	Adjective	vezo
must	Adjective	must
sanumatoi	Adjective	sanumatoi
vepsläine	Adjective	vepsläine
päzumatoi	Adjective	päzumatoi
süvä	Adjective	süvä
hura	Adjective	hura
heitmatoi	Adjective	heitmatoi
seižutamatoi	Adjective	seižutamatoi
hamatoi	Adjective	hamatoi
kuštai	Adjective	kuštai
kaid	Adjective	kaid
vajehtamatoi	Adjective	vajehtamatoi
todištamatoi	Adjective	todištamatoi
tundmatoi	Adjective	tundmatoi
vär	Adjective	vär
kucmatoi	Adjective	kucmatoi
