kanta	Noun	kanta (genitive kannaa, partitive [please provide])
nõita	Noun	nõita (genitive nõďďaa, partitive [please provide])
põlto	Noun	põlto (genitive põlloo, partitive [please provide])
veeri	Noun	veeri (genitive veeree, partitive [please provide])
pöörä	Noun	pöörä (genitive pöörää, partitive [please provide])
aźźa	Noun	aźźa (genitive aźźaa, partitive [please provide])
kattila	Noun	kattila (genitive kattilaa, partitive [please provide])
töö	Noun	töö (genitive töö, partitive tööt)
laukopäivä	Noun	laukopäivä (genitive laukopäivää, partitive [please provide])
lupa	Noun	lupa (genitive luvaa, partitive lupaa)
õźźa	Noun	õźźa (genitive õźźaa, partitive õźźaa)
dohtari	Noun	dohtari (genitive dohtarii, partitive [please provide])
velli	Noun	velli (genitive vellee, partitive velleä)
karu	Noun	karu (genitive karuu, partitive karua)
põhja	Noun	põhja (genitive põhjaa, partitive [please provide])
kusi	Noun	kusi (genitive kuõõ, partitive [please provide])
ahvõn	Noun	ahvõn (genitive ahvõnaa or ahvõnõõ, partitive [please provide])
nältšä	Noun	nältšä (genitive nällää, partitive [please provide])
särtši	Noun	särtši (genitive särjee, partitive [please provide])
koira	Noun	koira (genitive koiraa, partitive koiraa)
tõrva	Noun	tõrva (genitive tõrvaa, partitive [please provide])
neemi	Noun	neemi (genitive neemee, partitive [please provide])
põski	Noun	põski (genitive põzgõõ, partitive [please provide])
talvi	Noun	talvi (genitive talvõõ, partitive [please provide])
õhsa	Noun	õhsa (genitive õhzaa, partitive [please provide])
karjušši	Noun	karjušši (genitive karjušii, partitive [please provide])
virolain	Noun	virolain (genitive virolaizõõ, partitive [please provide])
kuusi	Noun	kuusi (genitive kuuzõõ, partitive [please provide])
muna	Noun	muna (genitive munaa, partitive [please provide])
gaada	Noun	gaada (genitive gaadaa, partitive [please provide])
savvi	Noun	savvi (genitive savvõõ, partitive [please provide])
kunikaz	Noun	kunikaz (genitive kunikaa, partitive [please provide])
sulka	Noun	sulka (genitive sulgaa, partitive [please provide])
kaľaska	Noun	kaľaska (genitive kaľaskaa, partitive [please provide])
lauta	Noun	lauta (genitive lavvaa, partitive [please provide])
lehmä	Noun	lehmä (genitive lehmää, partitive [please provide])
sooli	Noun	sooli (genitive soolõõ, partitive [please provide])
tervüüz	Noun	tervüüz (genitive tervüü or tervühsee, partitive [please provide])
vesi	Noun	vesi (genitive vee, partitive vettä)
einä	Noun	einä (genitive einää, partitive [please provide])
pühä	Noun	pühä (genitive pühää, partitive [please provide])
maa	Noun	maa (genitive maa, partitive maat)
silta	Noun	silta (genitive silla, partitive siltaa)
iiri	Noun	iiri (genitive iiree, partitive [please provide])
kormuna	Noun	kormuna (genitive kormunaa, partitive [please provide])
täi	Noun	täi (genitive täi, partitive [please provide])
kullaz	Noun	kullaz (genitive [please provide], partitive [please provide])
seppä	Noun	seppä (genitive sepää, partitive seppää)
lentüz	Noun	lentüz (genitive [please provide], partitive [please provide])
koto	Noun	koto (genitive koo, partitive [please provide])
länsi	Noun	länsi (genitive lännee, partitive [please provide])
baabukaz	Noun	baabukaz (genitive baabukkaa, partitive [please provide])
tšäsi	Noun	tšäsi (genitive tšäee, partitive tšättä)
katõ	Noun	katõ (genitive kattõõ, partitive [please provide])
aika	Noun	aika (genitive aigaa, partitive aikaa)
sorsa	Noun	sorsa (genitive sorzaa, partitive [please provide])
tšülä	Noun	tšülä (genitive tšülää, partitive [please provide])
keräjä	Noun	keräjä (genitive keräjää, partitive [please provide])
vaďďa	Noun	vaďďa (genitive vaďďaa, partitive [please provide])
vaďďa	Noun	vaďďa (genitive vaďďaa, partitive [please provide])
ahvakko	Noun	ahvakko (genitive ahvakoo, partitive [please provide])
kalanikka	Noun	kalanikka (genitive kalanikaa, partitive [please provide])
krotta	Noun	krotta (genitive krotaa, partitive [please provide])
klasi	Noun	klasi (genitive klazii, partitive [please provide])
kahtši	Noun	kahtši (genitive kazgõõ, partitive [please provide])
laulaja	Noun	laulaja (genitive laulajaa, partitive [please provide])
nagriz	Noun	nagriz (genitive nagrii, partitive [please provide])
laďďuuz	Noun	laďďuuz (genitive laďďuu, partitive [please provide])
kreeposti	Noun	kreeposti (genitive kreepostii, partitive [please provide])
ääri	Noun	ääri (genitive ääree, partitive [please provide])
lehtši	Noun	lehtši (genitive lezzee, partitive [please provide])
izintimä	Noun	izintimä (genitive izintimää, partitive [please provide])
äntä	Noun	äntä (genitive ännää, partitive [please provide])
kukko	Noun	kukko (genitive kukoo, partitive [please provide])
üü	Noun	üü (genitive üü, partitive üüt)
tšimo	Noun	tšimo (genitive tšimoo, partitive [please provide])
kõta	Noun	kõta (genitive kõaa, partitive [please provide])
eläin	Noun	eläin (genitive eläimee, partitive [please provide])
voosi	Noun	voosi (genitive vovvõõ, partitive [please provide])
kańevo	Noun	kańevo (genitive kańevoo, partitive [please provide])
reitšä	Noun	reitšä (genitive reďďä, partitive reitšää)
repo	Noun	repo (genitive revoo, partitive [please provide])
kerääjä	Noun	kerääjä (genitive kerääjää, partitive [please provide])
meeli	Noun	meeli (genitive meelee, partitive [please provide])
kataga	Noun	kataga (genitive katagaa, partitive [please provide])
aita	Noun	aita (genitive aďďaa, partitive [please provide])
sini	Noun	sini (genitive sinii, partitive [please provide])
inehmiin	Noun	inehmiin (genitive inehmiizee, partitive [please provide])
tšüüsi	Noun	tšüüsi (genitive tšüünee or tšünnee, partitive [please provide])
klazi	Noun	klazi (genitive klazii, partitive [please provide])
elo	Noun	elo (genitive eloo, partitive [please provide])
taimi	Noun	taimi (genitive taimõõ, partitive [please provide])
ääni	Noun	ääni (genitive äänee, partitive [please provide])
koorma	Noun	koorma (genitive koormaa, partitive [please provide])
varõz	Noun	varõz (genitive varõhsõõ, partitive varõssa)
soldatti	Noun	soldatti (genitive soldatii, partitive [please provide])
ilma	Noun	ilma (genitive ilmaa, partitive [please provide])
tedri	Noun	tedri (genitive tedrii, partitive [please provide])
terä	Noun	terä (genitive terää, partitive [please provide])
põlvi	Noun	põlvi (genitive põlvõõ, partitive [please provide])
tšeeli	Noun	tšeeli (genitive tšeelee, partitive [please provide])
laatka	Noun	laatka (genitive laadgaa, partitive [please provide])
taivaz	Noun	taivaz (genitive taivaa, partitive [please provide])
joomari	Noun	joomari (genitive joomarii, partitive [please provide])
vene	Noun	vene (genitive venee, partitive venehtä)
ätä	Noun	ätä (genitive ädää, partitive [please provide])
kotikko	Noun	kotikko (genitive kotikoo, partitive [please provide])
lehto	Noun	lehto (genitive lehoo, partitive [please provide])
puna	Noun	puna (genitive punaa, partitive [please provide])
api	Noun	api (genitive avii, partitive [please provide])
pesä	Noun	pesä (genitive pezää, partitive [please provide])
sooni	Noun	sooni (genitive [please provide], partitive [please provide])
sõrmi	Noun	sõrmi (genitive sõrmõõ, partitive [please provide])
kuu	Noun	kuu (genitive kuu, partitive kuut)
lammaz	Noun	lammaz (genitive lampaa, partitive lammassa)
hoonopooli	Noun	hoonopooli (genitive hoonopoolõõ, partitive [please provide])
sütšüzü	Noun	sütšüzü (genitive sütšüzüü, partitive [please provide])
tšüünel	Noun	tšüünel (genitive tšuunelee, partitive [please provide])
maailma	Noun	maailma (genitive maailmaa, partitive [please provide])
mätši	Noun	mätši (genitive mäe, partitive mätšeä)
veittsi	Noun	veittsi (genitive veitsee, partitive [please provide])
sõzar	Noun	sõzar (genitive sõsarõõ, partitive sõzarta)
koori	Noun	koori (genitive koorõõ, partitive [please provide])
bruuda	Noun	bruuda (genitive bruudaa, partitive [please provide])
vaikko	Noun	vaikko (genitive vaikoo, partitive [please provide])
jõutu	Noun	jõutu (genitive jõvvuu, partitive [please provide])
vaďďalain	Noun	vaďďalain (genitive vaďďalaizõõ, partitive [please provide])
luu	Noun	luu (genitive luu, partitive luut)
etelä	Noun	etelä (genitive etelää, partitive [please provide])
kramppi	Noun	kramppi (genitive krampii, partitive [please provide])
guľu	Noun	guľu (genitive guľuu, partitive [please provide])
vätši	Noun	vätši (genitive väee, partitive [please provide])
ilvez	Noun	ilvez (genitive ilvehsee, partitive [please provide])
kapussa	Noun	kapussa (genitive kapusaa, partitive [please provide])
itšee	Noun	itšee (genitive [please provide], partitive [please provide])
võtii	Noun	võtii (genitive võttimõ, partitive võtiit)
kagla	Noun	kagla (genitive kaglaa, partitive [please provide])
lautta	Noun	lautta (genitive lautaa, partitive [please provide])
lidna	Noun	lidna (genitive lidnaa, partitive [please provide])
tševäd	Noun	tševäd (genitive tševää, partitive tševättä)
tšentšä	Noun	tšentšä (genitive tšennä, partitive [please provide])
inkerilain	Noun	inkerilain (genitive inkerilaizõõ, partitive [please provide])
mahla	Noun	mahla (genitive mahlaa, partitive [please provide])
jupka	Noun	jupka (genitive jubgaa, partitive [please provide])
laiskuz	Noun	laiskuz (genitive laiskuu, partitive [please provide])
jürü	Noun	jürü (genitive jürüü, partitive [please provide])
kasõ	Noun	kasõ (genitive kassõõ, partitive [please provide])
kuraz	Noun	kuraz (genitive kurahsõõ, partitive [please provide])
võdna	Noun	võdna (genitive võdnaa, partitive [please provide])
truba	Noun	truba (genitive trubaa, partitive [please provide])
soo	Noun	soo (genitive soo, partitive soot)
ragõ	Noun	ragõ (genitive rakõõ, partitive [please provide])
aapa	Noun	aapa (genitive aavaa, partitive aapaa)
tõinõpäivä	Noun	tõinõpäivä (genitive tõinõpäivää, partitive [please provide])
nimi	Noun	nimi (genitive nime, partitive nimeä)
kazvo	Noun	kazvo (genitive kazvoo, partitive [please provide])
jätaži	Noun	jätaži (genitive jätaži, partitive jätažia)
jalka	Noun	jalka (genitive jalgaa, partitive jalkaa)
üle	Noun	üle (genitive ülee, partitive [please provide])
vävü	Noun	vävü (genitive vävüü, partitive [please provide])
tähti	Noun	tähti (genitive tähee, partitive tähtea)
vana	Noun	vana (genitive vanaa, partitive [please provide])
haili	Noun	haili (genitive hailii, partitive [please provide])
emä	Noun	emä (genitive emä, partitive emää)
mahsa	Noun	mahsa (genitive [please provide], partitive [please provide])
elmi	Noun	elmi (genitive elmee, partitive [please provide])
jää	Noun	jää (genitive jää, partitive jäät)
kukšina	Noun	kukšina (genitive kukšinaa, partitive [please provide])
iho	Noun	iho (genitive ihoo, partitive [please provide])
kumma	Noun	kumma (genitive kummaa, partitive [please provide])
saari	Noun	saari (genitive saarõõ, partitive [please provide])
tõuko	Noun	tõuko (genitive [please provide], partitive [please provide])
kirstu	Noun	kirstu (genitive kirstuu, partitive [please provide])
tuli	Noun	tuli (genitive tulõõ, partitive [please provide])
tširvez	Noun	tširvez (genitive tširvee, partitive [please provide])
sõpa	Noun	sõpa (genitive sõvaa, partitive [please provide])
puu	Noun	puu (genitive puu, partitive [please provide])
itä	Noun	itä (genitive iää, partitive [please provide])
latši	Noun	latši (genitive lagõ, partitive lakõa)
kaappi	Noun	kaappi (genitive kaapii, partitive [please provide])
kaaska	Noun	kaaska (genitive kaazgaa, partitive [please provide])
tširppu	Noun	tširppu (genitive tširpuu, partitive [please provide])
kamunista	Noun	kamunista (genitive kamunistaa, partitive [please provide])
opõnõ	Noun	opõnõ (genitive opõzõõ, partitive ovõssa)
tanttsu	Noun	tanttsu (genitive [please provide], partitive [please provide])
tšivi	Noun	tšivi (genitive tšivee, partitive tšiveä)
lainõ	Noun	lainõ (genitive lainõõ, partitive [please provide])
sõta	Noun	sõta (genitive sõaa, partitive [please provide])
õlka	Noun	õlka (genitive olaa, partitive [please provide])
kanava	Noun	kanava (genitive kanavaa, partitive [please provide])
kaivo	Noun	kaivo (genitive kaivoo, partitive [please provide])
perze	Noun	perze (genitive persee, partitive [please provide])
frovva	Noun	frovva (genitive frovvaa, partitive [please provide])
kagluz	Noun	kagluz (genitive kagluhsõõ, partitive [please provide])
baabuška	Noun	baabuška (genitive baabuškaa, partitive [please provide])
juusso	Noun	juusso (genitive juusoo, partitive juussoa)
kõrsi	Noun	kõrsi (genitive kõrrõõ, partitive kõrtta)
kagra	Noun	kagra (genitive kagraa, partitive [please provide])
doro	Noun	doro (genitive [please provide], partitive [please provide])
kiukka	Noun	kiukka (genitive [please provide], partitive [please provide])
tširjai	Noun	tširjai (genitive tširjaimõ, partitive tširjait)
kaasi	Noun	kaasi (genitive [please provide], partitive [please provide])
savi	Noun	savi (genitive savõõ, partitive [please provide])
seemee	Noun	seemee (genitive seemenee, partitive seementä)
õrava	Noun	õrava (genitive õravaa, partitive [please provide])
kõlmaispäivä	Noun	kõlmaispäivä (genitive kõlmaispäivää, partitive [please provide])
lahsi	Noun	lahsi (genitive lahzõõ, partitive lassa)
silmä	Noun	silmä (genitive silmää, partitive silmää)
jõtši	Noun	jõtši (genitive jõgõõ, partitive jõkõa)
sato	Noun	sato (genitive saoo, partitive [please provide])
nenä	Noun	nenä (genitive nenää, partitive [please provide])
tähtši	Noun	tähtši (genitive tähďee, partitive [please provide])
ime	Noun	ime (genitive imee, partitive imettä)
eläjä	Noun	eläjä (genitive eläjää, partitive [please provide])
lumi	Noun	lumi (genitive lumõõ, partitive lunta)
terveüz	Noun	terveüz (genitive terveüü, partitive [please provide])
kõrva	Noun	kõrva (genitive kõrvaa, partitive kõrvaa)
mõõkka	Noun	mõõkka (genitive mõõkaa, partitive [please provide])
adra	Noun	adra (genitive adraa, partitive [please provide])
süü	Noun	süü (genitive süü, partitive [please provide])
akkuna	Noun	akkuna (genitive akkunaa, partitive akkunaa)
lapia	Noun	lapia (genitive lapiaa, partitive [please provide])
kabja	Noun	kabja (genitive kabjaa, partitive [please provide])
entši	Noun	entši (genitive enďee, partitive entšeä)
autši	Noun	autši (genitive auďii, partitive [please provide])
sõna	Noun	sõna (genitive sõnaa, partitive sõnaa)
staruha	Noun	staruha (genitive staruhaa, partitive staruhaa)
jalgaz	Noun	jalgaz (genitive [please provide], partitive [please provide])
jänez	Noun	jänez (genitive jänehsee, partitive [please provide])
sika	Noun	sika (genitive sigaa, partitive [please provide])
zemľänka	Noun	zemľänka (genitive zemľänkaa, partitive [please provide])
orjamarja	Noun	orjamarja (genitive orjamarjaa, partitive [please provide])
uhsi	Noun	uhsi (genitive uhzõõ, partitive ussa)
maamuna	Noun	maamuna (genitive maamunaa, partitive maamunaa)
püssü	Noun	püssü (genitive püsüü, partitive [please provide])
nooruz	Noun	nooruz (genitive nooruu, partitive [please provide])
razva	Noun	razva (genitive razvaa, partitive [please provide])
kajaga	Noun	kajaga (genitive kajagaa, partitive [please provide])
pää	Noun	pää (genitive pää, partitive päät)
mettsä	Noun	mettsä (genitive metsää, partitive [please provide])
lehti	Noun	lehti (genitive lehee, partitive [please provide])
itšä	Noun	itšä (genitive iä, partitive itšää)
pilvi	Noun	pilvi (genitive pilvee, partitive [please provide])
koivu	Noun	koivu (genitive koivuu, partitive [please provide])
ammaz	Noun	ammaz (genitive ampaa, partitive ammassa)
suvi	Noun	suvi (genitive suvõõ, partitive [please provide])
pimiä	Noun	pimiä (genitive pimiä, partitive [please provide])
tširja	Noun	tširja (genitive tširja, partitive tširjaa)
õltši	Noun	õltši (genitive õlgõõ, partitive [please provide])
vahtši	Noun	vahtši (genitive vazgõõ, partitive [please provide])
suurima	Noun	suurima (genitive [please provide], partitive [please provide])
salmi	Noun	salmi (genitive salmii, partitive [please provide])
ärtšä	Noun	ärtšä (genitive ärjää, partitive [please provide])
ülle	Noun	ülle (genitive ültšee, partitive [please provide])
kangaz	Noun	kangaz (genitive kankaa, partitive [please provide])
itši	Noun	itši (genitive igõõ, partitive [please provide])
laatko	Noun	laatko (genitive laadgoo, partitive [please provide])
suu	Noun	suu (genitive suu, partitive [please provide])
laiva	Noun	laiva (genitive laivaa, partitive [please provide])
sukulain	Noun	sukulain (genitive sukulaizõõ, partitive [please provide])
leipä	Noun	leipä (genitive leivää, partitive leipää)
ahjo	Noun	ahjo (genitive ahjoo, partitive [please provide])
kreiposti	Noun	kreiposti (genitive kreipostii, partitive [please provide])
liha	Noun	liha (genitive lihaa, partitive [please provide])
isä	Noun	isä (genitive izää, partitive isää)
päivä	Noun	päivä (genitive päivää, partitive päivää)
opo	Noun	opo (genitive ovoo, partitive [please provide])
õhtago	Noun	õhtago (genitive õhtagoo, partitive [please provide])
sipuli	Noun	sipuli (genitive sipuli, partitive sipulia)
suvaamiin	Noun	suvaamiin (genitive suvaamizõõ, partitive [please provide])
iili	Noun	iili (genitive iilee, partitive [please provide])
surma	Noun	surma (genitive surmaa, partitive [please provide])
mäntä	Noun	mäntä (genitive männää, partitive [please provide])
lõimi	Noun	lõimi (genitive lõimõõ, partitive [please provide])
sauna	Noun	sauna (genitive saunaa, partitive [please provide])
leemi	Noun	leemi (genitive leemee, partitive [please provide])
kukkõ	Noun	kukkõ (genitive kukõõ, partitive [please provide])
kotti	Noun	kotti (genitive kotii, partitive [please provide])
javo	Noun	javo (genitive [please provide], partitive [please provide])
peni	Noun	peni (genitive penii, partitive [please provide])
ilozuz	Noun	ilozuz (genitive ilozuu, partitive ilozutta)
susi	Noun	susi (genitive suõõ, partitive sutta)
botška	Noun	botška (genitive bodžgaa, partitive [please provide])
murhõ	Noun	murhõ (genitive murhõõ, partitive [please provide])
ono	Noun	ono (genitive onoo, partitive [please provide])
traatti	Noun	traatti (genitive [please provide], partitive [please provide])
haukka	Noun	haukka (genitive haukaa, partitive [please provide])
kala	Noun	kala (genitive kalaa, partitive kalaa)
aukko	Noun	aukko (genitive aukoo, partitive [please provide])
tee	Noun	tee (genitive tee, partitive [please provide])
või	Noun	või (genitive või, partitive [please provide])
vihma	Noun	vihma (genitive vihmaa, partitive [please provide])
õnni	Noun	õnni (genitive õnnõõ, partitive [please provide])
lahja	Noun	lahja (genitive lahjaa, partitive [please provide])
seltšä	Noun	seltšä (genitive sellää, partitive [please provide])
siili	Noun	siili (genitive siilii, partitive siiliä)
õpõa	Noun	õpõa (genitive õppaa, partitive [please provide])
tšiutto	Noun	tšiutto (genitive tšiutoo, partitive [please provide])
karja	Noun	karja (genitive karjaa, partitive [please provide])
zveeri	Noun	zveeri (genitive zveerii, partitive [please provide])
tšesä	Noun	tšesä (genitive tšezää, partitive [please provide])
kurtši	Noun	kurtši (genitive kurgõõ, partitive kurkõa)
löülü	Noun	löülü (genitive löülüü, partitive [please provide])
juuri	Noun	juuri (genitive juurõõ, partitive [please provide])
mesi	Noun	mesi (genitive mee, partitive [please provide])
õja	Noun	õja (genitive õjaa, partitive [please provide])
kaatsad	Noun	kaatsad (genitive [please provide], partitive [please provide])
kaakko	Noun	kaakko (genitive [please provide], partitive [please provide])
tšüläläin	Noun	tšüläläin (genitive tšüläläizee, partitive [please provide])
jarvi	Noun	jarvi (genitive jarvõõ, partitive [please provide])
krapu	Noun	krapu (genitive kravuu, partitive [please provide])
harjokka	Noun	harjokka (genitive [please provide], partitive [please provide])
leppä	Noun	leppä (genitive lepää, partitive [please provide])
öö	Noun	öö (genitive öö, partitive ööt)
oonõ	Noun	oonõ (genitive oonõõ, partitive [please provide])
toomi	Noun	toomi (genitive toomõõ, partitive [please provide])
rauta	Noun	rauta (genitive ravvaa, partitive [please provide])
esimespäivä	Noun	esimespäivä (genitive esimespäivää, partitive [please provide])
kittrõõba	Noun	kittrõõba (genitive [please provide], partitive [please provide])
viha	Noun	viha (genitive vihaa, partitive [please provide])
lahti	Noun	lahti (genitive lahõõ, partitive [please provide])
lintu	Noun	lintu (genitive linnuu, partitive lintua)
poika	Noun	poika (genitive poigaa, partitive poikaa)
krazguz	Noun	krazguz (genitive [please provide], partitive [please provide])
õlud	Noun	õlud (genitive õluu, partitive õlutta)
tütär	Noun	tütär (genitive tüttäree, partitive tütärtä)
veri	Noun	veri (genitive veree, partitive [please provide])
sõbra	Noun	sõbra (genitive sõbra, partitive sõbraa)
kõrkõuz	Noun	kõrkõuz (genitive kõrkõuu, partitive [please provide])
jumala	Noun	jumala (genitive jumalaa, partitive [please provide])
meez	Noun	meez (genitive mehee, partitive meessä)
laulu	Noun	laulu (genitive lauluu, partitive [please provide])
ääli	Noun	ääli (genitive äälee, partitive [please provide])
järvi	Noun	järvi (genitive järvee, partitive järveä)
meri	Noun	meri (genitive meree, partitive [please provide])
siini	Noun	siini (genitive siinee, partitive [please provide])
arina	Noun	arina (genitive arinaa, partitive [please provide])
emintimä	Noun	emintimä (genitive emintimää, partitive [please provide])
ivuz	Noun	ivuz (genitive [please provide], partitive [please provide])
konna	Noun	konna (genitive konnaa, partitive [please provide])
nain	Noun	nain (genitive naizõõ, partitive naissa)
süä	Noun	süä (genitive süämee or süämmee, partitive süät)
