meeletoo	Adjective	meeletoo (genitive meeletomaa, partitive [please provide])
terve	Adjective	terve (genitive tervee, partitive [please provide])
mussa	Adjective	mussa (genitive musaa, partitive [please provide])
noori	Adjective	noori (genitive noorõõ, partitive [please provide])
pühä	Adjective	pühä (genitive pühää, partitive [please provide])
väärä	Adjective	väärä (genitive väärää, partitive [please provide])
kalliz	Adjective	kalliz (genitive kallii, partitive [please provide])
armaz	Adjective	armaz (genitive armaa, partitive [please provide])
õikõa	Adjective	õikõa (genitive õikõaa, partitive [please provide])
lämmii	Adjective	lämmii (genitive lämpimää, partitive [please provide])
uusi	Adjective	uusi (genitive uvvõõ, partitive [please provide])
peeni	Adjective	peeni (genitive peenee, partitive [please provide])
kõrkõa	Adjective	kõrkõa (genitive kõrkõa, partitive [please provide])
vana	Adjective	vana (genitive vanaa, partitive [please provide])
punanõ	Adjective	punanõ (genitive punazõõ, partitive [please provide])
valkõa	Adjective	valkõa (genitive valkõa, partitive [please provide])
tõin	Adjective	tõin (genitive tõizõõ, partitive [please provide])
ruskõa	Adjective	ruskõa (genitive ruskõa, partitive [please provide])
esimein	Adjective	esimein (genitive esimeizee, partitive [please provide])
pimiä	Adjective	pimiä (genitive pimiä, partitive [please provide])
sinin	Adjective	sinin (genitive sinizee, partitive sinissä)
parõpi	Adjective	parõpi (genitive parõpaa, partitive [please provide])
tšülmä	Adjective	tšülmä (genitive tšülmää, partitive [please provide])
ńemoi	Adjective	ńemoi (genitive ńemoi, partitive ńemoit)
kõva	Adjective	kõva (genitive kovaa, partitive [please provide])
hullu	Adjective	hullu (genitive hulluu, partitive [please provide])
viherä	Adjective	viherä (genitive viherää, partitive [please provide])
pittšä	Adjective	pittšä (genitive pitšää, partitive [please provide])
ellä	Adjective	ellä (genitive ellää, partitive [please provide])
postojannoi	Adjective	postojannoi (genitive [please provide], partitive [please provide])
stoikoi	Adjective	stoikoi (genitive [please provide], partitive [please provide])
üvä	Adjective	üvä (genitive üvää, partitive [please provide], comparative parõpi, superlative kõikkõa parõpi)
