piaxer	Verb	<p id="mwDw"><strong class="Latn headword" id="mwEA" lang="vec">piaxer</strong> <span class="ib-brac" id="mwEg">(</span><span class="ib-content">transitive</span><span class="ib-brac" id="mwEw">)</span></p>
conzsar	Verb	<p id="mwDQ"><strong class="Latn headword" id="mwDg" lang="vec">conzsar</strong></p>
inpizar	Verb	<p id="mwAw"><strong class="Latn headword" id="mwBA" lang="vec">inpizar</strong></p>
sgrafar	Verb	<p id="mwBQ"><strong class="Latn headword" id="mwBg" lang="vec">sgrafar</strong></p>
bagnar	Verb	<p id="mwCw"><strong class="Latn headword" id="mwDA" lang="vec">bagnar</strong></p>
conosar	Verb	<p id="mwEw"><strong class="Latn headword" id="mwFA" lang="vec">conosar</strong></p>
stupar	Verb	<p id="mwFg"><strong class="Latn headword" id="mwFw" lang="vec">stupar</strong></p>
védar	Verb	<p id="mwDA"><strong class="Latn headword" id="mwDQ" lang="vec">védar</strong></p>
sia	Verb	<p id="mwAQE"><strong class="Latn headword" id="mwAQI" lang="vec">sia</strong></p>
inventar	Verb	<p id="mwVg"><strong class="Latn headword" id="mwVw" lang="vec">inventar</strong></p>
son	Verb	<p id="mwA4A"><strong class="Latn headword" id="mwA4E" lang="vec">son</strong></p>
slongar	Verb	<p id="mwBQ"><strong class="Latn headword" id="mwBg" lang="vec">slongar</strong></p>
brustołar	Verb	<p id="mwBg"><strong class="Latn headword" id="mwBw" lang="vec">brustołar</strong></p>
pèrdar	Verb	<p id="mwCA"><strong class="Latn headword" id="mwCQ" lang="vec">pèrdar</strong></p>
tacar	Verb	<p id="mwSA"><strong class="Latn headword" id="mwSQ" lang="vec">tacar</strong></p>
strapegar	Verb	<p id="mwAw"><strong class="Latn headword" id="mwBA" lang="vec">strapegar</strong></p>
stuar	Verb	<p id="mwAw"><strong class="Latn headword" id="mwBA" lang="vec">stuar</strong></p>
odiare	Verb	<p id="mwNg"><strong class="Latn headword" id="mwNw" lang="vec">odiare</strong></p>
cogner	Verb	<p id="mwLQ"><strong class="Latn headword" id="mwLg" lang="vec">cogner</strong></p>
ametar	Verb	<p id="mwDA"><strong class="Latn headword" id="mwDQ" lang="vec">ametar</strong></p>
doparar	Verb	<p id="mwAw"><strong class="Latn headword" id="mwBA" lang="vec">doparar</strong></p>
invełenar	Verb	<p id="mwDQ"><strong class="Latn headword" id="mwDg" lang="vec">invełenar</strong></p>
bójar	Verb	<p id="mwEw"><strong class="Latn headword" id="mwFA" lang="vec">bójar</strong></p>
sbrisiar	Verb	<p id="mwAw"><strong class="Latn headword" id="mwBA" lang="vec">sbrisiar</strong></p>
sbrajar	Verb	<p id="mwBQ"><strong class="Latn headword" id="mwBg" lang="vec">sbrajar</strong></p>
scorlar	Verb	<p id="mwAw"><strong class="Latn headword" id="mwBA" lang="vec">scorlar</strong></p>
èser	Verb	<p id="mwHg"><strong class="Latn headword" id="mwHw" lang="vec">èser</strong></p>
conpletar	Verb	<p id="mwBQ"><strong class="Latn headword" id="mwBg" lang="vec">conpletar</strong></p>
spiegar	Verb	<p id="mwBg"><strong class="Latn headword" id="mwBw" lang="vec">spiegar</strong></p>
łegałixar	Verb	<p id="mwBA"><strong class="Latn headword" id="mwBQ" lang="vec">łegałixar</strong></p>
begar	Verb	<p id="mwEA"><strong class="Latn headword" id="mwEQ" lang="vec">begar</strong></p>
desbrojar	Verb	<p id="mwAw"><strong class="Latn headword" id="mwBA" lang="vec">desbrojar</strong> (fora)</p>
rumar	Verb	<p id="mwOg"><strong class="Latn headword" id="mwOw" lang="vec">rumar</strong></p>
limitar	Verb	<p id="mwQA"><strong class="Latn headword" id="mwQQ" lang="vec">limitar</strong></p>
atirar	Verb	<p id="mwNw"><strong class="Latn headword" id="mwOA" lang="vec">atirar</strong></p>
misiar	Verb	<p id="mwDQ"><strong class="Latn headword" id="mwDg" lang="vec">misiar</strong></p>
cascar	Verb	<p id="mwUw"><strong class="Latn headword" id="mwVA" lang="vec">cascar</strong></p>
véndar	Verb	<p id="mwCw"><strong class="Latn headword" id="mwDA" lang="vec">véndar</strong></p>
spetar	Verb	<p id="mwCA"><strong class="Latn headword" id="mwCQ" lang="vec">spetar</strong></p>
intosegar	Verb	<p id="mwDQ"><strong class="Latn headword" id="mwDg" lang="vec">intosegar</strong></p>
acetar	Verb	<p id="mwBQ"><strong class="Latn headword" id="mwBg" lang="vec">acetar</strong></p>
çentrałizar	Verb	<p id="mwBg"><strong class="Latn headword" id="mwBw" lang="vec">çentrałizar</strong></p>
desmontar	Verb	<p id="mwNA"><strong class="Latn headword" id="mwNQ" lang="vec">desmontar</strong></p>
gero	Verb	<p id="mwZA"><strong class="Latn headword" id="mwZQ" lang="vec">gero</strong></p>
castrar	Verb	<p id="mwTQ"><strong class="Latn headword" id="mwTg" lang="vec">castrar</strong></p>
provar	Verb	<p id="mwXg"><strong class="Latn headword" id="mwXw" lang="vec">provar</strong></p>
cantar	Verb	<p id="mwAS8"><strong class="Latn headword" id="mwATA" lang="vec">cantar</strong></p>
usir	Verb	<p id="mwPQ"><strong class="Latn headword" id="mwPg" lang="vec">usir</strong></p>
spełar	Verb	<p id="mwBQ"><strong class="Latn headword" id="mwBg" lang="vec">spełar</strong></p>
savariare	Verb	<p id="mwBg"><strong class="Latn headword" id="mwBw" lang="vec">savariare</strong></p>
sujerir	Verb	<p id="mwCQ"><strong class="Latn headword" id="mwCg" lang="vec">sujerir</strong></p>
rostir	Verb	<p id="mwMA"><strong class="Latn headword" id="mwMQ" lang="vec">rostir</strong></p>
criar	Verb	<p id="mwXA"><strong class="Latn headword" id="mwXQ" lang="vec">criar</strong></p>
soranomenar	Verb	<p id="mwAw"><strong class="Latn headword" id="mwBA" lang="vec">soranomenar</strong></p>
sfondrar	Verb	<p id="mwCA"><strong class="Latn headword" id="mwCQ" lang="vec">sfondrar</strong></p>
sentir	Verb	<p id="mwAeM"><strong class="Latn headword" id="mwAeQ" lang="vec">sentir</strong></p>
star	Verb	<p id="mwAVw"><strong class="Latn headword" id="mwAV0" lang="vec">star</strong></p>
fo	Verb	<p id="mwAUs"><strong class="Latn headword" id="mwAUw" lang="vec">fo</strong></p>
deventar	Verb	<p id="mwBQ"><strong class="Latn headword" id="mwBg" lang="vec">deventar</strong></p>
pontar	Verb	<p id="mwBQ"><strong class="Latn headword" id="mwBg" lang="vec">pontar</strong></p>
scrivar	Verb	<p id="mwCg"><strong class="Latn headword" id="mwCw" lang="vec">scrivar</strong></p>
taconar	Verb	<p id="mwAw"><strong class="Latn headword" id="mwBA" lang="vec">taconar</strong></p>
fracar	Verb	<p id="mwCQ"><strong class="Latn headword" id="mwCg" lang="vec">fracar</strong></p>
conpiłar	Verb	<p id="mwBQ"><strong class="Latn headword" id="mwBg" lang="vec">conpiłar</strong></p>
viajar	Verb	<p id="mwNw"><strong class="Latn headword" id="mwOA" lang="vec">viajar</strong></p>
verxar	Verb	<p id="mwCQ"><strong class="Latn headword" id="mwCg" lang="vec">verxar</strong></p>
stanpar	Verb	<p id="mwBA"><strong class="Latn headword" id="mwBQ" lang="vec">stanpar</strong></p>
bazxotar	Verb	<p id="mwAw"><strong class="Latn headword" id="mwBA" lang="vec">bazxotar</strong></p>
sluxegar	Verb	<p id="mwBQ"><strong class="Latn headword" id="mwBg" lang="vec">sluxegar</strong></p>
costumar	Verb	<p id="mwJw"><strong class="Latn headword" id="mwKA" lang="vec">costumar</strong></p>
tirar	Verb	<p id="mwARo"><strong class="Latn headword" id="mwARs" lang="vec">tirar</strong></p>
invernixar	Verb	<p id="mwCA"><strong class="Latn headword" id="mwCQ" lang="vec">invernixar</strong></p>
convìnzsar	Verb	<p id="mwCw"><strong class="Latn headword" id="mwDA" lang="vec">convìnzsar</strong></p>
ribelar	Verb	<p id="mwCQ"><strong class="Latn headword" id="mwCg" lang="vec">ribelar</strong></p>
sbiansar	Verb	<p id="mwBQ"><strong class="Latn headword" id="mwBg" lang="vec">sbiansar</strong></p>
springar	Verb	<p id="mwUA"><strong class="Latn headword" id="mwUQ" lang="vec">springar</strong></p>
comerçar	Verb	<p id="mwBQ"><strong class="Latn headword" id="mwBg" lang="vec">comerçar</strong></p>
sentar	Verb	<p id="mwqw"><strong class="Latn headword" id="mwrA" lang="vec">sentar</strong></p>
vansar	Verb	<p id="mwBQ"><strong class="Latn headword" id="mwBg" lang="vec">vansar</strong></p>
carołar	Verb	<p id="mwBg"><strong class="Latn headword" id="mwBw" lang="vec">carołar</strong></p>
mołar	Verb	<p id="mwCA"><strong class="Latn headword" id="mwCQ" lang="vec">mołar</strong></p>
slatar	Verb	<p id="mwAw"><strong class="Latn headword" id="mwBA" lang="vec">slatar</strong></p>
gera	Verb	<p id="mwsw"><strong class="Latn headword" id="mwtA" lang="vec">gera</strong></p>
batexemar	Verb	<p id="mwBQ"><strong class="Latn headword" id="mwBg" lang="vec">batexemar</strong></p>
alzsar	Verb	<p id="mwBQ"><strong class="Latn headword" id="mwBg" lang="vec">alzsar</strong></p>
pióvar	Verb	<p id="mwCQ"><strong class="Latn headword" id="mwCg" lang="vec">pióvar</strong> <span class="ib-brac" id="mwDA">(</span><span class="ib-content">impersonal</span><span class="ib-brac" id="mwDQ">)</span></p>
logar	Verb	<p id="mwew"><strong class="Latn headword" id="mwfA" lang="vec">logar</strong></p>
sarare	Verb	<p id="mwCA"><strong class="Latn headword" id="mwCQ" lang="vec">sarare</strong></p>
domandar	Verb	<p id="mwCg"><strong class="Latn headword" id="mwCw" lang="vec">domandar</strong></p>
aterar	Verb	<p id="mwAw"><strong class="Latn headword" id="mwBA" lang="vec">aterar</strong></p>
starnudar	Verb	<p id="mwCA"><strong class="Latn headword" id="mwCQ" lang="vec">starnudar</strong></p>
taxer	Verb	<p id="mwZA"><strong class="Latn headword" id="mwZQ" lang="vec">taxer</strong></p>
controłar	Verb	<p id="mwBQ"><strong class="Latn headword" id="mwBg" lang="vec">controłar</strong></p>
cunar	Verb	<p id="mwBQ"><strong class="Latn headword" id="mwBg" lang="vec">cunar</strong></p>
servir	Verb	<p id="mwATA"><strong class="Latn headword" id="mwATE" lang="vec">servir</strong></p>
morsegar	Verb	<p id="mwCA"><strong class="Latn headword" id="mwCQ" lang="vec">morsegar</strong></p>
vogar	Verb	<p id="mwPw"><strong class="Latn headword" id="mwQA" lang="vec">vogar</strong></p>
bacajar	Verb	<p id="mwAw"><strong class="Latn headword" id="mwBA" lang="vec">bacajar</strong></p>
desfar	Verb	<p id="mwEw"><strong class="Latn headword" id="mwFA" lang="vec">desfar</strong></p>
sugerir	Verb	<p id="mwLQ"><strong class="Latn headword" id="mwLg" lang="vec">sugerir</strong></p>
sperar	Verb	<p id="mwJg"><strong class="Latn headword" id="mwJw" lang="vec">sperar</strong></p>
aprofondir	Verb	<p id="mwBQ"><strong class="Latn headword" id="mwBg" lang="vec">aprofondir</strong></p>
tociar	Verb	<p id="mwAw"><strong class="Latn headword" id="mwBA" lang="vec">tociar</strong></p>
vołer	Verb	<p id="mwDA"><strong class="Latn headword" id="mwDQ" lang="vec">vołer</strong></p>
jeri	Verb	<p id="mwIg"><strong class="Latn headword" id="mwIw" lang="vec">jeri</strong></p>
łustrar	Verb	<p id="mwAw"><strong class="Latn headword" id="mwBA" lang="vec">łustrar</strong></p>
desidar	Verb	<p id="mwBg"><strong class="Latn headword" id="mwBw" lang="vec">desidar</strong></p>
somejar	Verb	<p id="mwDg"><strong class="Latn headword" id="mwDw" lang="vec">somejar</strong></p>
destacar	Verb	<p id="mwWw"><strong class="Latn headword" id="mwXA" lang="vec">destacar</strong></p>
carezsar	Verb	<p id="mwCg"><strong class="Latn headword" id="mwCw" lang="vec">carezsar</strong></p>
sponciar	Verb	<p id="mwAw"><strong class="Latn headword" id="mwBA" lang="vec">sponciar</strong></p>
intorcołar	Verb	<p id="mwBg"><strong class="Latn headword" id="mwBw" lang="vec">intorcołar</strong></p>
aspetar	Verb	<p id="mwCQ"><strong class="Latn headword" id="mwCg" lang="vec">aspetar</strong></p>
trincar	Verb	<p id="mwMw"><strong class="Latn headword" id="mwNA" lang="vec">trincar</strong></p>
pociar	Verb	<p id="mwBw"><strong class="Latn headword" id="mwCA" lang="vec">pociar</strong></p>
aver	Verb	<p id="mwAXU"><strong class="Latn headword" id="mwAXY" lang="vec">aver</strong></p>
mantegner	Verb	<p id="mwDA"><strong class="Latn headword" id="mwDQ" lang="vec">mantegner</strong></p>
cołegar	Verb	<p id="mwBQ"><strong class="Latn headword" id="mwBg" lang="vec">cołegar</strong></p>
gaver	Verb	<p id="mwOQ"><strong class="Latn headword" id="mwOg" lang="vec">gaver</strong></p>
apostrofar	Verb	<p id="mwHg"><strong class="Latn headword" id="mwHw" lang="vec">apostrofar</strong></p>
spesegar	Verb	<p id="mwAw"><strong class="Latn headword" id="mwBA" lang="vec">spesegar</strong></p>
visuałixar	Verb	<p id="mwBQ"><strong class="Latn headword" id="mwBg" lang="vec">visuałixar</strong></p>
parer	Verb	<p id="mwWA"><strong class="Latn headword" id="mwWQ" lang="vec">parer</strong></p>
stuxar	Verb	<p id="mwAw"><strong class="Latn headword" id="mwBA" lang="vec">stuxar</strong></p>
descovèrzar	Verb	<p id="mwEw"><strong class="Latn headword" id="mwFA" lang="vec">descovèrzar</strong></p>
apartegnir	Verb	<p id="mwCA"><strong class="Latn headword" id="mwCQ" lang="vec">apartegnir</strong></p>
tornar	Verb	<p id="mw4A"><strong class="Latn headword" id="mw4Q" lang="vec">tornar</strong></p>
ga	Verb	<p id="mwAUA"><strong class="Latn headword" id="mwAUE" lang="vec">ga</strong></p>
aer	Verb	<p id="mw7g"><strong class="Latn headword" id="mw7w" lang="vec">aer</strong></p>
stropar	Verb	<p id="mwBg"><strong class="Latn headword" id="mwBw" lang="vec">stropar</strong></p>
pestar	Verb	<p id="mwGQ"><strong class="Latn headword" id="mwGg" lang="vec">pestar</strong></p>
ciapar	Verb	<p id="mwFw"><strong class="Latn headword" id="mwGA" lang="vec">ciapar</strong></p>
métar	Verb	<p id="mwDQ"><strong class="Latn headword" id="mwDg" lang="vec">métar</strong></p>
xontar	Verb	<p id="mwBw"><strong class="Latn headword" id="mwCA" lang="vec">xontar</strong></p>
invadar	Verb	<p id="mwEw"><strong class="Latn headword" id="mwFA" lang="vec">invadar</strong></p>
modifegar	Verb	<p id="mwBw"><strong class="Latn headword" id="mwCA" lang="vec">modifegar</strong></p>
ciacołar	Verb	<p id="mwBQ"><strong class="Latn headword" id="mwBg" lang="vec">ciacołar</strong></p>
prodùr	Verb	<p id="mwDA"><strong class="Latn headword" id="mwDQ" lang="vec">prodùr</strong></p>
pisar	Verb	<p id="mwig"><strong class="Latn headword" id="mwiw" lang="vec">pisar</strong></p>
voltar	Verb	<p id="mwiw"><strong class="Latn headword" id="mwjA" lang="vec">voltar</strong></p>
sfrutar	Verb	<p id="mwBQ"><strong class="Latn headword" id="mwBg" lang="vec">sfrutar</strong></p>
exagerar	Verb	<p id="mwOw"><strong class="Latn headword" id="mwPA" lang="vec">exagerar</strong></p>
arar	Verb	<p id="mwfg"><strong class="Latn headword" id="mwfw" lang="vec">arar</strong></p>
dar	Verb	<p id="mwBAs"><strong class="Latn headword" id="mwBAw" lang="vec">dar</strong></p>
slisegar	Verb	<p id="mwAQ"><strong class="Latn headword" id="mwAg" lang="vec">slisegar</strong></p>
scóndar	Verb	<p id="mwEA"><strong class="Latn headword" id="mwEQ" lang="vec">scóndar</strong></p>
maurar	Verb	<p id="mwFw"><strong class="Latn headword" id="mwGA" lang="vec">maurar</strong></p>
schincar	Verb	<p id="mwAw"><strong class="Latn headword" id="mwBA" lang="vec">schincar</strong></p>
curar	Verb	<p id="mwmQ"><strong class="Latn headword" id="mwmg" lang="vec">curar</strong></p>
justar	Verb	<p id="mwGw"><strong class="Latn headword" id="mwHA" lang="vec">justar</strong></p>
tremar	Verb	<p id="mwGQ"><strong class="Latn headword" id="mwGg" lang="vec">tremar</strong></p>
ocupar	Verb	<p id="mwXg"><strong class="Latn headword" id="mwXw" lang="vec">ocupar</strong></p>
augurar	Verb	<p id="mwTA"><strong class="Latn headword" id="mwTQ" lang="vec">augurar</strong></p>
far	Verb	<p id="mwA2M"><strong class="Latn headword" id="mwA2Q" lang="vec">far</strong></p>
tardigar	Verb	<p id="mwEg"><strong class="Latn headword" id="mwEw" lang="vec">tardigar</strong></p>
brazsar	Verb	<p id="mwAw"><strong class="Latn headword" id="mwBA" lang="vec">brazsar</strong></p>
sajar	Verb	<p id="mwFg"><strong class="Latn headword" id="mwFw" lang="vec">sajar</strong></p>
bociar	Verb	<p id="mwBQ"><strong class="Latn headword" id="mwBg" lang="vec">bociar</strong></p>
picar	Verb	<p id="mwlA"><strong class="Latn headword" id="mwlQ" lang="vec">picar</strong> <span class="ib-brac" id="mwlw">(</span><span class="ib-content">transitive<span> </span>or<span> </span>intransitive</span><span class="ib-brac" id="mwmA">)</span></p>
sachegiar	Verb	<p id="mwCA"><strong class="Latn headword" id="mwCQ" lang="vec">sachegiar</strong></p>
arestar	Verb	<p id="mwBQ"><strong class="Latn headword" id="mwBg" lang="vec">arestar</strong></p>
do	Verb	<p id="mwB64"><strong class="Latn headword" id="mwB68" lang="vec">do</strong></p>
pareciar	Verb	<p id="mwBQ"><strong class="Latn headword" id="mwBg" lang="vec">pareciar</strong></p>
go	Verb	<p id="mwBzI"><strong class="Latn headword" id="mwBzM" lang="vec">go</strong></p>
netar	Verb	<p id="mwBg"><strong class="Latn headword" id="mwBw" lang="vec">netar</strong></p>
bixognar	Verb	<p id="mwAw"><strong class="Latn headword" id="mwBA" lang="vec">bixognar</strong></p>
petar	Verb	<p id="mwRg"><strong class="Latn headword" id="mwRw" lang="vec">petar</strong></p>
nar	Verb	<p id="mwzw"><strong class="Latn headword" id="mw0A" lang="vec">nar</strong></p>
divìdar	Verb	<p id="mwBg"><strong class="Latn headword" id="mwBw" lang="vec">divìdar</strong></p>
insìstar	Verb	<p id="mwBw"><strong class="Latn headword" id="mwCA" lang="vec">insìstar</strong></p>
vìnsar	Verb	<p id="mwEQ"><strong class="Latn headword" id="mwEg" lang="vec">vìnsar</strong></p>
rodołar	Verb	<p id="mwBQ"><strong class="Latn headword" id="mwBg" lang="vec">rodołar</strong></p>
łevar	Verb	<p id="mwCA"><strong class="Latn headword" id="mwCQ" lang="vec">łevar</strong></p>
invidar	Verb	<p id="mwAw"><strong class="Latn headword" id="mwBA" lang="vec">invidar</strong></p>
tastar	Verb	<p id="mwWw"><strong class="Latn headword" id="mwXA" lang="vec">tastar</strong></p>
łavorar	Verb	<p id="mwDQ"><strong class="Latn headword" id="mwDg" lang="vec">łavorar</strong></p>
trar	Verb	<p id="mwHg"><strong class="Latn headword" id="mwHw" lang="vec">trar</strong></p>
raprexentar	Verb	<p id="mwBg"><strong class="Latn headword" id="mwBw" lang="vec">raprexentar</strong></p>
regatar	Verb	<p id="mwCQ"><strong class="Latn headword" id="mwCg" lang="vec">regatar</strong></p>
dettar	Verb	<p id="mwBg"><strong class="Latn headword" id="mwBw" lang="vec">dettar</strong></p>
asistar	Verb	<p id="mwBQ"><strong class="Latn headword" id="mwBg" lang="vec">asistar</strong></p>
tugar	Verb	<p id="mwBQ"><strong class="Latn headword" id="mwBg" lang="vec">tugar</strong></p>
costruir	Verb	<p id="mwBg"><strong class="Latn headword" id="mwBw" lang="vec">costruir</strong></p>
ciocar	Verb	<p id="mwAw"><strong class="Latn headword" id="mwBA" lang="vec">ciocar</strong></p>
cuèrzar	Verb	<p id="mwDQ"><strong class="Latn headword" id="mwDg" lang="vec">cuèrzar</strong></p>
pełar	Verb	<p id="mwBw"><strong class="Latn headword" id="mwCA" lang="vec">pełar</strong></p>
invidiar	Verb	<p id="mwBQ"><strong class="Latn headword" id="mwBg" lang="vec">invidiar</strong></p>
rivar	Verb	<p id="mwCw"><strong class="Latn headword" id="mwDA" lang="vec">rivar</strong></p>
incroxar	Verb	<p id="mwBQ"><strong class="Latn headword" id="mwBg" lang="vec">incroxar</strong></p>
acumular	Verb	<p id="mwcQ"><strong class="Latn headword" id="mwcg" lang="vec">acumular</strong></p>
ofendar	Verb	<p id="mwCw"><strong class="Latn headword" id="mwDA" lang="vec">ofendar</strong></p>
sunar	Verb	<p id="mwGQ"><strong class="Latn headword" id="mwGg" lang="vec">sunar</strong></p>
busnar	Verb	<p id="mwAw"><strong class="Latn headword" id="mwBA" lang="vec">busnar</strong></p>
vantar	Verb	<p id="mwGQ"><strong class="Latn headword" id="mwGg" lang="vec">vantar</strong></p>
oler	Verb	<p id="mwQA"><strong class="Latn headword" id="mwQQ" lang="vec">oler</strong> <span class="ib-brac" id="mwQw">(</span><span class="ib-content">intransitive</span><span class="ib-brac" id="mwRA">)</span></p>
copiar	Verb	<p id="mwTA"><strong class="Latn headword" id="mwTQ" lang="vec">copiar</strong></p>
asumar	Verb	<p id="mwBQ"><strong class="Latn headword" id="mwBg" lang="vec">asumar</strong></p>
salvar	Verb	<p id="mwASg"><strong class="Latn headword" id="mwASk" lang="vec">salvar</strong></p>
stisar	Verb	<p id="mwAw"><strong class="Latn headword" id="mwBA" lang="vec">stisar</strong></p>
spojar	Verb	<p id="mwCw"><strong class="Latn headword" id="mwDA" lang="vec">spojar</strong></p>
ponciar	Verb	<p id="mwAw"><strong class="Latn headword" id="mwBA" lang="vec">ponciar</strong></p>
tajar	Verb	<p id="mwNQ"><strong class="Latn headword" id="mwNg" lang="vec">tajar</strong></p>
remenar	Verb	<p id="mwKw"><strong class="Latn headword" id="mwLA" lang="vec">remenar</strong></p>
conbatar	Verb	<p id="mwBA"><strong class="Latn headword" id="mwBQ" lang="vec">conbatar</strong></p>
comandar	Verb	<p id="mwVg"><strong class="Latn headword" id="mwVw" lang="vec">comandar</strong></p>
strigar	Verb	<p id="mwBQ"><strong class="Latn headword" id="mwBg" lang="vec">strigar</strong></p>
daquar	Verb	<p id="mwBg"><strong class="Latn headword" id="mwBw" lang="vec">daquar</strong></p>
spaxemar	Verb	<p id="mwAw"><strong class="Latn headword" id="mwBA" lang="vec">spaxemar</strong></p>
bévar	Verb	<p id="mwCQ"><strong class="Latn headword" id="mwCg" lang="vec">bévar</strong></p>
łibarar	Verb	<p id="mwBg"><strong class="Latn headword" id="mwBw" lang="vec">łibarar</strong></p>
morir	Verb	<p id="mw4Q"><strong class="Latn headword" id="mw4g" lang="vec">morir</strong></p>
rasar	Verb	<p id="mwIw"><strong class="Latn headword" id="mwJA" lang="vec">rasar</strong></p>
anbir	Verb	<p id="mwBA"><strong class="Latn headword" id="mwBQ" lang="vec">anbir</strong></p>
uxar	Verb	<p id="mwBQ"><strong class="Latn headword" id="mwBg" lang="vec">uxar</strong></p>
asaltar	Verb	<p id="mwFg"><strong class="Latn headword" id="mwFw" lang="vec">asaltar</strong></p>
afermar	Verb	<p id="mwBQ"><strong class="Latn headword" id="mwBg" lang="vec">afermar</strong></p>
scoltar	Verb	<p id="mwCQ"><strong class="Latn headword" id="mwCg" lang="vec">scoltar</strong></p>
insegnar	Verb	<p id="mwEg"><strong class="Latn headword" id="mwEw" lang="vec">insegnar</strong></p>
córar	Verb	<p id="mwCg"><strong class="Latn headword" id="mwCw" lang="vec">córar</strong></p>
desmentegar	Verb	<p id="mwDQ"><strong class="Latn headword" id="mwDg" lang="vec">desmentegar</strong></p>
batizxar	Verb	<p id="mwDg"><strong class="Latn headword" id="mwDw" lang="vec">batizxar</strong></p>
bruxar	Verb	<p id="mwCw"><strong class="Latn headword" id="mwDA" lang="vec">bruxar</strong></p>
canbiar	Verb	<p id="mwCg"><strong class="Latn headword" id="mwCw" lang="vec">canbiar</strong></p>
bexognar	Verb	<p id="mwAQ"><strong class="Latn headword" id="mwAg" lang="vec">bexognar</strong></p>
desgatejar	Verb	<p id="mwBA"><strong class="Latn headword" id="mwBQ" lang="vec">desgatejar</strong></p>
sotomesar	Verb	<p id="mwBQ"><strong class="Latn headword" id="mwBg" lang="vec">sotomesar</strong></p>
gòder	Verb	<p id="mwCA"><strong class="Latn headword" id="mwCQ" lang="vec">gòder</strong></p>
aprovar	Verb	<p id="mwNg"><strong class="Latn headword" id="mwNw" lang="vec">aprovar</strong></p>
capir	Verb	<p id="mwOA"><strong class="Latn headword" id="mwOQ" lang="vec">capir</strong></p>
descargar	Verb	<p id="mwNw"><strong class="Latn headword" id="mwOA" lang="vec">descargar</strong></p>
mandar	Verb	<p id="mw6w"><strong class="Latn headword" id="mw7A" lang="vec">mandar</strong></p>
spiar	Verb	<p id="mwBQ"><strong class="Latn headword" id="mwBg" lang="vec">spiar</strong></p>
sgnaolar	Verb	<p id="mwAw"><strong class="Latn headword" id="mwBA" lang="vec">sgnaolar</strong></p>
baxar	Verb	<p id="mwIA"><strong class="Latn headword" id="mwIQ" lang="vec">baxar</strong></p>
ónxar	Verb	<p id="mwBg"><strong class="Latn headword" id="mwBw" lang="vec">ónxar</strong></p>
bearar	Verb	<p id="mwCQ"><strong class="Latn headword" id="mwCg" lang="vec">bearar</strong></p>
cuxir	Verb	<p id="mwCA"><strong class="Latn headword" id="mwCQ" lang="vec">cuxir</strong></p>
sfexar	Verb	<p id="mwAw"><strong class="Latn headword" id="mwBA" lang="vec">sfexar</strong></p>
topar	Verb	<p id="mwbw"><strong class="Latn headword" id="mwcA" lang="vec">topar</strong></p>
invojar	Verb	<p id="mwBQ"><strong class="Latn headword" id="mwBg" lang="vec">invojar</strong></p>
finansiar	Verb	<p id="mwBQ"><strong class="Latn headword" id="mwBg" lang="vec">finansiar</strong></p>
partir	Verb	<p id="mwAWA"><strong class="Latn headword" id="mwAWE" lang="vec">partir</strong></p>
móvar	Verb	<p id="mwEQ"><strong class="Latn headword" id="mwEg" lang="vec">móvar</strong></p>
contar	Verb	<p id="mwxw"><strong class="Latn headword" id="mwyA" lang="vec">contar</strong></p>
tamixar	Verb	<p id="mwAw"><strong class="Latn headword" id="mwBA" lang="vec">tamixar</strong></p>
verto	Verb	<p id="mwcQ"><strong class="Latn headword" id="mwcg" lang="vec">verto</strong><span> </span><span class="gender"><abbr title="masculine gender">m</abbr></span><span> (</span><i>feminine singular</i><span> </span><b class="Latn" lang="vec"><a href="verta.html" title="verta">verta</a></b><span>, </span><i>masculine plural</i><span> </span><b class="Latn" lang="vec"><a href="verti.html" title="verti">verti</a></b><span>, </span><i>feminine plural</i><span> </span><b class="Latn" lang="vec"><a href="verte.html" title="verte">verte</a></b><span>)</span></p>
oxar	Verb	<p id="mwDg"><strong class="Latn headword" id="mwDw" lang="vec">oxar</strong></p>
geri	Verb	<p id="mwYQ"><strong class="Latn headword" id="mwYg" lang="vec">geri</strong></p>
nàsar	Verb	<p id="mwCw"><strong class="Latn headword" id="mwDA" lang="vec">nàsar</strong></p>
saltar	Verb	<p id="mwwA"><strong class="Latn headword" id="mwwQ" lang="vec">saltar</strong></p>
studiar	Verb	<p id="mwKA"><strong class="Latn headword" id="mwKQ" lang="vec">studiar</strong></p>
aderir	Verb	<p id="mwEg"><strong class="Latn headword" id="mwEw" lang="vec">aderir</strong></p>
consejar	Verb	<p id="mwGw"><strong class="Latn headword" id="mwHA" lang="vec">consejar</strong></p>
rancurar	Verb	<p id="mwAw"><strong class="Latn headword" id="mwBA" lang="vec">rancurar</strong></p>
covèrzar	Verb	<p id="mwGw"><strong class="Latn headword" id="mwHA" lang="vec">covèrzar</strong></p>
sbuxar	Verb	<p id="mwAw"><strong class="Latn headword" id="mwBA" lang="vec">sbuxar</strong></p>
arivar	Verb	<p id="mwKg"><strong class="Latn headword" id="mwKw" lang="vec">arivar</strong></p>
spacar	Verb	<p id="mwBQ"><strong class="Latn headword" id="mwBg" lang="vec">spacar</strong></p>
roxegar	Verb	<p id="mwCQ"><strong class="Latn headword" id="mwCg" lang="vec">roxegar</strong></p>
scriver	Verb	<p id="mwFg"><strong class="Latn headword" id="mwFw" lang="vec">scriver</strong></p>
traversar	Verb	<p id="mwCQ"><strong class="Latn headword" id="mwCg" lang="vec">traversar</strong></p>
slargar	Verb	<p id="mwBQ"><strong class="Latn headword" id="mwBg" lang="vec">slargar</strong></p>
pensar	Verb	<p id="mw1A"><strong class="Latn headword" id="mw1Q" lang="vec">pensar</strong></p>
piànxar	Verb	<p id="mwBw"><strong class="Latn headword" id="mwCA" lang="vec">piànxar</strong></p>
noar	Verb	<p id="mwSw"><strong class="Latn headword" id="mwTA" lang="vec">noar</strong></p>
òn	Verb	<p id="mwFA"><strong class="Latn headword" id="mwFQ" lang="vec">òn</strong></p>
atribuir	Verb	<p id="mwPg"><strong class="Latn headword" id="mwPw" lang="vec">atribuir</strong></p>
acreditar	Verb	<p id="mwYA"><strong class="Latn headword" id="mwYQ" lang="vec">acreditar</strong></p>
avì	Verb	<p id="mwHw"><strong class="Latn headword" id="mwIA" lang="vec">avì</strong></p>
inverinar	Verb	<p id="mwBA"><strong class="Latn headword" id="mwBQ" lang="vec">inverinar</strong></p>
mancar	Verb	<p id="mwRQ"><strong class="Latn headword" id="mwRg" lang="vec">mancar</strong></p>
postar	Verb	<p id="mwJg"><strong class="Latn headword" id="mwJw" lang="vec">postar</strong></p>
ofrir	Verb	<p id="mwIQ"><strong class="Latn headword" id="mwIg" lang="vec">ofrir</strong></p>
carezxar	Verb	<p id="mwCA"><strong class="Latn headword" id="mwCQ" lang="vec">carezxar</strong></p>
arfiar	Verb	<p id="mwBg"><strong class="Latn headword" id="mwBw" lang="vec">arfiar</strong></p>
vestir	Verb	<p id="mwkQ"><strong class="Latn headword" id="mwkg" lang="vec">vestir</strong></p>
concepir	Verb	<p id="mwBg"><strong class="Latn headword" id="mwBw" lang="vec">concepir</strong></p>
roversar	Verb	<p id="mwCg"><strong class="Latn headword" id="mwCw" lang="vec">roversar</strong></p>
sciocar	Verb	<p id="mwBQ"><strong class="Latn headword" id="mwBg" lang="vec">sciocar</strong></p>
vestirse	Verb	<p id="mwCg"><strong class="Latn headword" id="mwCw" lang="vec">vestirse</strong></p>
sbregar	Verb	<p id="mwDA"><strong class="Latn headword" id="mwDQ" lang="vec">sbregar</strong></p>
dir	Verb	<p id="mwAVE"><strong class="Latn headword" id="mwAVI" lang="vec">dir</strong></p>
svejar	Verb	<p id="mwCg"><strong class="Latn headword" id="mwCw" lang="vec">svejar</strong></p>
desgozar	Verb	<p id="mwCQ"><strong class="Latn headword" id="mwCg" lang="vec">desgozar</strong></p>
tradir	Verb	<p id="mwBw"><strong class="Latn headword" id="mwCA" lang="vec">tradir</strong></p>
segar	Verb	<p id="mwmw"><strong class="Latn headword" id="mwnA" lang="vec">segar</strong></p>
butar	Verb	<p id="mwDw"><strong class="Latn headword" id="mwEA" lang="vec">butar</strong></p>
menar	Verb	<p id="mwYA"><strong class="Latn headword" id="mwYQ" lang="vec">menar</strong></p>
smagrir	Verb	<p id="mwBw"><strong class="Latn headword" id="mwCA" lang="vec">smagrir</strong></p>
udar	Verb	<p id="mwQQ"><strong class="Latn headword" id="mwQg" lang="vec">udar</strong></p>
pónxar	Verb	<p id="mwBw"><strong class="Latn headword" id="mwCA" lang="vec">pónxar</strong></p>
sparagnar	Verb	<p id="mwBQ"><strong class="Latn headword" id="mwBg" lang="vec">sparagnar</strong></p>
montar	Verb	<p id="mwYA"><strong class="Latn headword" id="mwYQ" lang="vec">montar</strong></p>
bruscar	Verb	<p id="mwIA"><strong class="Latn headword" id="mwIQ" lang="vec">bruscar</strong></p>
tegner	Verb	<p id="mwFA"><strong class="Latn headword" id="mwFQ" lang="vec">tegner</strong></p>
sorar	Verb	<p id="mwFg"><strong class="Latn headword" id="mwFw" lang="vec">sorar</strong></p>
vałer	Verb	<p id="mwBQ"><strong class="Latn headword" id="mwBg" lang="vec">vałer</strong></p>
sentarse	Verb	<p id="mwFQ"><strong class="Latn headword" id="mwFg" lang="vec">sentarse</strong></p>
cargar	Verb	<p id="mwJg"><strong class="Latn headword" id="mwJw" lang="vec">cargar</strong></p>
rìdar	Verb	<p id="mwCw"><strong class="Latn headword" id="mwDA" lang="vec">rìdar</strong></p>
becar	Verb	<p id="mwGQ"><strong class="Latn headword" id="mwGg" lang="vec">becar</strong></p>
ascrivar	Verb	<p id="mwCA"><strong class="Latn headword" id="mwCQ" lang="vec">ascrivar</strong></p>
proclamar	Verb	<p id="mwKQ"><strong class="Latn headword" id="mwKg" lang="vec">proclamar</strong></p>
copar	Verb	<p id="mwHw"><strong class="Latn headword" id="mwIA" lang="vec">copar</strong></p>
bàtar	Verb	<p id="mwDA"><strong class="Latn headword" id="mwDQ" lang="vec">bàtar</strong></p>
parlar	Verb	<p id="mwqg"><strong class="Latn headword" id="mwqw" lang="vec">parlar</strong></p>
crédar	Verb	<p id="mwCw"><strong class="Latn headword" id="mwDA" lang="vec">crédar</strong></p>
serar	Verb	<p id="mwIQ"><strong class="Latn headword" id="mwIg" lang="vec">serar</strong></p>
gestir	Verb	<p id="mwCg"><strong class="Latn headword" id="mwCw" lang="vec">gestir</strong></p>
afitar	Verb	<p id="mwHQ"><strong class="Latn headword" id="mwHg" lang="vec">afitar</strong></p>
sfrixar	Verb	<p id="mwBQ"><strong class="Latn headword" id="mwBg" lang="vec">sfrixar</strong></p>
sałudar	Verb	<p id="mwBw"><strong class="Latn headword" id="mwCA" lang="vec">sałudar</strong></p>
danar	Verb	<p id="mwYw"><strong class="Latn headword" id="mwZA" lang="vec">danar</strong></p>
vangar	Verb	<p id="mwDA"><strong class="Latn headword" id="mwDQ" lang="vec">vangar</strong></p>
unir	Verb	<p id="mwwQ"><strong class="Latn headword" id="mwwg" lang="vec">unir</strong></p>
bravar	Verb	<p id="mwEg"><strong class="Latn headword" id="mwEw" lang="vec">bravar</strong></p>
semenar	Verb	<p id="mwGA"><strong class="Latn headword" id="mwGQ" lang="vec">semenar</strong></p>
pexar	Verb	<p id="mwCg"><strong class="Latn headword" id="mwCw" lang="vec">pexar</strong></p>
intivar	Verb	<p id="mwBQ"><strong class="Latn headword" id="mwBg" lang="vec">intivar</strong></p>
łigar	Verb	<p id="mwCg"><strong class="Latn headword" id="mwCw" lang="vec">łigar</strong></p>
magnar	Verb	<p id="mwCg"><strong class="Latn headword" id="mwCw" lang="vec">magnar</strong></p>
smorsar	Verb	<p id="mwBQ"><strong class="Latn headword" id="mwBg" lang="vec">smorsar</strong></p>
stranuar	Verb	<p id="mwBQ"><strong class="Latn headword" id="mwBg" lang="vec">stranuar</strong></p>
tetar	Verb	<p id="mwAw"><strong class="Latn headword" id="mwBA" lang="vec">tetar</strong></p>
prodùxer	Verb	<p id="mwBQ"><strong class="Latn headword" id="mwBg" lang="vec">prodùxer</strong></p>
cosołar	Verb	<p id="mwBQ"><strong class="Latn headword" id="mwBg" lang="vec">cosołar</strong></p>
bałar	Verb	<p id="mwDg"><strong class="Latn headword" id="mwDw" lang="vec">bałar</strong></p>
calcołar	Verb	<p id="mwBQ"><strong class="Latn headword" id="mwBg" lang="vec">calcołar</strong></p>
desligar	Verb	<p id="mwZg"><strong class="Latn headword" id="mwZw" lang="vec">desligar</strong></p>
spostar	Verb	<p id="mwBQ"><strong class="Latn headword" id="mwBg" lang="vec">spostar</strong></p>
suar	Verb	<p id="mwUA"><strong class="Latn headword" id="mwUQ" lang="vec">suar</strong></p>
zontar	Verb	<p id="mwBQ"><strong class="Latn headword" id="mwBg" lang="vec">zontar</strong></p>
costar	Verb	<p id="mwjg"><strong class="Latn headword" id="mwjw" lang="vec">costar</strong></p>
tor	Verb	<p id="mwAio"><strong class="Latn headword" id="mwAis" lang="vec">tor</strong></p>
sugar	Verb	<p id="mwAdc"><strong class="Latn headword" id="mwAdg" lang="vec">sugar</strong></p>
anoverar	Verb	<p id="mwBQ"><strong class="Latn headword" id="mwBg" lang="vec">anoverar</strong></p>
influensar	Verb	<p id="mwBQ"><strong class="Latn headword" id="mwBg" lang="vec">influensar</strong></p>
bojir	Verb	<p id="mwEQ"><strong class="Latn headword" id="mwEg" lang="vec">bojir</strong></p>
sguaratar	Verb	<p id="mwBg"><strong class="Latn headword" id="mwBw" lang="vec">sguaratar</strong></p>
colpir	Verb	<p id="mwDQ"><strong class="Latn headword" id="mwDg" lang="vec">colpir</strong></p>
abitar	Verb	<p id="mwBg"><strong class="Latn headword" id="mwBw" lang="vec">abitar</strong></p>
catar	Verb	<p id="mw5w"><strong class="Latn headword" id="mw6A" lang="vec">catar</strong></p>
supiar	Verb	<p id="mwBw"><strong class="Latn headword" id="mwCA" lang="vec">supiar</strong></p>
vèrzar	Verb	<p id="mwGA"><strong class="Latn headword" id="mwGQ" lang="vec">vèrzar</strong></p>
riciamar	Verb	<p id="mwBQ"><strong class="Latn headword" id="mwBg" lang="vec">riciamar</strong></p>
siełier	Verb	<p id="mwDA"><strong class="Latn headword" id="mwDQ" lang="vec">siełier</strong></p>
piantar	Verb	<p id="mwFw"><strong class="Latn headword" id="mwGA" lang="vec">piantar</strong></p>
raxónxer	Verb	<p id="mwAw"><strong class="Latn headword" id="mwBA" lang="vec">raxónxer</strong></p>
svodar	Verb	<p id="mwBQ"><strong class="Latn headword" id="mwBg" lang="vec">svodar</strong></p>
urtar	Verb	<p id="mwBA"><strong class="Latn headword" id="mwBQ" lang="vec">urtar</strong></p>
amar	Verb	<p id="mwAiM"><strong class="Latn headword" id="mwAiQ" lang="vec">amar</strong></p>
ałestir	Verb	<p id="mwBQ"><strong class="Latn headword" id="mwBg" lang="vec">ałestir</strong></p>
maciar	Verb	<p id="mwCA"><strong class="Latn headword" id="mwCQ" lang="vec">maciar</strong></p>
abi	Verb	<p id="mwAT4"><strong class="Latn headword" id="mwAT8" lang="vec">abi</strong></p>
vìvar	Verb	<p id="mwCg"><strong class="Latn headword" id="mwCw" lang="vec">vìvar</strong></p>
temer	Verb	<p id="mwqw"><strong class="Latn headword" id="mwrA" lang="vec">temer</strong></p>
vardar	Verb	<p id="mwDQ"><strong class="Latn headword" id="mwDg" lang="vec">vardar</strong></p>
nominar	Verb	<p id="mwOA"><strong class="Latn headword" id="mwOQ" lang="vec">nominar</strong></p>
bevarar	Verb	<p id="mwEA"><strong class="Latn headword" id="mwEQ" lang="vec">bevarar</strong></p>
testimoniar	Verb	<p id="mwEw"><strong class="Latn headword" id="mwFA" lang="vec">testimoniar</strong></p>
èssere	Verb	<p id="mwyg"><strong class="Latn headword" id="mwyw" lang="vec">èssere</strong></p>
jutar	Verb	<p id="mwFg"><strong class="Latn headword" id="mwFw" lang="vec">jutar</strong></p>
slùxar	Verb	<p id="mwAw"><strong class="Latn headword" id="mwBA" lang="vec">slùxar</strong></p>
finir	Verb	<p id="mwzw"><strong class="Latn headword" id="mw0A" lang="vec">finir</strong></p>
sofegar	Verb	<p id="mwBw"><strong class="Latn headword" id="mwCA" lang="vec">sofegar</strong></p>
rumegar	Verb	<p id="mwBQ"><strong class="Latn headword" id="mwBg" lang="vec">rumegar</strong></p>
véder	Verb	<p id="mwFg"><strong class="Latn headword" id="mwFw" lang="vec">véder</strong></p>
vixitar	Verb	<p id="mwCA"><strong class="Latn headword" id="mwCQ" lang="vec">vixitar</strong></p>
vernixar	Verb	<p id="mwCA"><strong class="Latn headword" id="mwCQ" lang="vec">vernixar</strong></p>
sonar	Verb	<p id="mwww"><strong class="Latn headword" id="mwxA" lang="vec">sonar</strong></p>
ciamar	Verb	<p id="mwEg"><strong class="Latn headword" id="mwEw" lang="vec">ciamar</strong></p>
spedir	Verb	<p id="mwBw"><strong class="Latn headword" id="mwCA" lang="vec">spedir</strong></p>
intrigar	Verb	<p id="mwOw"><strong class="Latn headword" id="mwPA" lang="vec">intrigar</strong></p>
ricordar	Verb	<p id="mwBw"><strong class="Latn headword" id="mwCA" lang="vec">ricordar</strong></p>
spoxar	Verb	<p id="mwBg"><strong class="Latn headword" id="mwBw" lang="vec">spoxar</strong></p>
confrontar	Verb	<p id="mwIA"><strong class="Latn headword" id="mwIQ" lang="vec">confrontar</strong></p>
łimar	Verb	<p id="mwBQ"><strong class="Latn headword" id="mwBg" lang="vec">łimar</strong></p>
sgropar	Verb	<p id="mwBQ"><strong class="Latn headword" id="mwBg" lang="vec">sgropar</strong></p>
sostituir	Verb	<p id="mwBg"><strong class="Latn headword" id="mwBw" lang="vec">sostituir</strong></p>
strénxar	Verb	<p id="mwBg"><strong class="Latn headword" id="mwBw" lang="vec">strénxar</strong></p>
fondar	Verb	<p id="mwJg"><strong class="Latn headword" id="mwJw" lang="vec">fondar</strong></p>
sgnacar	Verb	<p id="mwAw"><strong class="Latn headword" id="mwBA" lang="vec">sgnacar</strong></p>
voxar	Verb	<p id="mwBA"><strong class="Latn headword" id="mwBQ" lang="vec">voxar</strong></p>
xe	Verb	<p id="mwnA"><strong class="Latn headword" id="mwnQ" lang="vec">xe</strong></p>
macar	Verb	<p id="mwBg"><strong class="Latn headword" id="mwBw" lang="vec">macar</strong></p>
spuar	Verb	<p id="mwFw"><strong class="Latn headword" id="mwGA" lang="vec">spuar</strong></p>
caminar	Verb	<p id="mwbw"><strong class="Latn headword" id="mwcA" lang="vec">caminar</strong></p>
obligar	Verb	<p id="mwMg"><strong class="Latn headword" id="mwMw" lang="vec">obligar</strong></p>
entrar	Verb	<p id="mwew"><strong class="Latn headword" id="mwfA" lang="vec">entrar</strong></p>
realisar	Verb	<p id="mwCA"><strong class="Latn headword" id="mwCQ" lang="vec">realisar</strong></p>
scuminsiar	Verb	<p id="mwEw"><strong class="Latn headword" id="mwFA" lang="vec">scuminsiar</strong></p>
meritar	Verb	<p id="mwLg"><strong class="Latn headword" id="mwLw" lang="vec">meritar</strong></p>
dormir	Verb	<p id="mwAQg"><strong class="Latn headword" id="mwAQk" lang="vec">dormir</strong></p>
restar	Verb	<p id="mwhg"><strong class="Latn headword" id="mwhw" lang="vec">restar</strong></p>
rónpar	Verb	<p id="mwBw"><strong class="Latn headword" id="mwCA" lang="vec">rónpar</strong></p>
sarar	Verb	<p id="mwRQ"><strong class="Latn headword" id="mwRg" lang="vec">sarar</strong></p>
strabucar	Verb	<p id="mwBg"><strong class="Latn headword" id="mwBw" lang="vec">strabucar</strong></p>
supiàr	Verb	<p id="mwCQ"><strong class="Latn headword" id="mwCg" lang="vec">supiàr</strong></p>
spoliar	Verb	<p id="mwCw"><strong class="Latn headword" id="mwDA" lang="vec">spoliar</strong></p>
tocar	Verb	<p id="mwARc"><strong class="Latn headword" id="mwARg" lang="vec">tocar</strong></p>
strupiar	Verb	<p id="mwCA"><strong class="Latn headword" id="mwCQ" lang="vec">strupiar</strong></p>
portar	Verb	<p id="mw9g"><strong class="Latn headword" id="mw9w" lang="vec">portar</strong></p>
inaugurar	Verb	<p id="mwNw"><strong class="Latn headword" id="mwOA" lang="vec">inaugurar</strong></p>
ciuciar	Verb	<p id="mwBA"><strong class="Latn headword" id="mwBQ" lang="vec">ciuciar</strong></p>
pasar	Verb	<p id="mw-g"><strong class="Latn headword" id="mw-w" lang="vec">pasar</strong></p>
cavar	Verb	<p id="mwYw"><strong class="Latn headword" id="mwZA" lang="vec">cavar</strong></p>
votar	Verb	<p id="mwrA"><strong class="Latn headword" id="mwrQ" lang="vec">votar</strong></p>
robar	Verb	<p id="mwPQ"><strong class="Latn headword" id="mwPg" lang="vec">robar</strong></p>
remar	Verb	<p id="mwXA"><strong class="Latn headword" id="mwXQ" lang="vec">remar</strong></p>
