ξεψυχώ	Verb	ξεψυχώ • (xepsychó) (simple past ξεψύχησα)
βαστάζω	Verb	βαστάζω • (vastázo) (simple past βάσταξα or βάστηξα, passive form βαστάζομαι)
αλευρώνομαι	Verb	αλευρώνομαι • (alevrónomai) (simple past αλευρώθηκα, active form αλευρώνω, passive)
διακόπτω	Verb	διακόπτω • (diakópto) (simple past διέκοψα, passive form διακόπτομαι)
αγορεύω	Verb	αγορεύω • (agorévo) (simple past αγόρευσα)
ξανασυναντιέμαι	Verb	ξανασυναντιέμαι • (xanasynantiémai) (simple past ξανασυναντήθηκα, active form ξανασυναντώ, passive)
ερμηνεύω	Verb	ερμηνεύω • (erminévo) (simple past ερμήνευσα)
αλησμονάω	Verb	αλησμονάω • (alismonáo) (simple past αλησμόνησα)
ξυρίζομαι	Verb	ξυρίζομαι • (xyrízomai) (simple past ξυρίστηκα, active form ξυρίζω, passive)
καρατομώ	Verb	καρατομώ • (karatomó) (simple past καρατόμησα, passive form καρατομούμαι)
απελαύνω	Verb	απελαύνω • (apelávno) (simple past απέλασα or απήλασα, passive form απελαύνομαι)
χέζω	Verb	χέζω • (chézo) (simple past έχεσα, passive form χέζομαι)
επιδρώ	Verb	επιδρώ • (epidró) (simple past επέδρασα, passive form —)
αναζητιέμαι	Verb	αναζητιέμαι • (anazitiémai) (simple past αναζητήθηκα, active form αναζητώ, passive)
στολίζω	Verb	στολίζω • (stolízo) (simple past στόλισα, passive form στολίζομαι)
κατασκηνώνω	Verb	κατασκηνώνω • (kataskinóno) (simple past κατασκήνωσα)
κλαδεύω	Verb	κλαδεύω • (kladévo) (simple past κλάδεψα)
γδέρνομαι	Verb	γδέρνομαι • (gdérnomai) (simple past γδάρθηκα, active form γδέρνω, passive)
διπλασιάζομαι	Verb	διπλασιάζομαι • (diplasiázomai) (simple past διπλασιάστηκα, active form διπλασιάζω, passive)
αδικώ	Verb	αδικώ • (adikó) (simple past αδίκησα, passive form αδικούμαι or αδικιέμαι)
αβαντζάρω	Verb	αβαντζάρω • (avantzáro) (simple past αβαντζάρισα)
διαιρώ	Verb	διαιρώ • (diairó) (simple past διαίρεσα, passive form διαιρούμαι)
κολλώ	Verb	κολλώ • (kolló) (simple past κόλλησα, passive form κολλιέμαι)
σβήνω	Verb	σβήνω • (svíno) (simple past έσβησα, passive form σβήνομαι)
ερευνάω	Verb	ερευνάω • (erevnáo) (simple past ερεύνησα)
αγριοκοιτώ	Verb	αγριοκοιτώ • (agriokoitó) (simple past αγριοκοίταξα)
αηδονολαλώ	Verb	αηδονολαλώ • (aidonolaló) (simple past αηδονολάλησα)
'γγίζω	Verb	'γγίζω • ('ngízo) (simple past 'γγιξα)
παθαίνω	Verb	παθαίνω • (pathaíno) (simple past έπαθα, passive form παθαίνομαι)
ξεπερνάω	Verb	ξεπερνάω • (xepernáo) (simple past ξεπέρασα)
κινώ	Verb	κινώ • (kinó) (simple past κίνησα, passive form κινούμαι)
υπονοώ	Verb	υπονοώ • (yponoó) (simple past υπονόησα)
ακλουθώ	Verb	ακλουθώ • (aklouthó) (simple past ακλούθησα)
αναγνωρίζω	Verb	αναγνωρίζω • (anagnorízo) (simple past αναγνώρισα, passive form αναγνωρίζομαι)
φρενάρω	Verb	φρενάρω • (frenáro) (simple past φρέναρα or φρενάρισα)
νιαουρίζω	Verb	νιαουρίζω • (niaourízo) (simple past νιαούρισα)
χαιρετάω	Verb	χαιρετάω • (chairetáo) (simple past χαιρέτησα)
αλεγράρω	Verb	αλεγράρω • (alegráro) (simple past αλεγράρισα)
λυγίζω	Verb	λυγίζω • (lygízo) (simple past λύγισα)
μαντάρω	Verb	μαντάρω • (mantáro) (simple past μάνταρισα, passive form μαντάρομαι)
αδικιέμαι	Verb	αδικιέμαι • (adikiémai) (simple past αδικήθηκα, active form αδικώ, passive)
αμαρτάνω	Verb	αμαρτάνω • (amartáno) (simple past αμάρτησα, passive form —)
πληρώνομαι	Verb	πληρώνομαι • (plirónomai) (simple past πληρώθηκα, active form πληρώνω, passive)
κρεμώ	Verb	κρεμώ • (kremó) (simple past κρέμασα, passive form κρεμιέμαι)
στενοχωρούμαι	Verb	στενοχωρούμαι • (stenochoroúmai) (simple past στενοχωρήθηκα, active form στενοχωρώ, mediopassive)
αλείφω	Verb	αλείφω • (aleífo) (simple past άλειψα, passive form αλείφομαι, active)
διώκω	Verb	διώκω • (dióko) (simple past δίωξα, passive form διώκομαι)
ανακλώμαι	Verb	ανακλώμαι • (anaklómai) (simple past ανακλάστηκα, active form ανακλώ, passive)
βαρώ	Verb	βαρώ • (varó) (simple past βάρεσα, passive form —)
μπορώ	Verb	μπορώ • (boró) (simple past μπόρεσα)
ανανεώνομαι	Verb	ανανεώνομαι • (ananeónomai) (simple past ανανεώθηκα, active form ανανεώνω, passive)
αγιάζομαι	Verb	αγιάζομαι • (agiázomai) (simple past αγιάστηκα, active form αγιάζω, passive)
βοσκάω	Verb	βοσκάω • (voskáo) (simple past βόσκησα, passive form βοσκιέμαι)
ζαρώνω	Verb	ζαρώνω • (zaróno) (simple past ζάρωσα, passive form —)
προσπαθώ	Verb	προσπαθώ • (prospathó) (simple past προσπάθησα)
φιλοξενούμαι	Verb	φιλοξενούμαι • (filoxenoúmai) (simple past φιλοξενήθηκα, active form φιλοξενώ, passive)
παρακάμπτομαι	Verb	παρακάμπτομαι • (parakámptomai) (simple past παρακάμφθηκα, active form παρακάμπτω, passive)
εμβολίζω	Verb	εμβολίζω • (emvolízo) (simple past εμβόλισα, passive form εμβολίζομαι)
αποφασίζω	Verb	αποφασίζω • (apofasízo) (simple past αποφάσισα, passive form αποφασίζομαι)
σχεδιάζω	Verb	σχεδιάζω • (schediázo) (simple past σχεδίασα)
τραβώ	Verb	τραβώ • (travó) (simple past τράβηξα, passive form τραβιέμαι)
προτιμιέμαι	Verb	προτιμιέμαι • (protimiémai) (simple past προτιμήθηκα, active form προτιμώ, passive)
εξολοθρεύω	Verb	εξολοθρεύω • (exolothrévo) (simple past εξολόθρευσα or εξολόθρεψα, passive form εξολοθρεύομαι)
διατρέφω	Verb	διατρέφω • (diatréfo) (simple past διέθρεψα)
παίρνομαι	Verb	παίρνομαι • (paírnomai) (simple past πάρθηκα, active form παίρνω, passive)
αποβιβάζω	Verb	αποβιβάζω • (apovivázo) (simple past αποβίβασα, passive form αποβιβάζομαι)
ζηλεύομαι	Verb	ζηλεύομαι • (zilévomai) (simple past ζηλεύτηκα, active form ζηλεύω, passive)
προωθώ	Verb	προωθώ • (proothó) (simple past προώθησα, passive form προωθούμαι)
ξεχειλίζω	Verb	ξεχειλίζω • (xecheilízo) (simple past ξεχείλισα)
χορεύομαι	Verb	χορεύομαι • (chorévomai) (simple past —, active form χορεύω, found only in the imperfective tenses, passive)
ξενυχτώ	Verb	ξενυχτώ • (xenychtó) (simple past ξενύκτησα, passive form —)
αναπαριστάνω	Verb	αναπαριστάνω • (anaparistáno) (simple past αναπαρέστησα, passive form αναπαριστάνομαι)
πετιέμαι	Verb	πετιέμαι • (petiémai) (simple past πετάχτηκα, active form πετάω, passive)
συνεχίζομαι	Verb	συνεχίζομαι • (synechízomai) (simple past συνεχίστηκα, active form συνεχίζω, passive)
αμαυρώνω	Verb	αμαυρώνω • (amavróno) (simple past αμαύρωσα, passive form αμαυρώνομαι)
αντικατασταίνω	Verb	αντικατασταίνω • (antikatastaíno) (simple past αντικατέστησα or αντικατάστησα)
αρκώ	Verb	αρκώ • (arkó) (simple past άρκεσα, passive form αρκούμαι)
λογοκρίνω	Verb	λογοκρίνω • (logokríno) (simple past λογόκρινα, passive form λογοκρίνομαι)
δακτυλογραφώ	Verb	δακτυλογραφώ • (daktylografó) (simple past δακτυλογράφησα, passive form δακτυλογραφούμαι)
απαγάγω	Verb	απαγάγω • (apagágo) (simple past απήγαγα)
χαραμίζομαι	Verb	χαραμίζομαι • (charamízomai) (simple past χαραμίστηκα, active form χαραμίζω, passive)
διευθύνω	Verb	διευθύνω • (diefthýno) (simple past διηύθυνα or διεύθυνα, passive form διευθύνομαι)
διαπερνάω	Verb	διαπερνάω • (diapernáo) (simple past διαπέρασα)
απαντώ	Verb	απαντώ • (apantó) (simple past απάντησα, passive form απαντιέμαι or απαντώμαι)
συντομεύω	Verb	συντομεύω • (syntomévo) (simple past συντόμευσα or συντόμεψα, passive form συντομέυομαι)
αγοράζω	Verb	αγοράζω • (agorázo) (simple past αγόρασα, passive form αγοράζομαι)
διευκρινίζω	Verb	διευκρινίζω • (diefkrinízo) (simple past διευκρίνισα, passive form διευκρινίζομαι)
ενώνομαι	Verb	ενώνομαι • (enónomai) (simple past ενώθηκα, active form ενώνω, passive)
υπερφορτώνω	Verb	υπερφορτώνω • (yperfortóno) (simple past υπερφόρτωσα, passive form υπερφορτώνομαι)
καβουρδίζομαι	Verb	καβουρδίζομαι • (kavourdízomai) (simple past καβουρδίστηκα, active form καβουρδίζω, passive)
αφυδατώνω	Verb	αφυδατώνω • (afydatóno) (simple past αφυδάτωσα, passive form αφυδατώνομαι)
ξεσκονίζω	Verb	ξεσκονίζω • (xeskonízo) (simple past ξεσκόνισα)
αποστειρώνομαι	Verb	αποστειρώνομαι • (aposteirónomai) (simple past αποστειρώθηκα, active form αποστειρώνω, passive)
αισιοδοξώ	Verb	αισιοδοξώ • (aisiodoxó) (found only in the present and imperfect tenses)
χάβω	Verb	χάβω • (chávo) (simple past έχαψα)
καταπολεμούμαι	Verb	καταπολεμούμαι • (katapolemoúmai) (simple past καταπολεμήθηκα, active form καταπολεμώ, passive)
κομίζω	Verb	κομίζω • (komízo) (simple past κόμισα)
εμπορεύομαι	Verb	εμπορεύομαι • (emporévomai) (simple past εμπορεύτηκα, deponent)
εξηγώ	Verb	εξηγώ • (exigó) (simple past εξήγησα, passive form εξηγούμαι)
φροντίζω	Verb	φροντίζω • (frontízo) (simple past φρόντισα, passive form —)
αλυσώνω	Verb	αλυσώνω • (alysóno) (simple past αλύσωσα)
αβασκαίνω	Verb	αβασκαίνω • (avaskaíno) (simple past βάσκανα or αβάσκανα)
αλέθω	Verb	αλέθω • (alétho) (simple past άλεσα, passive form αλέθομαι)
φοβούμαι	Verb	φοβούμαι • (fovoúmai) (simple past φοβήθηκα, deponent)
ψάλλομαι	Verb	ψάλλομαι • (psállomai) (simple past —, active form ψάλλω, passive)
ακινητοποιώ	Verb	ακινητοποιώ • (akinitopoió) (simple past ακινητοποίησα, passive form ακινητοποιούμαι)
αλληλεπιδρώ	Verb	αλληλεπιδρώ • (allilepidró) (simple past αλληλεπίδρασα)
εμποδίζω	Verb	εμποδίζω • (empodízo) (simple past εμπόδισα, passive form εμποδίζομαι)
παραγγέλλομαι	Verb	παραγγέλλομαι • (parangéllomai) (simple past παραγγέλθηκα, active form παραγγέλλω, passive)
γρικιέμαι	Verb	γρικιέμαι • (grikiémai) (simple past γρικήθηκα, active form γρικώ, passive)
παρακοιμούμαι	Verb	παρακοιμούμαι • (parakoimoúmai) (simple past παρακοιμήθηκα, deponent)
ζητάω	Verb	ζητάω • (zitáo) (simple past ζήτησα, passive form ζητούμαι or ζητιέμαι)
παρκάρω	Verb	παρκάρω • (parkáro) (simple past πάρκαρα or παρκάρισα, passive form παρκάρομαι)
κοινωνικοποιώ	Verb	κοινωνικοποιώ • (koinonikopoió) (simple past κοινωνικοποίησa)
ξαγναντεύω	Verb	ξαγναντεύω • (xagnantévo) (simple past ξαγνάντεψα)
διασκεδάζομαι	Verb	διασκεδάζομαι • (diaskedázomai) (simple past διασκεδάστηκα, active form διασκεδάζω, passive)
διοχετεύω	Verb	διοχετεύω • (diochetévo) (simple past διοχέτευσα)
μεταδίδω	Verb	μεταδίδω • (metadído) (simple past μετέδωσα, passive form μεταδόδομαι)
τραγανίζω	Verb	τραγανίζω • (traganízo) (simple past τραγάνισα, passive form —)
κτίζομαι	Verb	κτίζομαι • (ktízomai) (simple past κτίστηκα, active form κτίζω, passive)
αγκωνιάζομαι	Verb	αγκωνιάζομαι • (agkoniázomai) (simple past αγκωνιάστηκα, active form αγκωνιάζω, passive)
αντηχώ	Verb	αντηχώ • (antichó) (simple past αντήχησα)
ασχολιέμαι	Verb	ασχολιέμαι • (ascholiémai) (simple past ασχολήθηκα, deponent)
ξυπνάω	Verb	ξυπνάω • (xypnáo) (simple past ξύπνησα)
τσιμπουκώνω	Verb	τσιμπουκώνω • (tsimpoukóno) (simple past τσιμπούκωσα, passive form τσιμπουκώνομαι)
προστατεύομαι	Verb	προστατεύομαι • (prostatévomai) (simple past προστατεύτηκα, active form προστατεύω, passive)
εγγράφω	Verb	εγγράφω • (engráfo) (simple past ενέγραψα)
ψηφίζω	Verb	ψηφίζω • (psifízo) (simple past ψήφισα)
εκτιμώ	Verb	εκτιμώ • (ektimó) (simple past εκτίμησα, passive form εκτιμώμαι)
μειώνω	Verb	μειώνω • (meióno) (simple past μείωσα, passive form μειώνομαι)
προβλέπω	Verb	προβλέπω • (provlépo) (simple past πρόβλεψα or προέβλεψα, passive form προβλέπομαι)
κουνιέμαι	Verb	κουνιέμαι • (kouniémai) (simple past κουνήθηκα, active form κουνώ, mediopassive)
ουσιαστικοποιώ	Verb	ουσιαστικοποιώ • (ousiastikopoió) (simple past ουσιαστικοποίησα, passive form ουσιαστικοποιούμαι)
ρεζιλεύω	Verb	ρεζιλεύω • (rezilévo) (simple past ρεζίλεψα, passive form ρεζιλεύομαι)
καβαλιέμαι	Verb	καβαλιέμαι • (kavaliémai) (simple past καβαλήθηκα, active form καβαλάω, passive)
ελευθερώνω	Verb	ελευθερώνω • (eleftheróno) (simple past ελευθέρωσα)
διασχίζω	Verb	διασχίζω • (diaschízo) (simple past διέσχισα)
ανάβομαι	Verb	ανάβομαι • (anávomai) (simple past ανάφτηκα, active form ανάβω, passive)
ήταν	Verb	ήταν • (ítan)
πλήττω	Verb	πλήττω • (plítto) (simple past έπληξα, passive form πλήττομαι)
δεσπόζω	Verb	δεσπόζω • (despózo) (simple past δέσποσα)
στοιχίζω	Verb	στοιχίζω • (stoichízo) (simple past στοίχισα, passive form —)
εξηγούμαι	Verb	εξηγούμαι • (exigoúmai) (simple past εξηγήθηκα, active form εξηγώ, passive)
αποχαιρετιέμαι	Verb	αποχαιρετιέμαι • (apochairetiémai) (simple past αποχαιρετήθηκα, active form αποχαιρετώ, passive)
αγουροξυπνώ	Verb	αγουροξυπνώ • (agouroxypnó) (simple past αγουροξύπνησα)
παραγγέλνω	Verb	παραγγέλνω • (parangélno) (simple past παρήγγειλα or παράγγειλα, passive form παραγγέλλομαι)
χαιρετιέμαι	Verb	χαιρετιέμαι • (chairetiémai) (simple past χαιρετήθηκα, active form χαιρετώ, passive)
καταλαμβάνω	Verb	καταλαμβάνω • (katalamváno) (simple past κατέλαβα, passive form καταλαμβάνομαι)
προσκαλούμαι	Verb	προσκαλούμαι • (proskaloúmai) (simple past προσκλήθηκα, active form προσκαλώ, passive)
χορεύω	Verb	χορεύω • (chorévo) (simple past χόρεψα, passive form χορεύομαι)
κατοικώ	Verb	κατοικώ • (katoikó) (simple past κατοίκησα, passive form κατοικούμαι)
λιγοστεύω	Verb	λιγοστεύω • (ligostévo) (simple past λιγόστεψα)
αμβλύνω	Verb	αμβλύνω • (amvlýno) (simple past άμβλυνα, passive form αμβλύνομαι)
ονειροπολώ	Verb	ονειροπολώ • (oneiropoló) (simple past ονειροπόλησα)
λυπάμαι	Verb	λυπάμαι • (lypámai) (simple past λυπήθηκα, active form λυπώ, passive)
ματοκυλίζομαι	Verb	ματοκυλίζομαι • (matokylízomai) (simple past ματοκυλίστηκα, active form ματοκυλίζω, passive)
αναχαιτίζω	Verb	αναχαιτίζω • (anachaitízo) (simple past αναχαίτισα, passive form αναχαιτίζομαι)
σκίζομαι	Verb	σκίζομαι • (skízomai) (simple past σκίστηκα, active form σκίζω, passive)
πωλώ	Verb	πωλώ • (poló) (simple past πώλησα, passive form πωλούμαι)
αναλώνομαι	Verb	αναλώνομαι • (analónomai) (simple past αναλώθηκα, active form αναλώνω, passive)
αναπηδάω	Verb	αναπηδάω • (anapidáo) (simple past αναπήδησα)
ιδρώνω	Verb	ιδρώνω • (idróno) (simple past ίδρωσα)
λύνω	Verb	λύνω • (lýno) (simple past έλυσα, passive form λύνομαι)
διακόπτομαι	Verb	διακόπτομαι • (diakóptomai) (simple past διακόπηκα, active form διακόπτω, passive)
προγραμματίζω	Verb	προγραμματίζω • (programmatízo) (simple past προγραμμάτισα, passive form προγραμματίζομαι)
διατηρούμαι	Verb	διατηρούμαι • (diatiroúmai) (simple past διατηρήθηκα, active form διατηρώ, passive)
παραλαμβάνω	Verb	παραλαμβάνω • (paralamváno) (simple past παρέλαβα, passive form παραλαμβάνομαι)
αποκοιμιέμαι	Verb	αποκοιμιέμαι • (apokoimiémai) (simple past αποκοιμήθηκα, active form αποκοιμίζω, passive)
αγαλλιάζω	Verb	αγαλλιάζω • (agalliázo) (simple past αγαλλίασα, passive form αγάλλομαι)
αποκαλύπτω	Verb	αποκαλύπτω • (apokalýpto) (simple past αποκάλυψα, passive form αποκαλύπτομαι)
διαλέγομαι	Verb	διαλέγομαι • (dialégomai) (simple past διαλέχτηκα, active form διαλέγω, passive)
διαλέγομαι	Verb	διαλέγομαι • (dialégomai) (simple past διαλέχτηκα, deponent)
αποσβένω	Verb	αποσβένω • (aposvéno) (simple past απόσβεσα, passive form αποσβένομαι)
τραγουδώ	Verb	τραγουδώ • (tragoudó) (simple past τραγούδησα, passive form τραγουδιέμαι)
αναφέρω	Verb	αναφέρω • (anaféro) (simple past ανέφερα, passive form αναφέρομαι)
σαπουνίζω	Verb	σαπουνίζω • (sapounízo) (simple past σαπούνισα)
επαναλαμβάνομαι	Verb	επαναλαμβάνομαι • (epanalamvánomai) (simple past επαναλήφθηκα, active form επαναλαμβάνω, passive)
παρακούω	Verb	παρακούω • (parakoúo) (simple past παράκουσα)
αποσιωπώ	Verb	αποσιωπώ • (aposiopó) (simple past αποσιώπησα, passive form αποσιωπώμαι)
σαλτάρω	Verb	σαλτάρω • (saltáro) (simple past σάλταρα or σαλτάρισα)
αντιμεταθέτω	Verb	αντιμεταθέτω • (antimetathéto) (simple past αντιμετέθεσα)
αποτελειώνω	Verb	αποτελειώνω • (apoteleióno) (simple past αποτελείωσα or αποτέλειωσα)
αποκωδικοποιώ	Verb	αποκωδικοποιώ • (apokodikopoió) (simple past αποκωδικοποίησα)
έχουμε	Verb	έχουμε • (échoume)
πληρώνω	Verb	πληρώνω • (pliróno) (simple past πλήρωσα, passive form πληρώνομαι)
χλομιάζω	Verb	χλομιάζω • (chlomiázo) (simple past χλώμιασα)
ακινητώ	Verb	ακινητώ • (akinitó) (simple past ακινήτησα)
υπολογίζω	Verb	υπολογίζω • (ypologízo) (simple past υπολόγισα)
απανθρακώνω	Verb	απανθρακώνω • (apanthrakóno) (simple past απανθράκωσα)
ξεσκεπάζω	Verb	ξεσκεπάζω • (xeskepázo) (simple past ξεσκέπασα)
ανεβάζω	Verb	ανεβάζω • (anevázo) (simple past ανέβασα)
απομυζώ	Verb	απομυζώ • (apomyzó) (simple past απομύζησα)
κουρεύομαι	Verb	κουρεύομαι • (kourévomai) (simple past κουρεύτηκα, active form κουρεύω, passive)
βοσκιέμαι	Verb	βοσκιέμαι • (voskiémai) (simple past βοσκήθηκα, active form βοσκώ, passive)
αιμορραγώ	Verb	αιμορραγώ • (aimorragó) (simple past αιμορράγησα)
θα είσαστε	Verb	θα είσαστε • (tha eísaste) (tha eísaste)
παραιτούμαι	Verb	παραιτούμαι • (paraitoúmai) (simple past παραιτήθηκα, deponent)
παρουσιάζω	Verb	παρουσιάζω • (parousiázo) (simple past παρουσίασα, passive form παρουσιάζομαι)
γκρινιάζω	Verb	γκρινιάζω • (gkriniázo) (simple past γκρίνιαξα, passive form —)
κατηγορώ	Verb	κατηγορώ • (katigoró) (simple past κατηγόρησα, passive form κατηγορούμαι)
διαλέγω	Verb	διαλέγω • (dialégo) (simple past διάλεξα, passive form διαλέγομαι)
σκεπάζω	Verb	σκεπάζω • (skepázo) (simple past σκέπασα, passive form σκεπάζομαι)
τσουγκρανίζω	Verb	τσουγκρανίζω • (tsougkranízo) (simple past τσουγκράνισα)
σπαράζομαι	Verb	σπαράζομαι • (sparázomai) (simple past σπαράχτηκα, active form σπαράζω, passive)
πασπατεύω	Verb	πασπατεύω • (paspatévo) (simple past πασπάτεψα)
αξιώ	Verb	αξιώ • (axió) (simple past αξίωσα)
αμείβομαι	Verb	αμείβομαι • (ameívomai) (simple past αμείφτηκα or αμείφθηκα, active form αμείβω, passive)
βαδίζω	Verb	βαδίζω • (vadízo) (simple past βάδισα)
ήσαστε	Verb	ήσαστε • (ísaste)
νικώ	Verb	νικώ • (nikó) (simple past νίκησα, passive form νικιέμαι)
διασκεδάζω	Verb	διασκεδάζω • (diaskedázo) (simple past διασκέδασα, passive form διασκεδάζομαι)
κλίνομαι	Verb	κλίνομαι • (klínomai) (simple past κλίθηκα, active form κλίνω, passive)
απουσιάζω	Verb	απουσιάζω • (apousiázo) (simple past απουσίασα)
προωθούμαι	Verb	προωθούμαι • (proothoúmai) (simple past προωθήθηκα, active form προωθώ, passive)
ακτινογραφώ	Verb	ακτινογραφώ • (aktinografó) (simple past ακτινογράφησα)
μεταφράζομαι	Verb	μεταφράζομαι • (metafrázomai) (simple past μεταφράστηκα, active form μεταφράζω, passive)
συγκεντρώνομαι	Verb	συγκεντρώνομαι • (sygkentrónomai) (simple past συγκεντρώθηκα, active form συγκεντρώνω, passive)
παρακολουθούμαι	Verb	παρακολουθούμαι • (parakolouthoúmai) (simple past παρακολουθήθηκα, active form παρακολουθώ, passive)
παράγω	Verb	παράγω • (parágo) (simple past παρήγαγα, passive form παράγομαι)
αναφωνώ	Verb	αναφωνώ • (anafonó) (simple past αναφώνησα)
συνεργάζομαι	Verb	συνεργάζομαι • (synergázomai) (simple past συνεργάστηκα, deponent)
αποκρύβω	Verb	αποκρύβω • (apokrývo) (simple past απέκρυψα or απόκρυψα)
εξορίζω	Verb	εξορίζω • (exorízo) (simple past εξόρισα)
τιμώ	Verb	τιμώ • (timó) (simple past τίμησα, passive form τιμώμαι)
δελεάζομαι	Verb	δελεάζομαι • (deleázomai) (simple past δελεάστηκα, active form δελεάζω, passive)
τιμάω	Verb	τιμάω • (timáo) (simple past τίμησα, passive form τιμώμαι)
βαλσαμώθηκα	Verb	βαλσαμώθηκα • (valsamóthika)
αναστέλλω	Verb	αναστέλλω • (anastéllo) (simple past ανέστειλα, passive form αναστέλλομαι)
ήσουν	Verb	ήσουν • (ísoun)
μεστώνω	Verb	μεστώνω • (mestóno) (simple past μέστωσα)
παραμερίζω	Verb	παραμερίζω • (paramerízo) (simple past παραμέρισα, passive form παραμερίζομαι)
λησμονώ	Verb	λησμονώ • (lismonó) (simple past λησμόνησα, passive form λησμονούμαι)
ψέλνω	Verb	ψέλνω • (psélno) (simple past έψαλα, passive form ψέλνομαι)
ακροβολίζομαι	Verb	ακροβολίζομαι • (akrovolízomai) (simple past ακροβολίστηκα, deponent)
τείνω	Verb	τείνω • (teíno) (simple past έτεινα)
βιάζομαι	Verb	βιάζομαι • (viázomai) (simple past βιάστηκα, active form βιάζω, passive)
αντιτάσσω	Verb	αντιτάσσω • (antitásso) (simple past αντέταξα, passive form αντιτάσσομαι)
αιχμαλωτίζω	Verb	αιχμαλωτίζω • (aichmalotízo) (simple past αιχμαλώτισα, passive form αιχμαλωτίζομαι)
βοηθάω	Verb	βοηθάω • (voitháo) (simple past βοήθησα, passive form βοηθιέμαι)
συναντιέμαι	Verb	συναντιέμαι • (synantiémai) (simple past συναντήθηκα, active form συναντώ, passive)
επιτυγχάνομαι	Verb	επιτυγχάνομαι • (epitynchánomai) (simple past επιτεύχθηκα, active form επιτυγχάνω, passive)
κυβερνιέμαι	Verb	κυβερνιέμαι • (kyverniémai) (simple past κυβερνήθηκα, active form κυβερνώ, passive)
λαλάω	Verb	λαλάω • (laláo) (simple past λάλησα)
διψώ	Verb	διψώ • (dipsó) (simple past δίψασα, passive form —)
κυνηγάω	Verb	κυνηγάω • (kynigáo) (simple past κυνήγησα, passive form κυνηγιέμαι)
αναδεικνύω	Verb	αναδεικνύω • (anadeiknýo) (simple past ανέδειξα or ανάδειξα, passive form αναδεικνύομαι)
κρύβω	Verb	κρύβω • (krývo) (simple past έκρυψα, passive form κρύβομαι)
παπαγαλίζω	Verb	παπαγαλίζω • (papagalízo) (simple past παπαγάλισα)
αηδιάζομαι	Verb	αηδιάζομαι • (aidiázomai) (simple past αηδιάστηκα, active form αηδιάζω, passive)
αδημονώ	Verb	αδημονώ • (adimonó) (found only in the present and imperfect tenses)
αναχαιτίζομαι	Verb	αναχαιτίζομαι • (anachaitízomai) (simple past αναχαιτίστηκα, active form αναχαιτίζω, passive)
αναζητούμαι	Verb	αναζητούμαι • (anazitoúmai) (simple past αναζητήθηκα, active form αναζητώ, passive)
αδερφώνω	Verb	αδερφώνω • (aderfóno) (simple past αδέρφωσα, passive form αδερφώνομαι)
μέμφομαι	Verb	μέμφομαι • (mémfomai) (simple past μέμφθηκα, deponent)
συμπληρώνω	Verb	συμπληρώνω • (sympliróno) (simple past συμπληρώσα, passive form συμπληρώνομαι)
επαινώ	Verb	επαινώ • (epainó) (simple past επαίνεσα, passive form επαινούμαι)
πεταλώνω	Verb	πεταλώνω • (petalóno) (simple past πετάλωσα)
ήρα	Verb	ήρα • (íra)
δαμάζομαι	Verb	δαμάζομαι • (damázomai) (simple past δαμάστηκα, active form δαμάζω, passive)
χορογραφώ	Verb	χορογραφώ • (chorografó) (simple past χορογράφησα)
νομίζω	Verb	νομίζω • (nomízo) (simple past νόμισα, passive form —)
εφαρμόζομαι	Verb	εφαρμόζομαι • (efarmózomai) (simple past εφαρμόστηκα, active form εφαρμόζω, passive)
δραματοποιώ	Verb	δραματοποιώ • (dramatopoió) (simple past δραματοποίησα)
κυκλοφορούμαι	Verb	κυκλοφορούμαι • (kykloforoúmai) (simple past κυκλοφορήθηκα, active form κυκλοφορώ, passive)
ομολογώ	Verb	ομολογώ • (omologó) (simple past ομολόγησα, passive form ομολογούμαι)
αναπαρίσταμαι	Verb	αναπαρίσταμαι • (anaparístamai) (simple past αναπαραστάθηκα, active form αναπαριστώ, passive)
μετανιώνω	Verb	μετανιώνω • (metanióno) (simple past μετάνιωσα)
αιθριάζω	Verb	αιθριάζω • (aithriázo) (simple past αιθρίασα)
ακούγομαι	Verb	ακούγομαι • (akoúgomai) (simple past ακούστηκα, active form ακούω, mediopassive)
ευχαριστώ	Verb	ευχαριστώ • (efcharistó) (simple past ευχαρίστησα, passive form ευχαριστιέμαι or ευχαριστούμαι)
αναλύομαι	Verb	αναλύομαι • (analýomai) (simple past αναλύθηκα, active form αναλύω, passive)
υπάρχω	Verb	υπάρχω • (ypárcho) (simple past υπήρξα)
αποταμιεύομαι	Verb	αποταμιεύομαι • (apotamiévomai) (simple past αποταμιεύτηκα or αποταμιεύθηκα, active form αποταμιεύω, passive)
απαλλοτριώνω	Verb	απαλλοτριώνω • (apallotrióno) (simple past απαλλοτρίωσα)
υπερβάλλω	Verb	υπερβάλλω • (ypervállo) (simple past υπερέβαλα)
πλέκομαι	Verb	πλέκομαι • (plékomai) (simple past πλέχτηκα, active form πλέκω, passive)
βρίζω	Verb	βρίζω • (vrízo) (simple past έβρισα, passive form βρίζομαι)
ανασταίνομαι	Verb	ανασταίνομαι • (anastaínomai) (simple past αναστήθηκα, active form ανασταίνω, passive)
πετάω	Verb	πετάω • (petáo) (simple past πέταξα, passive form πετάγομαι or πετιέμαι)
υποδέχομαι	Verb	υποδέχομαι • (ypodéchomai) (simple past υποδέχτηκα or υποδέχθηκα, deponent)
ξεκωλιάζομαι	Verb	ξεκωλιάζομαι • (xekoliázomai) (simple past ξεκωλιάστηκα, active form ξεκωλιάζω, passive)
ξεψυχάω	Verb	ξεψυχάω • (xepsycháo) (simple past ξεψύχησα)
χλιμιντρώ	Verb	χλιμιντρώ • (chlimintró) (simple past χλιμίντρισα)
απελπίζομαι	Verb	απελπίζομαι • (apelpízomai) (simple past απελπίστηκα, active form απελπίζω, passive)
τσουγκρίζω	Verb	τσουγκρίζω • (tsougkrízo) (simple past τσούγκρισα, passive form τσουγκρίζομαι)
παρεκκλίνω	Verb	παρεκκλίνω • (parekklíno) (simple past παρεξέκλινα)
αποκλείω	Verb	αποκλείω • (apokleío) (simple past απέκλεισα or απόκλεισα, passive form αποκλείομαι)
ντύνομαι	Verb	ντύνομαι • (dýnomai) (simple past ντύθηκα, active form ντύνω, mediopassive)
αλληγορώ	Verb	αλληγορώ • (alligoró) (simple past αλληγόρησα)
τρέπομαι	Verb	τρέπομαι • (trépomai) (simple past τράπηκα, active form τρέπω, passive)
οικονομιέμαι	Verb	οικονομιέμαι • (oikonomiémai) (simple past οικονομήθηκα, active form οικονομώ, passive)
αφήνομαι	Verb	αφήνομαι • (afínomai) (simple past αφέθηκα, active form αφήνω, passive)
ενσταλάζω	Verb	ενσταλάζω • (enstalázo) (simple past ενστάλαξα)
προλαβαίνω	Verb	προλαβαίνω • (prolavaíno) (simple past πρόλαβα)
συζητάω	Verb	συζητάω • (syzitáo) (simple past συζήτησα, passive form συζητιέμαι or συζητούμαι)
αλαφιάζομαι	Verb	αλαφιάζομαι • (alafiázomai) (simple past αλαφιάστηκα, active form αλαφιάζω, passive)
παρασκευάζομαι	Verb	παρασκευάζομαι • (paraskevázomai) (simple past παρασκευάστηκα, active form παρασκευάζω, passive)
ζητούμαι	Verb	ζητούμαι • (zitoúmai) (simple past ζητήθηκα, active form ζητώ, mediopassive)
ανταλλάσσομαι	Verb	ανταλλάσσομαι • (antallássomai) (simple past ανταλλάχτηκα or ανταλλάχθηκα, active form ανταλλάζω, passive)
φέρομαι	Verb	φέρομαι • (féromai) (active form φέρω, found only in the present and imperfect tenses, passive)
σκάζω	Verb	σκάζω • (skázo) (simple past έσκασα)
ψήνω	Verb	ψήνω • (psíno) (simple past έψησα, passive form ψήνομαι)
κάμνω	Verb	κάμνω • (kámno) (simple past έκαμα or έκαμνα)
σερβίρω	Verb	σερβίρω • (servíro) (simple past σέρβιρα, passive form σερβίρομαι)
τελώ	Verb	τελώ • (teló) (simple past τέλεσα, passive form τελούμαι)
κυκλώνομαι	Verb	κυκλώνομαι • (kyklónomai) (simple past κυκλώθηκα, active form κυκλώνω, passive)
ασχολούμαι	Verb	ασχολούμαι • (ascholoúmai) (simple past ασχολήθηκα, deponent)
υιοθετώ	Verb	υιοθετώ • (yiothetó) (simple past υιοθέτησα)
παρεμποδίζω	Verb	παρεμποδίζω • (parempodízo) (simple past παρεμπόδισα)
αναθεματίζω	Verb	αναθεματίζω • (anathematízo) (simple past αναθεμάτισα, passive form αναθεματίζομαι)
παραμερίζομαι	Verb	παραμερίζομαι • (paramerízomai) (simple past παραμερίστηκα, active form παραμερίζω, passive)
βυθίζω	Verb	βυθίζω • (vythízo) (simple past βύθισα, passive form βυθίζομαι)
πατάω	Verb	πατάω • (patáo) (simple past πάτησα, passive form πατιέμαι)
γλιτώνω	Verb	γλιτώνω • (glitóno) (simple past γλύτωσα)
ακρωτηριάζομαι	Verb	ακρωτηριάζομαι • (akrotiriázomai) (simple past ακρωτηριάστηκα, active form ακρωτηριάζω, passive)
διατυπώνω	Verb	διατυπώνω • (diatypóno) (simple past διατύπωσα, passive form διατυπώνομαι)
ξαλεγράρω	Verb	ξαλεγράρω • (xalegráro) (simple past —)
καβαλώ	Verb	καβαλώ • (kavaló) (simple past καβάλησα, passive form καβαλιέμαι)
απευθύνω	Verb	απευθύνω • (apefthýno) (simple past απηύθυνα or απεύθυνα, passive form απευθύνομαι)
αντιλαμβάνομαι	Verb	αντιλαμβάνομαι • (antilamvánomai) (simple past αντιλήφθηκα, deponent)
αλατίζω	Verb	αλατίζω • (alatízo) (simple past αλάτισα, passive form αλατίζομαι)
κοινωνώ	Verb	κοινωνώ • (koinonó) (simple past κοινώνησα, passive form —)
θα έχουνε	Verb	θα έχουνε • (tha échoune)
στραβομουτσουνιάζω	Verb	στραβομουτσουνιάζω • (stravomoutsouniázo) (simple past στραβομουτσούνιασα)
κελαηδάω	Verb	κελαηδάω • (kelaidáo) (simple past κελάηδησα)
ξεφλουδίζω	Verb	ξεφλουδίζω • (xefloudízo) (simple past ξεφλούδισα)
χρονίζω	Verb	χρονίζω • (chronízo) (simple past χρόνισα)
αποκεντρώνω	Verb	αποκεντρώνω • (apokentróno) (simple past αποκέντρωσα, passive form αποκεντρώνομαι)
κλειδώνω	Verb	κλειδώνω • (kleidóno) (simple past κλείδωσα, passive form κλειδώνομαι)
ήτανε	Verb	ήτανε • (ítane)
απεικονίζω	Verb	απεικονίζω • (apeikonízo) (simple past απεικόνισα, passive form απεικονίζομαι)
ανταλλάζω	Verb	ανταλλάζω • (antallázo) (simple past αντάλλαξα, passive form ανταλλάζομαι)
αναγουλιάζω	Verb	αναγουλιάζω • (anagouliázo) (simple past αναγούλιασα)
σκάβω	Verb	σκάβω • (skávo) (simple past έσκαψα, passive form σκάβομαι, active)
αθροίζομαι	Verb	αθροίζομαι • (athroízomai) (simple past αθροίστηκα, active form αθροίζω, passive)
προχωρώ	Verb	προχωρώ • (prochoró) (simple past προχώρησα, passive form —)
πέφτω	Verb	πέφτω • (péfto) (simple past έπεσα)
ποντάρω	Verb	ποντάρω • (pontáro) (simple past πόνταρα or ποντάρισα)
απειθαρχώ	Verb	απειθαρχώ • (apeitharchó) (simple past απειθάρχησα)
ριζοσπαστικοποιώ	Verb	ριζοσπαστικοποιώ • (rizospastikopoió) (simple past ριζοσπαστικοποίησα, passive form ριζοσπαστικοποιούμαι)
τυραννάω	Verb	τυραννάω • (tyrannáo) (simple past τυράννησα, passive form τυραννιέμαι)
σπιλώνομαι	Verb	σπιλώνομαι • (spilónomai) (simple past σπιλώθηκα, active form σπιλώνω, passive)
βάφομαι	Verb	βάφομαι • (váfomai) (simple past βάφτηκα or βάφηκα, active form βάφω)
σπρώχνω	Verb	σπρώχνω • (spróchno) (simple past έσπρωξα, passive form σπρώχνομαι)
περπατώ	Verb	περπατώ • (perpató) (simple past περπάτησα)
διώχνομαι	Verb	διώχνομαι • (dióchnomai) (simple past διώχτηκα, active form διώχνω, passive)
περνώ	Verb	περνώ • (pernó) (simple past πέρασα, passive form περνιέμαι)
κουβαλιέμαι	Verb	κουβαλιέμαι • (kouvaliémai) (simple past κουβαλήθηκα, active form κουβαλώ, passive)
βοηθιέμαι	Verb	βοηθιέμαι • (voithiémai) (simple past βοηθήθηκα, active form βοηθώ, passive)
αλησμονώ	Verb	αλησμονώ • (alismonó) (simple past αλησμόνησα)
ανακυκλώνω	Verb	ανακυκλώνω • (anakyklóno) (simple past ανακύκλωσα, passive form ανακυκλώνομαι)
αγγίζομαι	Verb	αγγίζομαι • (angízomai) (simple past αγγίχτηκα, active form αγγίζω, passive)
διορίζω	Verb	διορίζω • (diorízo) (simple past διόρισα)
κρεμιέμαι	Verb	κρεμιέμαι • (kremiémai) (simple past κρεμάστηκα, active form κρεμώ, passive)
σπιθίζω	Verb	σπιθίζω • (spithízo) (simple past σπίθισα)
άπτομαι	Verb	άπτομαι • (áptomai) (simple past —, deponent)
θυμίζω	Verb	θυμίζω • (thymízo) (simple past θύμισα, passive form —)
αναταράσσω	Verb	αναταράσσω • (anatarásso) (simple past ανατάραξα, passive form αναταράσσομαι)
απαντιέμαι	Verb	απαντιέμαι • (apantiémai) (simple past απαντήθηκα, active form απαντώ, passive)
πλησιάζω	Verb	πλησιάζω • (plisiázo) (simple past πλησίασα, passive form —)
αποκαλώ	Verb	αποκαλώ • (apokaló) (simple past αποκάλεσα, passive form αποκαλούμαι)
δειγματίζω	Verb	δειγματίζω • (deigmatízo) (simple past δειγμάτισα, passive form δειγματίζομαι)
ανακατεύω	Verb	ανακατεύω • (anakatévo) (simple past ανακάτεψα, passive form ανακατεύομαι)
αποκαλύπτομαι	Verb	αποκαλύπτομαι • (apokalýptomai) (simple past αποκαλύφθηκα or αποκαλύφτηκα, active form αποκαλύπτω, passive)
καταφεύγω	Verb	καταφεύγω • (katafévgo) (simple past κατέφυγα, passive form —)
ξεκινώ	Verb	ξεκινώ • (xekinó) (simple past ξεκίνησα)
προσαρμόζομαι	Verb	προσαρμόζομαι • (prosarmózomai) (simple past προσαρμόστηκα, active form προσαρμόζω, passive)
ανταλλάζομαι	Verb	ανταλλάζομαι • (antallázomai) (simple past ανταλλάχτηκα, active form ανταλλάζω, passive)
φυλακίζω	Verb	φυλακίζω • (fylakízo) (simple past φυλάκισα)
ανακτώμαι	Verb	ανακτώμαι • (anaktómai) (simple past ανακτήθηκα, active form ανακτώ, passive)
μαίνομαι	Verb	μαίνομαι • (maínomai) (found only in the present and imperfect tenses, deponent)
ξεσχίζομαι	Verb	ξεσχίζομαι • (xeschízomai) (simple past ξεσχίστηκα, active form ξεσχίζω, passive)
είμαι	Verb	είμαι • (eímai) (imperfect ήμουν)
αντιδρώ	Verb	αντιδρώ • (antidró) (simple past αντέδρασα, passive form —)
αγκυλώνω	Verb	αγκυλώνω • (agkylóno) (simple past αγκύλωσα, passive form αγκυλώνομαι)
εξοπλίζω	Verb	εξοπλίζω • (exoplízo) (simple past εξόπλισα, passive form εξοπλίζομαι)
αναγκάζομαι	Verb	αναγκάζομαι • (anagkázomai) (simple past αναγκάστηκα, active form αναγκάζω, passive)
απαντώμαι	Verb	απαντώμαι • (apantómai) (simple past απαντήθηκα, active form απαντώ, passive)
κόβω	Verb	κόβω • (kóvo) (simple past έκοψα, passive form κόβομαι)
κεντιέμαι	Verb	κεντιέμαι • (kentiémai) (simple past κεντήθηκα, active form κεντώ, passive)
μαχαιροπήρουνο	Verb	μαχαιροπήρουνο • (machairopírouno) (simple past μαχαιροπήρουνα) (usually plural)
ανταμώνομαι	Verb	ανταμώνομαι • (antamónomai) (simple past ανταμώθηκα, active form ανταμώνω, passive)
βαραίνω	Verb	βαραίνω • (varaíno) (simple past βάρυνα, passive form —)
ξεχέζω	Verb	ξεχέζω • (xechézo) (simple past ξέχεσα)
απολογούμαι	Verb	απολογούμαι • (apologoúmai) (simple past απολογήθηκα, deponent)
πολεμιέμαι	Verb	πολεμιέμαι • (polemiémai) (simple past πολεμήθηκα, active form πολεμώ, passive)
μεθώ	Verb	μεθώ • (methó) (simple past μέθυσα)
παρουσιάζομαι	Verb	παρουσιάζομαι • (parousiázomai) (simple past παρουσιάστηκα, active form παρουσιάζω, passive)
ακμάζω	Verb	ακμάζω • (akmázo) (simple past άκμασα)
γιορτάζω	Verb	γιορτάζω • (giortázo) (simple past γιόρτασα, passive form γιορτάζομαι)
φασκιώνω	Verb	φασκιώνω • (faskióno) (simple past φάσκιωσα, passive form φασκιώνομαι)
αποτυγχάνω	Verb	αποτυγχάνω • (apotyncháno) (simple past απέτυχα or απότυχα)
κατάσχω	Verb	κατάσχω • (katáscho) (simple past κατάσχεσα or κατέσχεσα, passive form κατάσχομαι)
αμέλγω	Verb	αμέλγω • (amélgo) (simple past άρμεξα)
θριαμβεύω	Verb	θριαμβεύω • (thriamvévo) (simple past θριάμβευσα)
γιορτάζομαι	Verb	γιορτάζομαι • (giortázomai) (simple past γιορτάστηκα, active form γιορτάζω, passive)
απωθούμαι	Verb	απωθούμαι • (apothoúmai) (simple past απωθήθηκα, active form απωθώ, passive)
κουλουριάζω	Verb	κουλουριάζω • (koulouriázo) (simple past κουλούριασα, passive form κουλουριάζομαι)
λέγομαι	Verb	λέγομαι • (légomai) (simple past ειπώθηκα or λέχθηκα, active form λέω, mediopassive)
επαπειλούμαι	Verb	επαπειλούμαι • (epapeiloúmai) (simple past —, active form επαπειλώ, found only in the present tense, passive)
ακοντίζω	Verb	ακοντίζω • (akontízo) (simple past ακόνtισα)
παράγομαι	Verb	παράγομαι • (parágomai) (simple past παράχθηκα, active form παράγω, mediopassive)
μαλακίζομαι	Verb	μαλακίζομαι • (malakízomai) (simple past μαλακίστηκα, deponent)
ματοκυλίζω	Verb	ματοκυλίζω • (matokylízo) (simple past ματοκύλισα, passive form ματοκυλίζομαι)
αινώ	Verb	αινώ • (ainó) (found only in the present tense)
καταφρονούμαι	Verb	καταφρονούμαι • (katafronoúmai) (simple past καταφρονήθηκα, active form καταφρονώ, passive)
κελαϊδάω	Verb	κελαϊδάω • (kelaïdáo) (simple past κελάιδησα)
βλασταίνω	Verb	βλασταίνω • (vlastaíno) (simple past βλάστησα)
αναδιοργανώνω	Verb	αναδιοργανώνω • (anadiorganóno) (simple past αναδιοργάνωσα, passive form αναδιοργανώνομαι)
κουρελιάζομαι	Verb	κουρελιάζομαι • (koureliázomai) (simple past κουρελιάστηκα, active form κουρελιάζω, passive)
αναγγέλλω	Verb	αναγγέλλω • (anangéllo) (simple past ανήγγειλα or ανάγγειλα, passive form αναγγέλλομαι)
αρμέγω	Verb	αρμέγω • (armégo) (simple past άρμεξα)
ενθαρρύνομαι	Verb	ενθαρρύνομαι • (entharrýnomai) (simple past ενθαρρύνθηκα, active form ενθαρρύνω, passive)
αρπάζω	Verb	αρπάζω • (arpázo) (simple past άρπαξα, passive form αρπάζομαι)
κονταίνω	Verb	κονταίνω • (kontaíno) (simple past κόντυνα)
ακριβοπουλιέμαι	Verb	ακριβοπουλιέμαι • (akrivopouliémai) (simple past ακριβοπουλήθηκα, active form ακριβοπουλώ, passive)
εκκενώνομαι	Verb	εκκενώνομαι • (ekkenónomai) (simple past εκκενώθηκα, active form εκκενώνω, passive)
αναγαλλιάζω	Verb	αναγαλλιάζω • (anagalliázo) (simple past αναγαλλίασα)
αυξομειώνω	Verb	αυξομειώνω • (afxomeióno) (simple past αυξομείωσα, passive form αυξομειώνομαι)
αντιμετωπίζομαι	Verb	αντιμετωπίζομαι • (antimetopízomai) (simple past αντιμετωπίστηκα, active form αντιμετωπίζω, passive)
κερδίζομαι	Verb	κερδίζομαι • (kerdízomai) (simple past κερδήθηκα, active form κερδίζω, passive)
στρίβομαι	Verb	στρίβομαι • (strívomai) (simple past στρίφτηκα, active form στρίβω, passive)
ανήκω	Verb	ανήκω • (aníko) (imperfect ανήκα, found only in the imperfective tenses)
προγραμματίζομαι	Verb	προγραμματίζομαι • (programmatízomai) (simple past προγραμματίστηκα, active form προγραμματίζω, passive)
ζωγραφίζω	Verb	ζωγραφίζω • (zografízo) (simple past ζωγράφισα)
βουτυρώνω	Verb	βουτυρώνω • (voutyróno) (simple past βουτύρωσα, passive form βουτυρώνομαι)
καθαρίζω	Verb	καθαρίζω • (katharízo) (simple past καθάρισα, passive form καθαρίζομαι)
ανατρέπω	Verb	ανατρέπω • (anatrépo) (simple past ανέτρεψα)
σπάζω	Verb	σπάζω • (spázo) (simple past έσπασα, passive form σπάζομαι)
τηγανίζω	Verb	τηγανίζω • (tiganízo) (simple past τηγάνισα, passive form τηγανίζομαι)
σφάλλω	Verb	σφάλλω • (sfállo) (simple past έσφαλα)
θειαφίζω	Verb	θειαφίζω • (theiafízo) (simple past θειάφισα, passive form θειαφίζομαι)
απλοποιώ	Verb	απλοποιώ • (aplopoió) (simple past απλοποίησα, passive form απλοποιούμαι)
αρπάζομαι	Verb	αρπάζομαι • (arpázomai) (simple past αρπάχτηκα, active form αρπάζω, passive)
καλώ	Verb	καλώ • (kaló) (simple past κάλεσα, passive form καλούμαι)
υπογράφω	Verb	υπογράφω • (ypográfo) (simple past υπέγραψα or υπόγραψα, passive form υπογράφομαι)
σηκώνω	Verb	σηκώνω • (sikóno) (simple past σήκωσα, passive form σηκώνομαι)
αποζημιώνω	Verb	αποζημιώνω • (apozimióno) (simple past αποζημίωσα, passive form αποζημιώνομαι)
αιμορροώ	Verb	αιμορροώ • (aimorroó) (simple past αιμορρόησα)
προετοιμάζω	Verb	προετοιμάζω • (proetoimázo) (simple past προετοίματισα, passive form προετοιμάζομαι)
εξαφανίζομαι	Verb	εξαφανίζομαι • (exafanízomai) (simple past εξαφανίστηκα, active form εξαφανίζω, passive)
στερούμαι	Verb	στερούμαι • (steroúmai) (simple past στερήθηκα, active form στερώ, mediopassive)
θερίζω	Verb	θερίζω • (therízo) (simple past θέρισα, passive form θερίζομαι)
μετρώ	Verb	μετρώ • (metró) (simple past μέτρησα, passive form μετριέμαι)
αυξάνομαι	Verb	αυξάνομαι • (afxánomai) (simple past αυξήθηκα, active form αυξάνω, passive)
μεταφυτεύω	Verb	μεταφυτεύω • (metafytévo) (simple past μεταφύτεψα, passive form μεταφυτεύομαι)
αγαπίζω	Verb	αγαπίζω • (agapízo) (simple past αγάπισα)
αλαφροζυγιάζομαι	Verb	αλαφροζυγιάζομαι • (alafrozygiázomai)
διατηρώ	Verb	διατηρώ • (diatiró) (simple past διατήρησα, passive form διατηρούμαι)
ξεσκατίζω	Verb	ξεσκατίζω • (xeskatízo) (simple past ξεσκάτισα, passive form ξεσκατίζομαι)
κατοικούμαι	Verb	κατοικούμαι • (katoikoúmai) (simple past κατοικήθηκα, active form κατοικώ, mediopassive)
αλαλιάζω	Verb	αλαλιάζω • (alaliázo) (simple past αλάλιασα)
ζεσταίνομαι	Verb	ζεσταίνομαι • (zestaínomai) (simple past ζεστάθηκα, active form ζεσταίνω, passive)
ανατίθεμαι	Verb	ανατίθεμαι • (anatíthemai) (simple past ανατέθηκα, active form αναθέτω, passive)
ακολουθιέμαι	Verb	ακολουθιέμαι • (akolouthiémai) (simple past ακολουθήθηκα, active form ακολουθώ, passive)
επηρεάζομαι	Verb	επηρεάζομαι • (epireázomai) (simple past επηρεάστηκα, active form επηρεάζω, passive)
ανταμώνω	Verb	ανταμώνω • (antamóno) (simple past αντάμωσα, passive form ανταμώνομαι)
αδερφώνομαι	Verb	αδερφώνομαι • (aderfónomai) (simple past αδερφώθηκα, active form αδερφώνω, passive)
ενεχυριάζω	Verb	ενεχυριάζω • (enechyriázo) (simple past ενεχυρίασα)
απατώ	Verb	απατώ • (apató) (simple past απάτησα, passive form απατώμαι)
αισχρολογώ	Verb	αισχρολογώ • (aischrologó) (found only in the present and imperfect tenses)
υποψιάζομαι	Verb	υποψιάζομαι • (ypopsiázomai) (simple past υποψιάστηκα, deponent)
επιστρέφω	Verb	επιστρέφω • (epistréfo) (simple past επέστρεψα)
πιστοποιώ	Verb	πιστοποιώ • (pistopoió) (simple past πιστοποίησα)
ενστερνίζομαι	Verb	ενστερνίζομαι • (ensternízomai) (simple past ενστερνίστηκα, deponent)
οικονομάω	Verb	οικονομάω • (oikonomáo) (simple past οικονόμησα, passive form οικονομιέμαι)
καθίζω	Verb	καθίζω • (kathízo) (simple past κάθισα)
παίζομαι	Verb	παίζομαι • (paízomai) (simple past παίχτηκα, active form παίζω, passive)
κηλιδώνομαι	Verb	κηλιδώνομαι • (kilidónomai) (simple past κηλιδώθηκα, active form κηλιδώνω, passive)
κουνώ	Verb	κουνώ • (kounó) (simple past κούνησα, passive form κουνιέμαι)
κοροϊδεύω	Verb	κοροϊδεύω • (koroïdévo) (simple past κορόιδεψα, passive form κοροϊδεύομαι)
συμφωνούμαι	Verb	συμφωνούμαι • (symfonoúmai) (simple past συμφωνήθηκα, active form συμφωνώ, passive)
συντρέχω	Verb	συντρέχω • (syntrécho) (simple past συνέτρεζα or συνέδραμα)
ασκούμαι	Verb	ασκούμαι • (askoúmai) (simple past ασκήθηκα, active form ασκώ)
αποκρύπτω	Verb	αποκρύπτω • (apokrýpto) (simple past απέκρυψα or απόκρυψα)
θα είμαστε	Verb	θα είμαστε • (tha eímaste)
τυραννιέμαι	Verb	τυραννιέμαι • (tyranniémai) (simple past τυραννήθηκα, active form τυραννώ, mediopassive)
παρκέρνω	Verb	παρκέρνω • (parkérno) (simple past πάρκαρα or παρκάρισα)
σκεπάζομαι	Verb	σκεπάζομαι • (skepázomai) (simple past σκεπάστηκα, active form σκεπάζω, passive)
χτικιάζω	Verb	χτικιάζω • (chtikiázo) (simple past χτίκιασα, passive form χτικιάζομαι)
αναγγέλλομαι	Verb	αναγγέλλομαι • (anangéllomai) (simple past αναγγέλθηκα, active form αναγγέλλω, passive)
προτιμώ	Verb	προτιμώ • (protimó) (simple past προτίμησα, passive form προτιμώμαι)
καταβάλλομαι	Verb	καταβάλλομαι • (katavállomai) (simple past καταβλήθηκα, active form καταβάλλω, passive)
ξεκωλώνομαι	Verb	ξεκωλώνομαι • (xekolónomai) (simple past ξεκωλώθηκα, active form ξεκωλώνω, passive)
αναπαριστάνομαι	Verb	αναπαριστάνομαι • (anaparistánomai) (simple past αναπαραστάθηκα, active form αναπαριστάνω, passive)
αποδείχνομαι	Verb	αποδείχνομαι • (apodeíchnomai) (simple past αποδείχτηκα, active form αποδείχνω, passive)
στιγματίζω	Verb	στιγματίζω • (stigmatízo) (simple past στιγμάτισα, passive form στιγματίζομαι)
απορρίπτω	Verb	απορρίπτω • (aporrípto) (simple past απέρριψα or απόρριψα, passive form απορρίπτομαι, passive)
βαστάζομαι	Verb	βαστάζομαι • (vastázomai) (simple past βαστάχτηκα, active form βαστάζω, passive)
αγλαΐζω	Verb	αγλαΐζω • (aglaḯzo) (simple past αγλάισα)
σπαταλάω	Verb	σπαταλάω • (spataláo) (simple past σπατάλησα)
εγείρω	Verb	εγείρω • (egeíro) (found only in the present and imperfect tenses)
εγγίζω	Verb	εγγίζω • (engízo) (simple past έγγιξα)
μοιράζομαι	Verb	μοιράζομαι • (moirázomai) (simple past μοιράστηκα, active form μοιράζω, passive)
κυματίζω	Verb	κυματίζω • (kymatízo) (simple past κυμάτισα)
ανακατεύομαι	Verb	ανακατεύομαι • (anakatévomai) (simple past ανακατεύτηκα, active form ανακατεύω, mediopassive)
αγωνιώ	Verb	αγωνιώ • (agonió) (imperfect αγωνιούσα, found only in the present and imperfect tenses)
καίγω	Verb	καίγω • (kaígo) (simple past έκαψα, passive form καίγομαι)
ράβω	Verb	ράβω • (rávo) (simple past έραψα, passive form ράβομαι)
απορρίπτομαι	Verb	απορρίπτομαι • (aporríptomai) (simple past απορρίφθηκα or απορρίφτηκα, active form απορρίπτω)
ξεκαρφώνω	Verb	ξεκαρφώνω • (xekarfóno) (simple past ξεκάρφωσα)
ξεκουράζομαι	Verb	ξεκουράζομαι • (xekourázomai) (simple past ξεκουράστηκα, active form ξεκουράζω, passive)
μειώνομαι	Verb	μειώνομαι • (meiónomai) (simple past μειώθηκα, active form μειώνω, passive)
σκουντάω	Verb	σκουντάω • (skountáo) (simple past σκούντηξα or σκούντησα, passive form —)
αθωώνομαι	Verb	αθωώνομαι • (athoónomai) (simple past αθωώθηκα, active form αθωώνω, passive)
ξεραίνομαι	Verb	ξεραίνομαι • (xeraínomai) (simple past ξεράθηκα, active form ξεραίνω, passive)
ξερνώ	Verb	ξερνώ • (xernó) (simple past ξέρασα)
σκέφτομαι	Verb	σκέφτομαι • (skéftomai) (simple past σκέφτηκα or σκέφθηκα, deponent)
αλληλοκοιτάζομαι	Verb	αλληλοκοιτάζομαι • (allilokoitázomai) (simple past αλληλοκοιτάχτηκα, deponent)
αναλαμβάνω	Verb	αναλαμβάνω • (analamváno) (simple past ανέλαβα or ανάλαβα, passive form αναλαμβάνομαι)
προφασίζομαι	Verb	προφασίζομαι • (profasízomai) (simple past προφασίστηκα, deponent)
πηδάω	Verb	πηδάω • (pidáo) (simple past πήδηξα or πήδησα, passive form πηδιέμαι)
αποτραβιέμαι	Verb	αποτραβιέμαι • (apotraviémai) (simple past αποτραβήχτηκα, active form αποτραβώ, passive)
προσδοκώμαι	Verb	προσδοκώμαι • (prosdokómai) (simple past —, active form προσδοκώ, found only in the present and imperfect tenses, passive)
αιτώ	Verb	αιτώ • (aitó) (simple past αιτούσα, passive form αιτούμαι)
πηδώ	Verb	πηδώ • (pidó) (simple past πήδηξα or πήδησα, passive form πηδιέμαι)
εξαφανίζω	Verb	εξαφανίζω • (exafanízo) (simple past εξαφάνισα, passive form εξαφανίζομαι)
δροσίζω	Verb	δροσίζω • (drosízo) (simple past δρόσισα, passive form δροσίζομαι)
διαφημίζομαι	Verb	διαφημίζομαι • (diafimízomai) (simple past διαφημίστηκα, active form διαφημίζω, passive)
δοξάζω	Verb	δοξάζω • (doxázo) (simple past δόξασα)
επεμβαίνω	Verb	επεμβαίνω • (epemvaíno) (simple past επέμβηκα, passive form —)
δημιουργώ	Verb	δημιουργώ • (dimiourgó) (simple past δημιούργησα, passive form δημιουργούμαι)
αγιοποιώ	Verb	αγιοποιώ • (agiopoió) (simple past αγιοποίησα, passive form αγιοποιούμαι)
συμβουλεύομαι	Verb	συμβουλεύομαι • (symvoulévomai) (simple past συμβουλεύτηκα, active form συμβουλεύω, passive)
κοιμάμαι	Verb	κοιμάμαι • (koimámai) (simple past κοιμήθηκα, deponent)
λογχίζω	Verb	λογχίζω • (lonchízo) (simple past λόγχισα)
φτύνω	Verb	φτύνω • (ftýno) (simple past έφτυσα)
ξιφουλκώ	Verb	ξιφουλκώ • (xifoulkó) (simple past ξιφούλκησα)
αγωροφέρνω	Verb	αγωροφέρνω • (agoroférno) (found only in the present and imperfect tenses)
μετριέμαι	Verb	μετριέμαι • (metriémai) (simple past μετρήθηκα, active form μετρώ, mediopassive)
αδυνατίζω	Verb	αδυνατίζω • (adynatízo) (simple past αδυνάτισα)
αναρρώνω	Verb	αναρρώνω • (anarróno) (simple past ανάρρωσα or ανέρρωσα)
αποκρατικοποιώ	Verb	αποκρατικοποιώ • (apokratikopoió) (simple past αποκρατικοποίησα)
αλαζονεύομαι	Verb	αλαζονεύομαι • (alazonévomai) (simple past αλαζονεύτηκα, deponent)
εκτιμάω	Verb	εκτιμάω • (ektimáo) (simple past εκτίμησα, passive form εκτιμώμαι)
χωράω	Verb	χωράω • (choráo) (simple past χώρεσα)
μποδίζω	Verb	μποδίζω • (bodízo) (simple past μπόδισα, passive form εμποδίζομαι)
αντιφάσκω	Verb	αντιφάσκω • (antifásko) (simple past —) (used in expressions)
λερώνω	Verb	λερώνω • (leróno) (simple past λέρωσα, passive form λερώνομαι)
καλούμαι	Verb	καλούμαι • (kaloúmai) (simple past καήθηκα or καλέστηκα, active form καλώ, passive)
απωθώ	Verb	απωθώ • (apothó) (simple past απώθησα, passive form απωθούμαι)
κωδικοποιώ	Verb	κωδικοποιώ • (kodikopoió) (simple past κωδικοποίησα)
αποσαφηνίζω	Verb	αποσαφηνίζω • (aposafinízo) (simple past αποσαφήνισα, passive form αποσαφηνίζομαι)
προδίδω	Verb	προδίδω • (prodído) (simple past πρόδωσα, passive form προδίδομαι)
έρπω	Verb	έρπω • (érpo) (found only in the present tense)
στενοχωρώ	Verb	στενοχωρώ • (stenochoró) (simple past στενοχώρησα, passive form στενοχωρούμαι or στενοχωριέμαι)
κολλάω	Verb	κολλάω • (kolláo) (simple past κόλλησα, passive form κολλιέμαι)
ήμουν	Verb	ήμουν • (ímoun)
αδειάζω	Verb	αδειάζω • (adeiázo) (simple past άδειασα, passive form αδειάζομαι)
αγρυπνάω	Verb	αγρυπνάω • (agrypnáo) (simple past αγρύπνησα, passive form —)
αντιπροσωπεύω	Verb	αντιπροσωπεύω • (antiprosopévo) (simple past αντιπροσώπευσα, passive form αντιπροσωπεύομαι)
γαμάω	Verb	γαμάω • (gamáo) (simple past γάμησα, passive form γαμιέμαι)
χαράζομαι	Verb	χαράζομαι • (charázomai) (simple past χαράχτηκα, active form χαράζω, passive)
μοιάζω	Verb	μοιάζω • (moiázo) (simple past έμοιασα, passive form —)
κουμπώνω	Verb	κουμπώνω • (koumpóno) (simple past κούμπωσα, passive form κουμπώνομαι)
ξεσκατώνω	Verb	ξεσκατώνω • (xeskatóno) (simple past ξεσκάτωσα, passive form ξεσκατώνομαι)
φουσκώνω	Verb	φουσκώνω • (fouskóno) (simple past φούσκωσα)
ανασκαλεύω	Verb	ανασκαλεύω • (anaskalévo) (simple past ανασκάλεψα, passive form ανασκαλεύομαι)
ανοίγω τον δρόμο	Verb	ανοίγω τον δρόμο • (anoígo ton drómo)
αδράχνω	Verb	αδράχνω • (adráchno) (simple past άδραξα)
πάω	Verb	πάω • (páo) (simple past πήγα)
αλλοιώνομαι	Verb	αλλοιώνομαι • (alloiónomai) (simple past αλλοιώθηκα, active form αλλοιώνω, passive)
αεροκοπανίζω	Verb	αεροκοπανίζω • (aerokopanízo) (simple past αεροκοπάνισα)
τρέχω	Verb	τρέχω • (trécho) (simple past έτρεξα, passive form —)
διαβάζομαι	Verb	διαβάζομαι • (diavázomai) (simple past διαβάστηκα, active form διαβάζω, passive)
προτείνομαι	Verb	προτείνομαι • (proteínomai) (simple past προτάθηκα, active form προτείνω, passive)
συσσωρεύω	Verb	συσσωρεύω • (syssorévo) (simple past συσσώρευσα, passive form συσσωρεύομαι)
πιάνω	Verb	πιάνω • (piáno) (simple past έπιασα, passive form πιάνομαι)
ανακαλύπτω	Verb	ανακαλύπτω • (anakalýpto) (simple past ανακάλυψα, passive form ανακαλύπτομαι)
ξέρω	Verb	ξέρω • (xéro) (imperfect ήξερα, found only in the imperfective tenses)
βάφω	Verb	βάφω • (váfo) (simple past έβαψα, passive form βάφομαι)
αμπαλάρω	Verb	αμπαλάρω • (ampaláro) (simple past αμπαλάρισα, passive form αμπαλάρομαι)
βυζαίνομαι	Verb	βυζαίνομαι • (vyzaínomai) (simple past βυζάχτηκα, active form βυζαίνω, passive)
αντιπαραβάλλω	Verb	αντιπαραβάλλω • (antiparavállo) (simple past αντιπαρέβαλα, passive form αντιπαραβάλλομαι)
αγανακτώ	Verb	αγανακτώ • (aganaktó) (simple past αγανάκτησα or αγανάχτησα)
αναπαρασταίνω	Verb	αναπαρασταίνω • (anaparastaíno) (simple past αναπαράστησα)
ακούομαι	Verb	ακούομαι • (akoúomai) (simple past ακούστηκα, active form ακούω, mediopassive)
προλαμβάνομαι	Verb	προλαμβάνομαι • (prolamvánomai) (simple past —, active form προλαμβάνω, passive)
κτίζω	Verb	κτίζω • (ktízo) (simple past έκτισα, passive form κτίζομαι)
έχε	Verb	έχε • (éche)
ανατιμώμαι	Verb	ανατιμώμαι • (anatimómai) (simple past ανατιμήθηκα, active form ανατιμώ, passive)
αθλοθετούμαι	Verb	αθλοθετούμαι • (athlothetoúmai) (simple past αθλοθετήθηκα, active form αθλοθετώ, passive)
παίζω	Verb	παίζω • (paízo) (simple past έπαιξα, passive form παίζομαι)
περιστρέφω	Verb	περιστρέφω • (peristréfo) (simple past περιέστρεψα)
ακριβοπουλώ	Verb	ακριβοπουλώ • (akrivopouló) (simple past ακριβοπούλησα, passive form ακριβοπουλιέμαι)
ανασκαλεύομαι	Verb	ανασκαλεύομαι • (anaskalévomai) (simple past ανασκαλεύτηκα, active form ανασκαλεύω, passive)
εγκρίνω	Verb	εγκρίνω • (egkríno) (simple past ενέκρινα)
τολμώμαι	Verb	τολμώμαι • (tolmómai) (simple past τολμήθηκα, active form τολμώ, passive)
κλιμακώνομαι	Verb	κλιμακώνομαι • (klimakónomai) (simple past κλιμακώθηκα, active form κλιμακώνω, passive)
ξεπερνώ	Verb	ξεπερνώ • (xepernó) (simple past ξεπέρασα)
χιονίζω	Verb	χιονίζω • (chionízo) (simple past χιόνισα)
αλυχτάω	Verb	αλυχτάω • (alychtáo) (simple past αλύχτησα)
πιστεύεται	Verb	πιστεύεται • (pistévetai) (simple past —, active form πιστεύω, passive)
ξεσκατίζομαι	Verb	ξεσκατίζομαι • (xeskatízomai) (simple past ξεσκατίστηκα, active form ξεσκατίζω, passive)
βουτώ	Verb	βουτώ • (voutó) (simple past βούτηξα, passive form βουτιέμαι)
κλαίω	Verb	κλαίω • (klaío) (simple past έκλαψα, passive form κλαίγομαι)
αποδέχομαι	Verb	αποδέχομαι • (apodéchomai) (simple past αποδέχτηκα or αποδέχθηκα, deponent)
συλλαμβάνω	Verb	συλλαμβάνω • (syllamváno) (simple past συνέλαβα, passive form συλλαμβάνομαι)
σώζω	Verb	σώζω • (sózo) (simple past έσωσα, passive form σώζομαι)
στοιβάζομαι	Verb	στοιβάζομαι • (stoivázomai) (simple past στοιβάχτηκα, active form στοιβάζω, passive)
εννοούμαι	Verb	εννοούμαι • (ennooúmai) (simple past εννοήθηκα, active form εννοώ, passive)
έχει	Verb	έχει • (échei)
κανιβαλίζω	Verb	κανιβαλίζω • (kanivalízo) (simple past κανιβάλισα)
αλληλοσυμπληρώνομαι	Verb	αλληλοσυμπληρώνομαι • (allilosymplirónomai) (simple past αλληλοσυμπληρώθηκα, deponent)
εγκαθίσταμαι	Verb	εγκαθίσταμαι • (egkathístamai) (simple past εγκαταστάθηκα, active form εγκαθιστώ, mediopassive)
ξαναβλέπομαι	Verb	ξαναβλέπομαι • (xanavlépomai) (simple past ξαναειδώθηκα, active form ξαναβλέπω, passive)
επιμένω	Verb	επιμένω • (epiméno) (simple past επέμεινα, passive form —)
φοβάμαι	Verb	φοβάμαι • (fovámai) (simple past φοβήθηκα, deponent)
παίρνω πίπα	Verb	παίρνω πίπα • (paírno pípa)
πειράζω	Verb	πειράζω • (peirázo) (simple past πείραξα, passive form πειράζομαι)
παρηγοράω	Verb	παρηγοράω • (parigoráo) (simple past παρηγόρησα, passive form παρηγορούμαι or παρηγοριέμαι)
αποσβήνω	Verb	αποσβήνω • (aposvíno) (simple past απόσβησα, passive form —)
αλγώ	Verb	αλγώ • (algó)
κουβαλάω	Verb	κουβαλάω • (kouvaláo) (simple past κουβάλησα, passive form κουβαλιέμαι)
ανυπομονώ	Verb	ανυπομονώ • (anypomonó) (found only in the imperfective tenses)
αλατίζομαι	Verb	αλατίζομαι • (alatízomai) (simple past αλατίστηκα, active form αλατίζω, passive)
εξεγείρω	Verb	εξεγείρω • (exegeíro) (simple past εξήγειρα or εξέγειρα, passive form εξεγείρομαι)
ζεματίζομαι	Verb	ζεματίζομαι • (zematízomai) (simple past ζεματίστηκα, active form ζεματίζω, passive)
αναβάλλομαι	Verb	αναβάλλομαι • (anavállomai) (simple past αναβλήθηκα, active form αναβάλλω, passive)
αλέθομαι	Verb	αλέθομαι • (aléthomai) (simple past αλέστηκα, active form αλέθω, passive)
αναζητώ	Verb	αναζητώ • (anazitó) (simple past αναζήτησα, passive form αναζητούμαι or αναζητιέμαι)
ριγώ	Verb	ριγώ • (rigó) (simple past ρίγησα)
καταγράφω	Verb	καταγράφω • (katagráfo) (simple past κατέγραψα)
φιλοξενώ	Verb	φιλοξενώ • (filoxenó) (simple past φιλοξένησα, passive form φιλοξενούμαι)
αθετώ	Verb	αθετώ • (athetó) (simple past αθέτησα, passive form αθετούμαι)
ανακυκλώνομαι	Verb	ανακυκλώνομαι • (anakyklónomai) (simple past ανακυκλώθηκα, active form ανακυκλώνω, passive)
αποβλέπω	Verb	αποβλέπω • (apovlépo) (simple past απέβλεψα)
είστε	Verb	είστε • (eíste)
στολίζομαι	Verb	στολίζομαι • (stolízomai) (simple past στολίστηκα, active form στολίζω, mediopassive)
παγώνω	Verb	παγώνω • (pagóno) (simple past πάγωσα)
παραδίδομαι	Verb	παραδίδομαι • (paradídomai) (simple past παραδόθηκα, active form παραδίδω, mediopassive)
ζεσταίνω	Verb	ζεσταίνω • (zestaíno) (simple past ζέστανα, passive form ζεσταίνομαι)
βρέχομαι	Verb	βρέχομαι • (vréchomai) (simple past βράχηκα, active form βρέχω, mediopassive)
διανυκτερεύω	Verb	διανυκτερεύω • (dianykterévo) (simple past διανυκτέρευσα)
συνιστώ	Verb	συνιστώ • (synistó) (simple past σύστησα, passive form —)
συνάπτομαι	Verb	συνάπτομαι • (synáptomai) (simple past συνάφθηκα, active form συνάπτω, passive)
δένομαι	Verb	δένομαι • (dénomai) (simple past δέθηκα, active form δένω, mediopassive)
ταριχεύω	Verb	ταριχεύω • (tarichévo) (simple past ταρίχευσα or ταρίχεψα)
θρηνούμαι	Verb	θρηνούμαι • (thrinoúmai) (simple past θρηνήθηκα, active form θρηνώ, passive)
πλήττομαι	Verb	πλήττομαι • (plíttomai) (simple past πλήγηκα, active form πλήττω, passive)
υποχωρώ	Verb	υποχωρώ • (ypochoró) (simple past υποχώρησα)
μαραίνω	Verb	μαραίνω • (maraíno) (simple past μάρανα, passive form μαραίνομαι)
βάζω	Verb	βάζω • (vázo) (simple past έβαλα, passive form βάζομαι)
απαλάσσομαι	Verb	απαλάσσομαι • (apalássomai) (simple past απαλάχτηκα, active form απαλάσσω, passive)
αποστηθίζω	Verb	αποστηθίζω • (apostithízo) (simple past αποστήθισα, passive form αποστηθίζομαι)
βοηθώ	Verb	βοηθώ • (voithó) (simple past βοήθησα, passive form βοηθιέμαι)
χορταίνω	Verb	χορταίνω • (chortaíno) (simple past χόρτασα)
αποσκιρτώ	Verb	αποσκιρτώ • (aposkirtó) (simple past αποσκίρτησα)
κρατικοποιώ	Verb	κρατικοποιώ • (kratikopoió) (simple past κρατικοποίησα, passive form κρατικοποιούμαι)
είχαν	Verb	είχαν • (eíchan)
αιματώνω	Verb	αιματώνω • (aimatóno) (simple past αιμάτωσα)
φιλώ	Verb	φιλώ • (filó) (simple past φίλησα)
φυλλομετράω	Verb	φυλλομετράω • (fyllometráo) (simple past φυλλομέτρησα)
βαθουλώνω	Verb	βαθουλώνω • (vathoulóno) (simple past βαθούλωσα)
παρηγοριέμαι	Verb	παρηγοριέμαι • (parigoriémai) (simple past παρηγορήθηκα, active form παρηγορώ, passive)
αρρωσταίνω	Verb	αρρωσταίνω • (arrostaíno) (simple past αρρώστησα)
δηλώνομαι	Verb	δηλώνομαι • (dilónomai) (simple past δηλώθηκα, active form δηλώνω, passive)
είχανε	Verb	είχανε • (eíchane)
αλλαξοδρομώ	Verb	αλλαξοδρομώ • (allaxodromó) (simple past αλλαξοδρομησα)
γουστάρω	Verb	γουστάρω • (goustáro) (simple past γούσταρα or γουστάρισα)
καλωσορίζω	Verb	καλωσορίζω • (kalosorízo) (simple past καλωσόρισα)
αποκαρδιώνω	Verb	αποκαρδιώνω • (apokardióno) (simple past αποκαρδίωσα, passive form αποκαρδιώνομαι)
κατασκευάζομαι	Verb	κατασκευάζομαι • (kataskevázomai) (simple past κατασκευάστηκα, active form κατασκευάζω, passive)
εφαρμόζω	Verb	εφαρμόζω • (efarmózo) (simple past εφάρμοσα, passive form εφαρμόζομαι)
αλαφιάζω	Verb	αλαφιάζω • (alafiázo) (simple past αλάφιασα, passive form αλαφιάζομαι)
απομονώνομαι	Verb	απομονώνομαι • (apomonónomai) (simple past απομονώθηκα, active form απομονώνω, passive)
πιάνομαι	Verb	πιάνομαι • (piánomai) (simple past πιάστηκα, active form πιάνω, passive)
ακτινοσκοπώ	Verb	ακτινοσκοπώ • (aktinoskopó) (simple past ακτινοσκόπησα)
χάνομαι	Verb	χάνομαι • (chánomai) (simple past χάθηκα, active form χάνω, passive)
ξεμεθώ	Verb	ξεμεθώ • (xemethó) (simple past ξεμέθυσα)
αποκλείομαι	Verb	αποκλείομαι • (apokleíomai) (simple past αποκλείστηκα, active form αποκλείω, passive)
οδηγούμαι	Verb	οδηγούμαι • (odigoúmai) (simple past οδηγήθηκα, active form οδηγώ, passive)
φορώ	Verb	φορώ • (foró) (simple past φόρεσα, passive form φοριέμαι)
διασπώ	Verb	διασπώ • (diaspó) (simple past διέσπασα, passive form διασπώμαι)
κουρελιάζω	Verb	κουρελιάζω • (koureliázo) (simple past κουρέλιασα, passive form κουρελιάζομαι)
αντέχω	Verb	αντέχω • (antécho) (simple past άντεξα)
αγαπιέμαι	Verb	αγαπιέμαι • (agapiémai) (simple past αγαπήθηκα, active form αγαπώ, passive)
ανεβαίνω	Verb	ανεβαίνω • (anevaíno) (simple past ανέβηκα)
εκθέτω	Verb	εκθέτω • (ekthéto) (simple past εξέθεσα, passive form εκτίθεμαι)
συγχωρώ	Verb	συγχωρώ • (synchoró) (simple past συγχώρησα or συγχώρεσα, passive form συγχωρούμαι)
ξεφυτρώνω	Verb	ξεφυτρώνω • (xefytróno) (simple past ξεφύτρωσα)
θα έχεις	Verb	θα έχεις • (tha écheis)
ακουμπώ	Verb	ακουμπώ • (akoumpó) (simple past ακούμπησα, passive form ακουμπιέμαι)
δανείζομαι	Verb	δανείζομαι • (daneízomai) (simple past δανείστηκα, active form δανείζω, passive)
σερβιρίζομαι	Verb	σερβιρίζομαι • (servirízomai) (simple past σερβιρίστηκα, active form σερβιρίζω, passive)
τρυπώ	Verb	τρυπώ • (trypó) (simple past τρύπησα)
εμποδίζομαι	Verb	εμποδίζομαι • (empodízomai) (simple past εμποδίστηκα, active form εμποδίζω, passive)
κουτσαίνω	Verb	κουτσαίνω • (koutsaíno) (simple past κούτσανα)
υποθηκεύομαι	Verb	υποθηκεύομαι • (ypothikévomai) (simple past υποθηκεύτηκα or υποθηκεύθηκα, active form υποθηκεύω, passive)
ταπεινώνω	Verb	ταπεινώνω • (tapeinóno) (simple past ταπείνωσα, passive form ταπεινώνομαι)
κηρύσσομαι	Verb	κηρύσσομαι • (kirýssomai) (simple past κηρύχθηκα or κηρύχτηκα, active form κηρύσσω, passive)
συντηρούμαι	Verb	συντηρούμαι • (syntiroúmai) (simple past συντηρήθηκα, active form συντηρώ, passive)
νοικιάζω	Verb	νοικιάζω • (noikiázo) (simple past νοίκιασα, passive form νοικιάζομαι)
κατανοώ	Verb	κατανοώ • (katanoó) (simple past κατανόησα)
αναγγέλω	Verb	αναγγέλω • (anangélo) (simple past ανήγγειλα or ανάγγειλα)
φρουρώ	Verb	φρουρώ • (frouró) (simple past φρούρησα)
χαζεύω	Verb	χαζεύω • (chazévo) (simple past χάζεψα)
υποθέτω	Verb	υποθέτω • (ypothéto) (simple past υπέθεσα)
παρακάμπτω	Verb	παρακάμπτω • (parakámpto) (simple past παρέκαμψα, passive form παρακάμπτομαι)
λύνομαι	Verb	λύνομαι • (lýnomai) (simple past λύθηκα, active form λύνω, mediopassive)
διαβεβαιώνομαι	Verb	διαβεβαιώνομαι • (diavevaiónomai) (simple past διαβεβαιώθηκα, active form διαβεβαιώνω, passive)
ανακηρύσσω	Verb	ανακηρύσσω • (anakirýsso) (simple past ανακήρυξα, passive form ανακηρύσσομαι)
θυμιατίζω	Verb	θυμιατίζω • (thymiatízo) (simple past θυμιάτισα, passive form θυμιατίζομαι)
καταπίνω	Verb	καταπίνω • (katapíno) (simple past κατάπια, passive form καταπίνομαι)
αμιλλώμαι	Verb	αμιλλώμαι • (amillómai) (found only in the present tense, deponent)
ανταμείβω	Verb	ανταμείβω • (antameívo) (simple past αντάμειψα, passive form ανταμείβομαι)
αποσπώ	Verb	αποσπώ • (apospó) (simple past απέσπασα, passive form αποσπώμαι)
γεννάω	Verb	γεννάω • (gennáo) (simple past γέννησα, passive form γεννιέμαι)
χρεωστώ	Verb	χρεωστώ • (chreostó) (imperfect χρωστούσα, found only in the imperfective tenses)
εξάρτησα	Verb	εξάρτησα • (exártisa)
συστήνω	Verb	συστήνω • (systíno) (simple past σύστησα, passive form συστήνομαι)
απαρχαιώνω	Verb	απαρχαιώνω • (aparchaióno) (simple past απαρχαίωσα, passive form απαρχαιώνομαι)
διδάσκομαι	Verb	διδάσκομαι • (didáskomai) (simple past διδάχτηκα or διδάχθηκα, active form διδάσκω, passive)
αλείβομαι	Verb	αλείβομαι • (aleívomai) (simple past αλείφτηκα, active form αλείβω, passive)
γλιστρώ	Verb	γλιστρώ • (glistró) (simple past γλίστρησα)
τελούμαι	Verb	τελούμαι • (teloúmai) (simple past τελέστηκα, active form τελώ, passive)
ανοίγομαι	Verb	ανοίγομαι • (anoígomai) (simple past ανοίχτηκα, active form ανοίγω, passive)
φτιάχνομαι	Verb	φτιάχνομαι • (ftiáchnomai) (simple past φτιάχτηκα, active form φτιάχνω, passive)
συγχρονίζω	Verb	συγχρονίζω • (synchronízo) (simple past συγχρόνισα, passive form συγχρονίζομαι)
απελαύνομαι	Verb	απελαύνομαι • (apelávnomai) (simple past απελάθηκα, active form απελαύνω, passive)
αεροποιώ	Verb	αεροποιώ • (aeropoió) (simple past αεροποίησα, passive form αεροποιούμαι)
εκπαιδεύω	Verb	εκπαιδεύω • (ekpaidévo) (simple past εκπαίδευσα, passive form εκπαιδεύομαι)
αλαφροπατώ	Verb	αλαφροπατώ • (alafropató)
αρταίνω	Verb	αρταίνω • (artaíno) (simple past άρτυσα, passive form αρταίνομαι)
ανακατώνω	Verb	ανακατώνω • (anakatóno) (simple past ανακάτωσα, passive form ανακατώνομαι)
γέρνω	Verb	γέρνω • (gérno) (simple past έγειρα, passive form —)
φρυγανίζομαι	Verb	φρυγανίζομαι • (fryganízomai) (simple past φρυγανίστηκα, active form φρυγανίζω, passive)
αγκομαχάω	Verb	αγκομαχάω • (agkomacháo) (simple past αγκομαχούσα)
μπερδεύω	Verb	μπερδεύω • (berdévo) (simple past μπέρδεψα, passive form μπερδεύομαι)
ασπρίζω	Verb	ασπρίζω • (asprízo) (simple past άσπρισα, passive form ασπρίζομαι)
εκλιπαρώ	Verb	εκλιπαρώ • (ekliparó) (simple past εκλιπάρησα)
σπρώχνομαι	Verb	σπρώχνομαι • (spróchnomai) (simple past σπρώχτηκα, active form σπρώχνω, passive)
υφίσταμαι	Verb	υφίσταμαι • (yfístamai) (simple past υπέστην or υπόστηκα, deponent)
ακριβολογώ	Verb	ακριβολογώ • (akrivologó) (simple past ακριβολόγησα)
κηλιδώνω	Verb	κηλιδώνω • (kilidóno) (simple past κηλίδωσα, passive form κηλιδώνομαι)
συνδυάζομαι	Verb	συνδυάζομαι • (syndyázomai) (simple past συνδυάστηκα, active form συνδυάζω, passive)
βόσκω	Verb	βόσκω • (vósko) (simple past βόσκησα, passive form βόσκομαι)
τσουγκρίζομαι	Verb	τσουγκρίζομαι • (tsougkrízomai) (simple past τσουγκρίστηκα, active form τσουγκρίζω, passive)
καθιερώνω	Verb	καθιερώνω • (kathieróno) (simple past καθιέρωσα, passive form καθιερώνομαι)
έρχομαι	Verb	έρχομαι • (érchomai) (simple past ήρθα or ήλθα, deponent)
υποχρεώνω	Verb	υποχρεώνω • (ypochreóno) (simple past υποχρέωσα, passive form υποχρεώνομαι)
αναστατώνω	Verb	αναστατώνω • (anastatóno) (simple past αναστάτωσα, passive form αναστατώνομαι)
παροτρύνω	Verb	παροτρύνω • (parotrýno) (simple past παρότρυνα)
υπογράφομαι	Verb	υπογράφομαι • (ypográfomai) (simple past υπογράφηκα or υπογράφτηκα, active form υπογράφω, passive)
μολογάω	Verb	μολογάω • (mologáo) (simple past μολόγησα, passive form —)
τρώγομαι	Verb	τρώγομαι • (trógomai) (simple past φαγώθηκα, active form τρώω, passive)
χαίρω	Verb	χαίρω • (chaíro) (simple past —) (largely found in the expressions shown)
πατούσα	Verb	πατούσα • (patoúsa)
κρίνω	Verb	κρίνω • (kríno) (simple past έκρινα, passive form κρίνομαι)
ενεργοποιώ	Verb	ενεργοποιώ • (energopoió) (simple past ενεργοποίησα)
αντλώ	Verb	αντλώ • (antló) (simple past άντλησα, passive form αντλούμαι)
λειώνω	Verb	λειώνω • (leióno) (simple past έλειωσα)
δικαιούμαι	Verb	δικαιούμαι • (dikaioúmai) (found only in the present and imperfect tenses, deponent)
διαμορφώνω	Verb	διαμορφώνω • (diamorfóno) (simple past διαμόφωσα, passive form διαμορφώνομαι)
χαροποιώ	Verb	χαροποιώ • (charopoió) (simple past χαροποίησα)
διαδέχομαι	Verb	διαδέχομαι • (diadéchomai) (simple past διαδέχτηκα or διαδέχθηκα, deponent)
παντρεύω	Verb	παντρεύω • (pantrévo) (simple past πάντρεψα, passive form παντρεύομαι)
σχίζω	Verb	σχίζω • (schízo) (simple past έσχισα or έσκισα, passive form σχίζομαι)
αναζωογονάω	Verb	αναζωογονάω • (anazoogonáo) (simple past αναζωογόνησα)
καβαλάω	Verb	καβαλάω • (kavaláo) (simple past καβάλησα, passive form καβαλιέμαι)
χρηματοδοτώ	Verb	χρηματοδοτώ • (chrimatodotó) (simple past χρηματοδότησα)
απογαλακτίζομαι	Verb	απογαλακτίζομαι • (apogalaktízomai) (simple past απογαλακτίστηκα, active form απογαλακτίζω, passive)
κατάσχομαι	Verb	κατάσχομαι • (katáschomai) (simple past κατασχέθηκα, active form κατάσχω, passive)
βήχω	Verb	βήχω • (vícho) (simple past έβηξα)
αγιάζω	Verb	αγιάζω • (agiázo) (simple past άγιασα or αγίασα, passive form αγιάζομαι)
αεριοποιώ	Verb	αεριοποιώ • (aeriopoió) (simple past αεριοποίησα)
αποκρυπτογραφώ	Verb	αποκρυπτογραφώ • (apokryptografó) (simple past αποκρυπτογράφησα)
αλλοτριώνω	Verb	αλλοτριώνω • (allotrióno) (simple past αλλοτρίωσα, passive form αλλοτριώνομαι)
δελεάζω	Verb	δελεάζω • (deleázo) (simple past δελέασα, passive form δελεάζομαι)
μεγεθύνω	Verb	μεγεθύνω • (megethýno) (simple past μεγέθυνα)
θα έχουμε	Verb	θα έχουμε • (tha échoume)
αγαπάω	Verb	αγαπάω • (agapáo) (simple past αγάπησα)
επιδοκιμάζομαι	Verb	επιδοκιμάζομαι • (epidokimázomai) (simple past επιδοκιμάστηκα, active form επιδοκιμάζω, passive)
μεταρρυθμίζομαι	Verb	μεταρρυθμίζομαι • (metarrythmízomai) (simple past μεταρρυθμίστηκα, active form μεταρρυθμίζω, passive)
αποδοκιμάζω	Verb	αποδοκιμάζω • (apodokimázo) (simple past αποδοκίμασα, passive form αποδοκιμάζομαι)
βλάφτομαι	Verb	βλάφτομαι • (vláftomai) (simple past βλάφτηκα, active form βλάφτω, passive)
δοκιμάζω	Verb	δοκιμάζω • (dokimázo) (simple past δοκίμασα, passive form δοκιμάζομαι)
εκπαιδεύομαι	Verb	εκπαιδεύομαι • (ekpaidévomai) (simple past εκπαιδεύτηκα, active form εκπαιδεύω, passive)
προτιμώμαι	Verb	προτιμώμαι • (protimómai) (simple past προτιμήθηκα, active form προτιμώ, passive)
δανείζω	Verb	δανείζω • (daneízo) (simple past δάνεισα, passive form δανείζομαι)
κυβερνώ	Verb	κυβερνώ • (kyvernó) (simple past κυβέρνησα, passive form κυβερνιέμαι)
φαίνομαι	Verb	φαίνομαι • (faínomai) (simple past φάνηκα, deponent)
θανατώνω	Verb	θανατώνω • (thanatóno) (simple past θανάτωσα)
ληστεύομαι	Verb	ληστεύομαι • (listévomai) (simple past ληστεύτηκα, active form ληστεύω, passive)
κουτσομπολεύω	Verb	κουτσομπολεύω • (koutsompolévo) (simple past κουτσομπόλεψα, passive form κουτσομπολιέμαι)
αναπληρώνω	Verb	αναπληρώνω • (anapliróno) (simple past αναπλήρωσα, passive form αναπληρώνομαι)
μισθώνω	Verb	μισθώνω • (misthóno) (simple past μίσθωσα, passive form μισθώνομαι)
κοιμίζω	Verb	κοιμίζω • (koimízo) (simple past κοίμισα)
αβγατίζομαι	Verb	αβγατίζομαι • (avgatízomai) (simple past αβγατίστηκα, active form αβγατίζω, passive)
αποβάλλω	Verb	αποβάλλω • (apovállo) (simple past απέβαλα, passive form αποβάλλομαι)
γοητεύω	Verb	γοητεύω • (goitévo) (simple past γοήτευσα or γοήτεψα)
αριθμώ	Verb	αριθμώ • (arithmó) (simple past αρίθμησα)
βλέπω	Verb	βλέπω • (vlépo) (simple past είδα, passive form βλέπομαι)
αναλύω	Verb	αναλύω • (analýo) (simple past ανέλυσα or ανάλυσα, passive form αναλύομαι)
δρω	Verb	δρω • (dro) (simple past έδρασα)
αποξενώνω	Verb	αποξενώνω • (apoxenóno) (simple past αποξένωσα, passive form αποξενώνομαι)
αποσαφηνίζομαι	Verb	αποσαφηνίζομαι • (aposafinízomai) (simple past αποσαφηνίστηκα, active form αποσαφηνίζω, passive)
αλλοιώνω	Verb	αλλοιώνω • (alloióno) (simple past αλλοίωσα, passive form αλλοιώνομαι)
εκχωρώ	Verb	εκχωρώ • (ekchoró) (simple past εκχώρησα, passive form εκχωρούμαι)
επιτίθεμαι	Verb	επιτίθεμαι • (epitíthemai) (simple past επιτέθηκα, deponent)
αλετρίζω	Verb	αλετρίζω • (aletrízo) (simple past αλέτρισα)
αλευρώνω	Verb	αλευρώνω • (alevróno) (simple past αλεύρωσα, passive form αλευρώνομαι)
αναλώνω	Verb	αναλώνω • (analóno) (simple past αναλώσα, passive form αναλώνομαι)
αλυσοδένομαι	Verb	αλυσοδένομαι • (alysodénomai) (simple past αλυσοδέθηκα, active form αλυσοδένω, passive)
φυλάγω	Verb	φυλάγω • (fylágo) (simple past φύλαξα, passive form φυλάγομαι)
αλωνίζομαι	Verb	αλωνίζομαι • (alonízomai) (simple past αλωνίστηκα, active form αλωνίζω, passive)
στιγματίζομαι	Verb	στιγματίζομαι • (stigmatízomai) (simple past στιγματίστηκα, active form στιγματίζω, passive)
τσιμπάω	Verb	τσιμπάω • (tsimpáo) (simple past τσίμπησα, passive form τσιμπιέμαι)
κατευνάζω	Verb	κατευνάζω • (katevnázo) (simple past κατεύνασα, passive form κατευνάζομαι)
βοσκώ	Verb	βοσκώ • (voskó) (simple past βόσκησα, passive form =βοσκιέμαι)
βαλσαμώνομαι	Verb	βαλσαμώνομαι • (valsamónomai) (simple past βαλσαμώθηκα, active form βαλσαμώνω, passive)
νικάω	Verb	νικάω • (nikáo) (simple past νίκησα, passive form νικιέμαι)
μουσκεύομαι	Verb	μουσκεύομαι • (mouskévomai) (simple past μουσεύτηκα, active form μουσκεύω, passive)
στύβω	Verb	στύβω • (stývo) (simple past έστυψα, passive form στύβομαι)
υποτιμώ	Verb	υποτιμώ • (ypotimó) (simple past υποτίμησα, passive form υποτιμώμαι)
ρουφώ	Verb	ρουφώ • (roufó) (simple past ρούφηξα, passive form ρουφιέμαι)
μαρτυρώ	Verb	μαρτυρώ • (martyró) (simple past μαρτύρησα, passive form —)
παραπονιέμαι	Verb	παραπονιέμαι • (paraponiémai) (simple past παραπονέθηκα, deponent)
αγουροφέρνω	Verb	αγουροφέρνω • (agouroférno) (simple past αγουρόφερα)
ξενυχτάω	Verb	ξενυχτάω • (xenychtáo) (simple past ξενύχτησα)
τρίβω	Verb	τρίβω • (trívo) (simple past έτριψα, passive form τρίβομαι)
βάζομαι	Verb	βάζομαι • (vázomai) (simple past βάλθηκα, active form βάζω, passive)
αδρανοποιώ	Verb	αδρανοποιώ • (adranopoió) (simple past αδρανοποίησα, passive form αδρανοποιούμαι)
ακολασταίνω	Verb	ακολασταίνω • (akolastaíno) (simple past ακολάστησα)
αμφιβάλλω	Verb	αμφιβάλλω • (amfivállo) (simple past αμφέβαλα, passive form —)
αποκοιμάμαι	Verb	αποκοιμάμαι • (apokoimámai) (simple past αποκοιμήθηκα, passive)
δαγκώνομαι	Verb	δαγκώνομαι • (dagkónomai) (simple past δαγκώθηκα, active form δαγκώνω, passive)
αγκαλιάζω	Verb	αγκαλιάζω • (agkaliázo) (simple past αγκάλιασα, passive form αγκαλιάζομαι)
θερμαίνομαι	Verb	θερμαίνομαι • (thermaínomai) (simple past θερμάνθηκα, active form θερμαίνω, passive)
ψάλλω	Verb	ψάλλω • (psállo) (simple past έψαλα, passive form ψάλλομαι)
περιορίζω	Verb	περιορίζω • (periorízo) (simple past περιόρισα, passive form περιορίζομαι)
ανακύπτω	Verb	ανακύπτω • (anakýpto) (simple past ανέκυψα)
τρίζω	Verb	τρίζω • (trízo) (simple past έτριξα, passive form —)
ματοκυλώ	Verb	ματοκυλώ • (matokyló) (simple past ματοκύλισα, passive form ματοκυλιέμαι)
ακροπατώ	Verb	ακροπατώ • (akropató) (simple past ακροπάτησα)
κηρύττομαι	Verb	κηρύττομαι • (kirýttomai) (simple past κηρύχθηκα or κηρύχτηκα, active form κηρύττω, passive)
νηστεύω	Verb	νηστεύω • (nistévo) (simple past νήστεψα)
φρυγανίζω	Verb	φρυγανίζω • (fryganízo) (simple past φρυγάνισα, passive form φρυγανίζομαι)
παζαρεύω	Verb	παζαρεύω • (pazarévo) (simple past παζάρεψα)
συνοδεύομαι	Verb	συνοδεύομαι • (synodévomai) (simple past συνοδεύτηκα, active form συνοδεύω, passive)
θερμαίνω	Verb	θερμαίνω • (thermaíno) (simple past θέρμανα, passive form θερμαίνομαι)
γράφω	Verb	γράφω • (gráfo) (simple past έγραψα, passive form γράφομαι)
εξάγω	Verb	εξάγω • (exágo) (simple past εξήγαγα)
χρηματίζω	Verb	χρηματίζω • (chrimatízo) (simple past χρημάτισα, passive form χρηματίζομαι)
ξεπροβάλλω	Verb	ξεπροβάλλω • (xeprovállo) (simple past ξεπρόβαλα)
νοσταλγώ	Verb	νοσταλγώ • (nostalgó) (simple past νοστάλγησα)
σκάω	Verb	σκάω • (skáo) (simple past έσκασα)
σκίζω	Verb	σκίζω • (skízo) (simple past έσκισα or έσχισα, passive form σκίζομαι)
εκπνέω	Verb	εκπνέω • (ekpnéo) (simple past εξέπνευσα)
υπερασπίζω	Verb	υπερασπίζω • (yperaspízo) (simple past υπεράσπισα, passive form υπερασπίζομαι)
αθεΐζω	Verb	αθεΐζω • (atheḯzo) (found only in the present and imperfect tenses)
λαμβάνω	Verb	λαμβάνω • (lamváno) (simple past έλαβα, passive form λαμβάνομαι)
αγναντεύω	Verb	αγναντεύω • (agnantévo) (simple past αγνάντεψα)
μιλάω	Verb	μιλάω • (miláo) (simple past μίλησα)
αβλεπτώ	Verb	αβλεπτώ • (avleptó) (simple past —)
αραιώνω	Verb	αραιώνω • (araióno) (simple past αραίωσα)
διασπώμαι	Verb	διασπώμαι • (diaspómai) (simple past διασπάστηκα, active form διασπώ, passive)
αποκόβω	Verb	αποκόβω • (apokóvo) (simple past απέκοψα, passive form αποκόβομαι)
σούρνω	Verb	σούρνω • (soúrno) (simple past έσουρα)
αναθεματίζομαι	Verb	αναθεματίζομαι • (anathematízomai) (simple past αναθεματίστηκα, active form αναθεματίζω, passive)
αποδεκατίζομαι	Verb	αποδεκατίζομαι • (apodekatízomai) (simple past αποδεκατίστηκα, active form αποδεκατίζω, passive)
τυραννώ	Verb	τυραννώ • (tyrannó) (simple past τυράννησα, passive form τυραννιέμαι)
επιτυγχάνω	Verb	επιτυγχάνω • (epityncháno) (simple past πέτυχα or επέτυχα, passive form επιτυγχάνομαι)
αναγεννώ	Verb	αναγεννώ • (anagennó) (simple past αναγέννησα, passive form αναγεννιέμαι or αναγεννώμαι)
βελτιώνω	Verb	βελτιώνω • (veltióno) (simple past βελτίωσα, passive form βελτιώνομαι)
γράφομαι	Verb	γράφομαι • (gráfomai) (simple past γράφηκα or γράφτηκα, active form γράφω, passive)
ξεμένω	Verb	ξεμένω • (xeméno) (simple past ξέμεινα)
γρικάω	Verb	γρικάω • (grikáo) (simple past γρίκησα, passive form γρικιέμαι)
τρέφω	Verb	τρέφω • (tréfo) (simple past έθρεψα, passive form τρέφομαι)
στύβομαι	Verb	στύβομαι • (stývomai) (simple past στύφτηκα, active form στύβω, passive)
καταβροχθίζω	Verb	καταβροχθίζω • (katavrochthízo) (simple past καταβρόχθισα)
καρτεράω	Verb	καρτεράω • (karteráo) (simple past καρτέρησα)
διαδηλώνομαι	Verb	διαδηλώνομαι • (diadilónomai) (simple past διαδηλώθηκα, active form διαδηλώνω)
αρνούμαι	Verb	αρνούμαι • (arnoúmai) (simple past αρνήθηκα, deponent)
διαρρέω	Verb	διαρρέω • (diarréo) (simple past διέρρευσα)
τσαμπουνάω	Verb	τσαμπουνάω • (tsampounáo) (simple past τσαμπούνησα)
ανέρχομαι	Verb	ανέρχομαι • (anérchomai) (simple past ανήλθα, deponent)
διαιρούμαι	Verb	διαιρούμαι • (diairoúmai) (simple past διαιρέθηκα, active form διαιρώ, passive)
ωφελώ	Verb	ωφελώ • (ofeló) (simple past ωφέλησα, passive form ωφελούμαι)
μαρκάρω	Verb	μαρκάρω • (markáro) (simple past μάρκαρα or μαρκάρισα, passive form μαρκάρομαι)
απαλλάσσομαι	Verb	απαλλάσσομαι • (apallássomai) (simple past απαλλάχτηκα, active form απαλάσσω, passive)
μουσκεύω	Verb	μουσκεύω • (mouskévo) (simple past μούσκεψα, passive form μουσκεύομαι)
λιποθυμώ	Verb	λιποθυμώ • (lipothymó) (simple past λιποθύμησα, passive form —)
υπαινίσσομαι	Verb	υπαινίσσομαι • (ypainíssomai) (simple past υπαινίχθηκα, deponent)
καταντώ	Verb	καταντώ • (katantó) (simple past κατάντησα or κατήντησα, passive form —)
λαμπρύνω	Verb	λαμπρύνω • (lamprýno) (simple past λάμπρυνα, passive form λαμπρύνομαι)
ενδιαφέρομαι	Verb	ενδιαφέρομαι • (endiaféromai) (simple past ενδιαφέρθηκα, active form ενδιαφέρω, passive)
αλληλογραφώ	Verb	αλληλογραφώ • (allilografó) (simple past αλληλογράφησα)
ακτοπλοώ	Verb	ακτοπλοώ • (aktoploó)
αναζωογονούμαι	Verb	αναζωογονούμαι • (anazoogonoúmai) (simple past αναζωογονήθηκα, active form αναζωογονώ, passive)
προτείνω	Verb	προτείνω • (proteíno) (simple past πρότεινα, passive form προτείνομαι)
συμβουλεύω	Verb	συμβουλεύω • (symvoulévo) (simple past συμβούλεψα, passive form συμβουλεύομαι)
διαχωρίζω	Verb	διαχωρίζω • (diachorízo) (simple past διαχώρισα, passive form διαχωρίζομαι)
βγαίνω	Verb	βγαίνω • (vgaíno) (simple past βγήκα, passive form —)
ψωνίζω	Verb	ψωνίζω • (psonízo) (simple past ψώνισα)
αναθρέφω	Verb	αναθρέφω • (anathréfo) (simple past ανάθρεψα or ανέθρεψα, passive form αναθρέφομαι)
σχηματίζομαι	Verb	σχηματίζομαι • (schimatízomai) (simple past σχηματίστηκα, active form σχηματίζω, passive)
φέρνομαι	Verb	φέρνομαι • (férnomai) (simple past φέρθηκα, active form φέρω, mediopassive)
αναστηλώνομαι	Verb	αναστηλώνομαι • (anastilónomai) (simple past αναστηλώθηκα, active form αναστηλώνω, passive)
αδράζω	Verb	αδράζω • (adrázo) (simple past άδραξα)
περικόπτω	Verb	περικόπτω • (perikópto) (simple past περιέκοψα)
απαντάω	Verb	απαντάω • (apantáo) (simple past απάντησα, passive form απαντιέμαι or απαντώμαι)
διακρίνω	Verb	διακρίνω • (diakríno) (simple past διέκρινα)
ψιθυρίζω	Verb	ψιθυρίζω • (psithyrízo) (simple past ψιθύρισα)
βουλιάζω	Verb	βουλιάζω • (vouliázo) (simple past βούλιαξα)
συμβαίνω	Verb	συμβαίνω • (symvaíno) (simple past συνέβηκα)
επιβιβάζω	Verb	επιβιβάζω • (epivivázo) (simple past επιβίβασα, passive form επιβιβάζομαι)
βογκάω	Verb	βογκάω • (vogkáo) (simple past βόγκηξα, passive form —)
κοιμούμαι	Verb	κοιμούμαι • (koimoúmai) (simple past κοιμήθηκα, deponent)
προσαρτώμαι	Verb	προσαρτώμαι • (prosartómai) (simple past προσαρτήθηκα, active form προσαρτώ, passive)
τσαμπουνώ	Verb	τσαμπουνώ • (tsampounó) (simple past τσαμπούνησα)
λυσσώ	Verb	λυσσώ • (lyssó) (simple past λύσσαξα, passive form —)
καταλαμβάνομαι	Verb	καταλαμβάνομαι • (katalamvánomai) (simple past καταλήφθηκα, active form καταλαμβάνω, passive)
οπλίζω	Verb	οπλίζω • (oplízo) (simple past όπλισα, passive form οπλίζομαι)
ξαναβλέπω	Verb	ξαναβλέπω • (xanavlépo) (simple past ξαναείδα or ξανάδα, passive form ξαναβλέπομαι)
ανησυχώ	Verb	ανησυχώ • (anisychó) (simple past ανησύχησα)
ριζοσπαστικοποιούμαι	Verb	ριζοσπαστικοποιούμαι • (rizospastikopoioúmai) (simple past ριζοσπαστικοποιήθηκα, active form ριζοσπαστικοποιώ, passive)
ανατιμώ	Verb	ανατιμώ • (anatimó) (simple past ανατίμησα, passive form ανατιμώμαι)
θα έχω	Verb	θα έχω • (tha écho)
αναζητάω	Verb	αναζητάω • (anazitáo) (simple past αναζήτησα, passive form αναζητούμαι or αναζητιέμαι)
ζεματίζω	Verb	ζεματίζω • (zematízo) (simple past ζεμάτισα, passive form ζεματίζομαι)
αποσαθρώνω	Verb	αποσαθρώνω • (aposathróno) (simple past αποσάθρωσα, passive form αποσαθρώνομαι)
συναντώμαι	Verb	συναντώμαι • (synantómai) (simple past συναντήθηκα, active form συναντώ, passive)
κρεμάω	Verb	κρεμάω • (kremáo) (simple past κρέμασα, passive form κρεμιέμαι)
οργίζω	Verb	οργίζω • (orgízo) (simple past όργισα)
κατατίθεμαι	Verb	κατατίθεμαι • (katatíthemai) (simple past κατατέθηκα, active form καταθέτω, passive)
περιφράσσω	Verb	περιφράσσω • (perifrásso) (simple past περιέφραξα)
διακοσμώ	Verb	διακοσμώ • (diakosmó) (simple past διακόσμησα)
στερεύω	Verb	στερεύω • (sterévo) (simple past στέρεψα)
βραχνιάζω	Verb	βραχνιάζω • (vrachniázo) (simple past βράχνιασα, passive form —)
αδικούμαι	Verb	αδικούμαι • (adikoúmai) (simple past αδικήθηκα, active form αδικώ, passive)
βλάπτομαι	Verb	βλάπτομαι • (vláptomai) (simple past βλάφτηκα, active form βλάπτω, passive)
συγκινώ	Verb	συγκινώ • (sygkinó) (simple past συγκίνησα)
αναζωογονώ	Verb	αναζωογονώ • (anazoogonó) (simple past αναζωογόνησα, passive form αναζωογονούμαι)
ρυμουλκώ	Verb	ρυμουλκώ • (rymoulkó) (simple past ρυμούλκησα)
στίβω	Verb	στίβω • (stívo) (simple past έστιψα)
απατώμαι	Verb	απατώμαι • (apatómai) (simple past απατήθηκα, active form απατώ, passive)
κόπτω	Verb	κόπτω • (kópto) (simple past —)
μαγειρεύω	Verb	μαγειρεύω • (mageirévo) (simple past μαγείρεψα)
πονώ	Verb	πονώ • (ponó) (simple past πόνεσα)
βελτιώνομαι	Verb	βελτιώνομαι • (veltiónomai) (simple past βελτιώθηκα, active form βελτιώνω, passive)
φυσάω	Verb	φυσάω • (fysáo) (simple past φύσηξα)
εγκαταλείπω	Verb	εγκαταλείπω • (egkataleípo) (simple past εγκατέλειψα)
αντικρούω	Verb	αντικρούω • (antikroúo) (simple past αντέκρουσα)
εξαρτώ	Verb	εξαρτώ • (exartó) (simple past εξάρτησα, passive form εξαρτιέμαι or εξαρτώμαι)
αιδούμαι	Verb	αιδούμαι • (aidoúmai) (found only in the present tense, deponent)
πετώ	Verb	πετώ • (petó) (simple past πέταξα, passive form πετάγομαι or πετιέμαι)
αλλαξοπιστώ	Verb	αλλαξοπιστώ • (allaxopistó) (simple past αλλαξοπίστησα)
ανάβω	Verb	ανάβω • (anávo) (simple past άναψα, passive form ανάβομαι)
γρικώ	Verb	γρικώ • (grikó) (simple past γρίκησα, passive form γρικιέμαι)
αναπαριστώ	Verb	αναπαριστώ • (anaparistó) (simple past αναπαρέστησα, passive form αναπαρίσταμαι)
καρατομούμαι	Verb	καρατομούμαι • (karatomoúmai) (simple past καρατομήθηκα, active form καρατομώ, passive)
ανοίγω	Verb	ανοίγω • (anoígo) (simple past άνοιξα, passive form ανοίγομαι)
βαράω	Verb	βαράω • (varáo) (simple past βάρεσα, passive form —)
αντιτίθεμαι	Verb	αντιτίθεμαι • (antitíthemai) (simple past αντιτέθηκα, mediopassive)
αγιοποιούμαι	Verb	αγιοποιούμαι • (agiopoioúmai) (simple past αγιοποιήθηκα, active form αγιοποιώ, passive)
ερευνώ	Verb	ερευνώ • (erevnó) (simple past ερεύνησα, passive form ερευνώμαι)
αγαντάρω	Verb	αγαντάρω • (agantáro) (simple past αγάνταρα or αγαντάρισα)
καταπίνομαι	Verb	καταπίνομαι • (katapínomai) (simple past —, active form καταπίνω, passive)
κρατώ	Verb	κρατώ • (krató) (simple past κράτησα, passive form κρατιέμαι)
αποδεκατίζω	Verb	αποδεκατίζω • (apodekatízo) (simple past αποδεκάτισα, passive form αποδεκατίζομαι)
κουρεύω	Verb	κουρεύω • (kourévo) (simple past κούρεψα, passive form κουρεύομαι)
υπογραμμίζω	Verb	υπογραμμίζω • (ypogrammízo) (simple past υπογράμμισα)
αναιρώ	Verb	αναιρώ • (anairó) (simple past αναίρεσα, passive form αναιρούμαι)
ανακόπτω	Verb	ανακόπτω • (anakópto) (simple past ανέκοψα, passive form ανακόπτομαι)
δουλεύω	Verb	δουλεύω • (doulévo) (simple past δούλεψα, passive form δουλεύομαι)
είμαστε	Verb	είμαστε • (eímaste)
καταδίδομαι	Verb	καταδίδομαι • (katadídomai) (simple past καταδόθηκα, active form καταδίδω, passive)
αγνοούμαι	Verb	αγνοούμαι • (agnooúmai) (simple past αγνοήθηκα, active form αγνοώ, passive)
άγω	Verb	άγω • (ágo) (passive form άγομαι, found only in the present tense)
παιδεύω	Verb	παιδεύω • (paidévo) (simple past παίδεψα)
ταξιδεύω	Verb	ταξιδεύω • (taxidévo) (simple past ταξίδεψα)
προδίνω	Verb	προδίνω • (prodíno) (simple past πρόδωσα, passive form προδίδομαι)
διαρκώ	Verb	διαρκώ • (diarkó) (simple past διάρκεσα, passive form —)
μιλιέμαι	Verb	μιλιέμαι • (miliémai) (simple past μιλήθηκα, active form μιλώ or [[μιλάω<!-
    -->#Greek|μιλάω<!-
    -->]], passive)
προσέχω	Verb	προσέχω • (prosécho) (simple past πρόσεξα, passive form προσέχομαι)
αβαντσάρω	Verb	αβαντσάρω • (avantsáro) (simple past αβαντσάρισα)
σύρομαι	Verb	σύρομαι • (sýromai) (simple past σύρθηκα, active form σύρω, mediopassive)
κοστίζω	Verb	κοστίζω • (kostízo) (simple past κόστισα, passive form —)
σύρω	Verb	σύρω • (sýro) (simple past έσυρα, passive form σύρομαι)
πρωτοκολλώ	Verb	πρωτοκολλώ • (protokolló) (simple past πρωτοκόλλησα)
αθλοθετώ	Verb	αθλοθετώ • (athlothetó) (simple past αθλοθέτησα, passive form αθλοθετούμαι)
ακριβαίνω	Verb	ακριβαίνω • (akrivaíno) (simple past ακρίβυνα)
βόσκομαι	Verb	βόσκομαι • (vóskomai) (simple past βοσκήθηκα, active form βόσκω, passive)
ονειρεύομαι	Verb	ονειρεύομαι • (oneirévomai) (simple past ονειρεύτηκα, deponent)
θρυμματίζω	Verb	θρυμματίζω • (thrymmatízo) (simple past θρυμμάτισα, passive form θρυμματίζομαι)
σκάβομαι	Verb	σκάβομαι • (skávomai) (simple past σκάφτηκα, active form σκάβω, passive)
μαυρίζω	Verb	μαυρίζω • (mavrízo) (simple past μαύρισα)
συντηρώ	Verb	συντηρώ • (syntiró) (simple past συντήρησα)
επιθυμώ	Verb	επιθυμώ • (epithymó) (simple past επιθύμησα)
απαγορεύομαι	Verb	απαγορεύομαι • (apagorévomai) (simple past απαγορεύτηκα or απαγορεύθηκα, active form απαγορεύω, passive)
προγευματίζω	Verb	προγευματίζω • (progevmatízo) (simple past προγευμάτισα)
αθωώνω	Verb	αθωώνω • (athoóno) (simple past αθώωσα, passive form αθωώνομαι)
μολογώ	Verb	μολογώ • (mologó) (simple past μολόγησα, passive form —)
ξεσκίζομαι	Verb	ξεσκίζομαι • (xeskízomai) (simple past ξεσκίστηκα, active form ξεσκίζω, passive)
οφείλω	Verb	οφείλω • (ofeílo) (imperfect όφειλα, passive form —, found only in the imperfective tenses)
κυκλώνω	Verb	κυκλώνω • (kyklóno) (simple past κύκλωσα, passive form κυκλώνομαι)
γνωρίζομαι	Verb	γνωρίζομαι • (gnorízomai) (simple past γνωρίστηκα, active form γνωρίζω, passive)
αφυδατώνομαι	Verb	αφυδατώνομαι • (afydatónomai) (simple past αφυδατώθηκα, active form αφυδατώνω, passive)
ειδοποιώ	Verb	ειδοποιώ • (eidopoió) (simple past ειδοποίησα, passive form ειδοποιούμαι)
διαψεύδω	Verb	διαψεύδω • (diapsévdo) (simple past διέψευσα, passive form διαψεύδομαι)
αγοροφέρνω	Verb	αγοροφέρνω • (agoroférno) (found only in the present and imperfect tenses)
βιάζω	Verb	βιάζω • (viázo) (simple past βίασα, passive form βιάζομαι)
βιάζω	Verb	βιάζω • (viázo) (simple past βίασα, passive form βιάζομαι)
μεθάω	Verb	μεθάω • (metháo) (simple past μέθυσα)
καταλαβαίνω	Verb	καταλαβαίνω • (katalavaíno) (simple past κατάλαβα, passive form —)
αποσυνδέομαι	Verb	αποσυνδέομαι • (aposyndéomai) (simple past αποσυνδέθηκα, active form αποσυνδέω, passive)
κερδίζω	Verb	κερδίζω • (kerdízo) (simple past κέρδισα, passive form κερδίζομαι)
καρτερώ	Verb	καρτερώ • (karteró) (simple past καρτέρεσα)
ανακτώ	Verb	ανακτώ • (anaktó) (simple past ανέκτησα, passive form ανακτώμαι)
αλωνίζω	Verb	αλωνίζω • (alonízo) (simple past αλώνισα, passive form αλωνίζομαι)
απεργώ	Verb	απεργώ • (apergó) (simple past απήργησα or απέργησα)
φωτίζω	Verb	φωτίζω • (fotízo) (simple past φώτισα)
αμφισβητώ	Verb	αμφισβητώ • (amfisvitó) (simple past αμφισβήτησα, passive form αμφισβητούμαι)
κατακουράζω	Verb	κατακουράζω • (katakourázo) (simple past κατακούρασα)
γυρνώ	Verb	γυρνώ • (gyrnó) (simple past γύρισα, passive form γυρίζομαι)
λιώνω	Verb	λιώνω • (lióno) (simple past έλιωσα, passive form λιώνομαι)
καταρρέω	Verb	καταρρέω • (katarréo) (simple past κατέρρευσα)
ανακλώ	Verb	ανακλώ • (anakló) (simple past ανάκλασα, passive form ανακλώμαι)
τραβάω	Verb	τραβάω • (traváo) (simple past τράβηξα, passive form τραβιέμαι)
προκαλώ	Verb	προκαλώ • (prokaló) (simple past προκάλεσα)
αισχροκερδώ	Verb	αισχροκερδώ • (aischrokerdó) (simple past αισχροκέρδησα)
πληγώνω	Verb	πληγώνω • (pligóno) (simple past πλήγωσα)
αγρεύω	Verb	αγρεύω • (agrévo) (simple past άγρευσα)
παρεξηγώ	Verb	παρεξηγώ • (parexigó) (simple past παρεξήγησα)
προφταίνω	Verb	προφταίνω • (proftaíno) (simple past πρόφτασα)
διαμορφώνομαι	Verb	διαμορφώνομαι • (diamorfónomai) (simple past διαμορφώθηκα, active form διαμορφώνω, passive)
καθιστώ	Verb	καθιστώ • (kathistó) (simple past κατέστησα, passive form καθίσταμαι)
τσαμπουνίζω	Verb	τσαμπουνίζω • (tsampounízo) (simple past —, found only in the present tense)
βασκαίνομαι	Verb	βασκαίνομαι • (vaskaínomai) (simple past βασκάθηκα, active form βασκαίνω, passive)
βασανίζω	Verb	βασανίζω • (vasanízo) (simple past βασάνισα)
τυχαίνω	Verb	τυχαίνω • (tychaíno) (simple past έτυχα)
είχε	Verb	είχε • (eíche)
ακούγω	Verb	ακούγω • (akoúgo) (simple past άκουσα, passive form ακούγομαι)
σπιλώνω	Verb	σπιλώνω • (spilóno) (simple past σπίλωσα, passive form σπιλώνομαι)
άγχομαι	Verb	άγχομαι • (ánchomai) (found only in the present tense, mediopassive)
αντεπιτίθεμαι	Verb	αντεπιτίθεμαι • (antepitíthemai) (simple past αντεπιτθηκα)
απαρνιέμαι	Verb	απαρνιέμαι • (aparniémai) (simple past απαρνήθηκα, deponent)
απολλύω	Verb	απολλύω • (apollýo) (simple past απώλεσα, passive form απόλλυμαι)
φαρμακώνομαι	Verb	φαρμακώνομαι • (farmakónomai) (simple past φαρμακώθηκα, active form φαρμακώνω, passive)
κόβομαι	Verb	κόβομαι • (kóvomai) (simple past κόπηκα, active form κόβω, passive)
αναπαύω	Verb	αναπαύω • (anapávo) (simple past ανέπαυσα, passive form αναπαύομαι)
στέκω	Verb	στέκω • (stéko) (simple past —)
κλιμακώνω	Verb	κλιμακώνω • (klimakóno) (simple past κλιμάκωσα, passive form κλιμακώνομαι)
ανακαινίζομαι	Verb	ανακαινίζομαι • (anakainízomai) (simple past ανακαινίστηκα, active form ανακαινίζω, passive)
αποτρέπω	Verb	αποτρέπω • (apotrépo) (simple past απέτρεψα or απότρεψα)
αργώ	Verb	αργώ • (argó) (simple past άργησα)
απαιτούμαι	Verb	απαιτούμαι • (apaitoúmai) (simple past απαιτήθηκα, active form απαιτώ, passive)
διαδραματίζω	Verb	διαδραματίζω • (diadramatízo) (simple past διαδραμάτισα)
αγνίζω	Verb	αγνίζω • (agnízo) (simple past άγνισα, passive form αγνίζομαι)
νοιώθω	Verb	νοιώθω • (noiótho) (simple past ένοιωσα, passive form —)
στραβώνομαι	Verb	στραβώνομαι • (stravónomai) (simple past στραβώθηκα, active form στραβώνω, passive)
χρησιμοποιώ	Verb	χρησιμοποιώ • (chrisimopoió) (simple past χρησιμοποίησα, passive form χρησιμοποιούμαι)
περικόβω	Verb	περικόβω • (perikóvo) (simple past περιέκοψα)
απολαμβάνω	Verb	απολαμβάνω • (apolamváno) (simple past απόλαυσα)
φυλάω	Verb	φυλάω • (fyláo) (simple past φύλαξα, passive form φυλάγομαι)
αντανακλώ	Verb	αντανακλώ • (antanakló) (simple past αντανάκλασα, passive form αντανακλώμαι)
αγριομιλάω	Verb	αγριομιλάω • (agriomiláo) (simple past αγριομίλησα)
βουτιέμαι	Verb	βουτιέμαι • (voutiémai) (simple past βουτήχτηκα, active form βουτάω, passive)
εμφιαλώνω	Verb	εμφιαλώνω • (emfialóno) (simple past εμφιάλωσα)
κανακεύω	Verb	κανακεύω • (kanakévo) (simple past κανάκεψα)
τρίβομαι	Verb	τρίβομαι • (trívomai) (simple past τρίφτηκα, active form τρίβω, passive)
περιμένω	Verb	περιμένω • (periméno) (simple past περίμεινα, passive form —)
περιηγούμαι	Verb	περιηγούμαι • (periigoúmai) (simple past περιηγήθηκα, deponent)
αναποδογυρίζομαι	Verb	αναποδογυρίζομαι • (anapodogyrízomai) (simple past αναποδογυρίστηκα, active form αναποδογυρίζω, passive)
συμπεθεριάζω	Verb	συμπεθεριάζω • (sympetheriázo) (simple past συμπεθέριασα)
εξοπλίζομαι	Verb	εξοπλίζομαι • (exoplízomai) (simple past εξοπλίστηκα, active form εξοπλίζω, passive)
λήγω	Verb	λήγω • (lígo) (simple past έληξα, passive form —)
εκσπερματίζω	Verb	εκσπερματίζω • (ekspermatízo) (simple past εκσπερμάτισα)
γκριζάρω	Verb	γκριζάρω • (gkrizáro) (simple past γκριζάρισα)
κλώθομαι	Verb	κλώθομαι • (klóthomai) (simple past κλώστηκα, active form κλώθω, passive)
χαιρετώ	Verb	χαιρετώ • (chairetó) (simple past χαιρέτησα, passive form χαιρετιέμαι)
κοιτάζομαι	Verb	κοιτάζομαι • (koitázomai) (simple past κοιτάχτηκα, active form κοιτάζω, passive)
αναπτύσσω	Verb	αναπτύσσω • (anaptýsso) (simple past ανέπτυξα or ανάπτυξα, passive form αναπτύσσομαι)
αναθέτω	Verb	αναθέτω • (anathéto) (simple past ανέθεσα, passive form ανατίθεμαι or αναθέτομαι)
βαστιέμαι	Verb	βαστιέμαι • (vastiémai) (simple past βαστήχτηκα or βαστάχτηκα, active form βαστώ, passive)
τυλίγω	Verb	τυλίγω • (tylígo) (simple past τύλιξα, passive form τυλίγομαι, active)
αγοράζομαι	Verb	αγοράζομαι • (agorázomai) (simple past αγοράστηκα, active form αγοράζω, passive)
λανθάνω	Verb	λανθάνω • (lantháno) (simple past —, found only in the present tense)
ήσουνα	Verb	ήσουνα • (ísouna)
αλληλοσυγκρούομαι	Verb	αλληλοσυγκρούομαι • (allilosygkroúomai) (simple past αλληλοσυγκρούστηκα, deponent)
εικάζω	Verb	εικάζω • (eikázo) (found only in the present and imperfect tenses)
αθλούμαι	Verb	αθλούμαι • (athloúmai) (simple past αθλήθηκα, deponent)
εκχωρούμαι	Verb	εκχωρούμαι • (ekchoroúmai) (simple past εκχωρήθηκα, active form εκχωρώ, passive)
αμφισβητούμαι	Verb	αμφισβητούμαι • (amfisvitoúmai) (simple past αμφισβητήθηκα, active form αμφισβητώ, passive)
αναγνωρίζομαι	Verb	αναγνωρίζομαι • (anagnorízomai) (simple past αναγνωρίστηκα, active form αναγνωρίζω, passive)
παρατάω	Verb	παρατάω • (paratáo) (simple past παράτησα)
διαβεβαιώνω	Verb	διαβεβαιώνω • (diavevaióno) (simple past διαβεβαίωσα, passive form διαβεβαιώνομαι)
διασπάω	Verb	διασπάω • (diaspáo) (simple past διέσπασα, passive form διασπώμαι)
δονούμαι	Verb	δονούμαι • (donoúmai) (simple past δονήθηκα, active form δονώ, passive)
απελπίζω	Verb	απελπίζω • (apelpízo) (simple past απέλπισα, passive form απελπίζομαι)
αλληλοσπαράζομαι	Verb	αλληλοσπαράζομαι • (allilosparázomai) (simple past αλληλοσπαράχτηκα, deponent)
αναδύομαι	Verb	αναδύομαι • (anadýomai) (simple past αναδύθηκα, deponent)
θέτω	Verb	θέτω • (théto) (simple past έθεσα, passive form τίθεμαι)
αλλοτριώνομαι	Verb	αλλοτριώνομαι • (allotriónomai) (simple past αλλοτριώθηκα, active form αλλοτριώνω, passive)
χύνω	Verb	χύνω • (chýno) (simple past έχυσα)
αιματοκυλάω	Verb	αιματοκυλάω • (aimatokyláo) (simple past αιματοκύλισα, passive form αιματοκυλιέμαι)
σπω	Verb	σπω • (spo) (simple past έσπασα)
προχωράω	Verb	προχωράω • (prochoráo) (simple past προχώρησα, passive form —)
δολοφονώ	Verb	δολοφονώ • (dolofonó) (simple past δολοφόνησα)
στενοχωριέμαι	Verb	στενοχωριέμαι • (stenochoriémai) (simple past στενοχωρήθηκα, active form στενοχωρώ, mediopassive)
σαγηνεύομαι	Verb	σαγηνεύομαι • (saginévomai) (simple past σαγηνεύτηκα, active form σαγηνεύω, passive)
αγκιστρώνω	Verb	αγκιστρώνω • (agkistróno) (simple past αγκίστρωσα, passive form αγκιστρώνομαι)
βιβλιοδετώ	Verb	βιβλιοδετώ • (vivliodetó) (simple past βιβλιοδέτησα)
επιχειρώ	Verb	επιχειρώ • (epicheiró) (simple past επιχείρησα, passive form επιχειρούμαι)
πολεμάω	Verb	πολεμάω • (polemáo) (simple past πολέμησα, passive form πολεμιέμαι)
εξεμώ	Verb	εξεμώ • (exemó) (simple past εξέμεσα)
εφευρίσκω	Verb	εφευρίσκω • (efevrísko) (simple past εφεύρα or εφηύρα, passive form εφευρίσκομαι)
συμφωνώ	Verb	συμφωνώ • (symfonó) (simple past συμφώνησα, passive form συμφωνούμαι)
καταπολεμάω	Verb	καταπολεμάω • (katapolemáo) (simple past καταπολέμησα)
συλλογιέμαι	Verb	συλλογιέμαι • (syllogiémai) (simple past συλλογίστηκα)
αποκτάω	Verb	αποκτάω • (apoktáo) (simple past απέκτησα or απόκτησα, passive form αποκτιέμαι)
εξασφαλίζομαι	Verb	εξασφαλίζομαι • (exasfalízomai) (simple past εξασφαλίστηκα, active form εξασφαλίζω, passive)
μουρμουρώ	Verb	μουρμουρώ • (mourmouró) (simple past μουρμούρισα)
αρχειοθετώ	Verb	αρχειοθετώ • (archeiothetó) (simple past αρχειοθέτησα)
καβουρδίζω	Verb	καβουρδίζω • (kavourdízo) (simple past καβούρδισα, passive form καβουρδίζομαι)
αισχύνομαι	Verb	αισχύνομαι • (aischýnomai) (simple past αισχύνθηκα, deponent)
μιλώ	Verb	μιλώ • (miló) (simple past μίλησα, passive form μιλιέμαι)
αλληλοτρώγομαι	Verb	αλληλοτρώγομαι • (allilotrógomai) (deponent)
αγκαζάρω	Verb	αγκαζάρω • (agkazáro) (simple past αγκαζάρισα)
έχουν	Verb	έχουν • (échoun)
διαλύω	Verb	διαλύω • (dialýo) (simple past διέλυσα, passive form διαλύομαι)
πληκτρολογώ	Verb	πληκτρολογώ • (pliktrologó) (simple past πληκτρολόγησα, passive form πληκτρολογούμαι)
διψάω	Verb	διψάω • (dipsáo) (simple past δίψασα, passive form —)
θυμάμαι	Verb	θυμάμαι • (thymámai) (simple past θυμήθηκα, deponent)
επηρεάζω	Verb	επηρεάζω • (epireázo) (simple past επηρέασα, passive form επηρεάζομαι)
τραγουδάω	Verb	τραγουδάω • (tragoudáo) (simple past τραγούδησα, passive form τραγουδιέμαι)
κελαϊδώ	Verb	κελαϊδώ • (kelaïdó) (simple past κελάιδησα)
σχίζομαι	Verb	σχίζομαι • (schízomai) (simple past σχίστηκα, active form σχίζω, passive)
τελειώνω	Verb	τελειώνω • (teleióno) (simple past τελείωσα or τέλειωσα, passive form —)
εργάζομαι	Verb	εργάζομαι • (ergázomai) (simple past εργάστηκα, deponent)
μπαλώνω	Verb	μπαλώνω • (balóno)
διαιτώμαι	Verb	διαιτώμαι • (diaitómai) (simple past —, found only in the present and imperfect tenses, deponent)
αποβιβάζομαι	Verb	αποβιβάζομαι • (apovivázomai) (simple past αποβιβάστηκα, active form αποβιβάζω, mediopassive)
θηλάζω	Verb	θηλάζω • (thilázo) (simple past θήλασα, passive form —)
ξεχνιέμαι	Verb	ξεχνιέμαι • (xechniémai) (simple past ξεχάστηκα, active form ξεχνώ, passive)
κρύπτω	Verb	κρύπτω • (krýpto) (simple past έκρυψα)
καταφέρω	Verb	καταφέρω • (kataféro) (simple past κατέφερα, passive form καταφέρομαι)
ψοφώ	Verb	ψοφώ • (psofó) (simple past ψόφησα)
σαρώνομαι	Verb	σαρώνομαι • (sarónomai) (simple past σαρώθηκα, active form σαρώνω, passive)
πλένω	Verb	πλένω • (pléno) (simple past έπλυνα, passive form πλένομαι)
κολλιέμαι	Verb	κολλιέμαι • (kolliémai) (simple past κολλήθηκα, active form κολλώ, passive)
κοιτάζω	Verb	κοιτάζω • (koitázo) (simple past κοίταξα, passive form κοιτάζομαι)
γυρίζομαι	Verb	γυρίζομαι • (gyrízomai) (simple past γυρίστηκα, active form γυρίζω, passive)
χωρίζω	Verb	χωρίζω • (chorízo) (simple past χώρισα, passive form χωρίζομαι)
λούω	Verb	λούω • (loúo) (simple past έλουσα, passive form λούζομαι)
απορροφάω	Verb	απορροφάω • (aporrofáo) (simple past απορρόφησα)
ανακινούμαι	Verb	ανακινούμαι • (anakinoúmai) (simple past ανακινήθηκα, active form ανακινώ, passive)
απαρχαιώνομαι	Verb	απαρχαιώνομαι • (aparchaiónomai) (simple past απαρχαιώθηκα, active form απαρχαιώνω, passive)
ξυρίζω	Verb	ξυρίζω • (xyrízo) (simple past ξύρισα, passive form ξυρίζομαι)
γαργαλίζω	Verb	γαργαλίζω • (gargalízo) (simple past γαργάλισα, passive form γαργαλίζομαι)
μαντεύω	Verb	μαντεύω • (mantévo) (simple past μάντεψα)
προσχωρώ	Verb	προσχωρώ • (proschoró) (simple past προσχώρησα, passive form —)
γδέρνω	Verb	γδέρνω • (gdérno) (simple past έγδαρα, passive form γδέρνομαι)
κατασκευάζω	Verb	κατασκευάζω • (kataskevázo) (simple past κατασκεύασα, passive form κατασκευάζομαι)
κλείνομαι	Verb	κλείνομαι • (kleínomai) (simple past κλείστηκα, active form κλείνω, mediopassive)
κελαηδώ	Verb	κελαηδώ • (kelaidó) (simple past κελάηδησα)
χαίρομαι	Verb	χαίρομαι • (chaíromai) (simple past χάρηκα, deponent)
γαργαλώ	Verb	γαργαλώ • (gargaló) (simple past γαργάλησα, passive form γαργαλιέμαι)
αιμάσσω	Verb	αιμάσσω • (aimásso) (found only in the present tense)
λιώνομαι	Verb	λιώνομαι • (liónomai) (simple past λιώθηκα, active form λιώνω, passive)
αναπηδώ	Verb	αναπηδώ • (anapidó) (simple past αναπήδησα)
σβύνω	Verb	σβύνω • (svýno) (simple past έσβησα)
ξενυχτίζω	Verb	ξενυχτίζω • (xenychtízo) (simple past ξενύχτισα)
κεντρίζομαι	Verb	κεντρίζομαι • (kentrízomai) (simple past κεντρίστηκα, active form κεντρίζω, passive)
άγομαι	Verb	άγομαι • (ágomai) (active form άγω, found only in the present and imperfect tenses, passive)
καταδίδω	Verb	καταδίδω • (katadído) (simple past κατέδωσα or κατάδωσα, passive form καταδίδομαι)
πλημμυρίζω	Verb	πλημμυρίζω • (plimmyrízo) (simple past πλημμύρισα)
ανατινάζομαι	Verb	ανατινάζομαι • (anatinázomai) (simple past ανατινάχτηκα, active form ανατινάζω, passive)
μπαίνω	Verb	μπαίνω • (baíno) (simple past μπήκα, passive form —)
απειλώ	Verb	απειλώ • (apeiló) (simple past απείλησα, passive form απειλούμαι)
εξαρτιέμαι	Verb	εξαρτιέμαι • (exartiémai) (simple past εξαρτήθηκα, active form εξαρτώ, passive)
επαρκώ	Verb	επαρκώ • (eparkó) (found only in the present and imperfect tenses)
αγκωνιάζω	Verb	αγκωνιάζω • (agkoniázo) (simple past αγκώνιασα, passive form αγκωνιάζομαι)
κεντρίζω	Verb	κεντρίζω • (kentrízo) (simple past κέντρισα, passive form κεντρίζομαι)
λαβαίνω	Verb	λαβαίνω • (lavaíno) (simple past έλαβα, passive form —)
ξεύρω	Verb	ξεύρω • (xévro) (simple past ήξευρα)
αποσπώμαι	Verb	αποσπώμαι • (apospómai) (simple past αποσπάστηκα, active form αποσπώ, passive)
κυνηγιέμαι	Verb	κυνηγιέμαι • (kynigiémai) (simple past κυγηνήθηκα, active form κυνηγάω, passive)
ανιχνεύω	Verb	ανιχνεύω • (anichnévo) (simple past ανίχνευσα, passive form ανιχνεύομαι)
αναπτερώνω	Verb	αναπτερώνω • (anapteróno) (simple past αναπτέρωσα, passive form αναπτερώνομαι)
ξοδεύω	Verb	ξοδεύω • (xodévo) (simple past ξόδεψα, passive form ξοδεύομαι)
ενοχλούμαι	Verb	ενοχλούμαι • (enochloúmai) (simple past ενοχλήθηκα, active form ενοχλώ, passive)
ανακόπτομαι	Verb	ανακόπτομαι • (anakóptomai) (simple past ανακόπηκα, active form ανακόπτω, passive)
παρασκευάζω	Verb	παρασκευάζω • (paraskevázo) (simple past παρασκεύασα, passive form παρασκευάζομαι)
διευκρινίζομαι	Verb	διευκρινίζομαι • (diefkrinízomai) (simple past διευκρινίστηκα, active form διευκρινίζω, passive)
προτιμάω	Verb	προτιμάω • (protimáo) (simple past προτίμησα, passive form προτιμώμαι)
αποκεφαλίζω	Verb	αποκεφαλίζω • (apokefalízo) (simple past αποκεφάλισα, passive form αποκεφαλίζομαι)
ανακατώνομαι	Verb	ανακατώνομαι • (anakatónomai) (simple past ανακατώθηκα, active form ανακατεύω, mediopassive)
συντάσσω	Verb	συντάσσω • (syntásso) (simple past συνέταξα)
λείπω	Verb	λείπω • (leípo) (simple past έλειψα, passive form —)
προσαρμόζω	Verb	προσαρμόζω • (prosarmózo) (simple past προσάρμοσα, passive form προσαρμόζομαι)
αποκόπτω	Verb	αποκόπτω • (apokópto) (simple past απέκοψα)
αναπνέω	Verb	αναπνέω • (anapnéo) (simple past ανέπνευσα or ανάπνευσα)
θρηνώ	Verb	θρηνώ • (thrinó) (simple past θρήνησα, passive form θρηνούμαι)
γαρνίρομαι	Verb	γαρνίρομαι • (garníromai) (simple past γαρνιρίστηκα, active form γαρνίρω, passive)
αγκυροβολάω	Verb	αγκυροβολάω • (agkyrovoláo) (simple past αγκυροβόλησα)
ντύνω	Verb	ντύνω • (dýno) (simple past έντυσα, passive form ντύνομαι)
αποστηθίζομαι	Verb	αποστηθίζομαι • (apostithízomai) (simple past —, active form αποστηθίζω, passive)
αποπλέω	Verb	αποπλέω • (apopléo) (simple past απέπλευσα)
αποθηκεύω	Verb	αποθηκεύω • (apothikévo) (simple past αποθήκευσα or αποθήκεψα, passive form αποθηκεύομαι)
πιπώνομαι	Verb	πιπώνομαι • (pipónomai) (simple past πιπώθηκα, active form πιπώνω, passive)
ξεσχίζω	Verb	ξεσχίζω • (xeschízo) (simple past ξέσχισα, passive form ξεσχίζομαι)
παρκάρομαι	Verb	παρκάρομαι • (parkáromai) (simple past παρκαρίστηκα, active form παρκάρω, passive)
αφιερώνω	Verb	αφιερώνω • (afieróno) (simple past αφιέρωσα)
αιχμαλωτίζομαι	Verb	αιχμαλωτίζομαι • (aichmalotízomai) (simple past αιχμαλωτίστηκα, active form αιχμαλωτίζω, passive)
ανακουφίζω	Verb	ανακουφίζω • (anakoufízo) (simple past ανακούφισα, passive form ανακουφίζομαι)
προσθέτομαι	Verb	προσθέτομαι • (prosthétomai) (simple past προστέθηκα, active form προσθέτω, passive)
παραχαϊδεύω	Verb	παραχαϊδεύω • (parachaïdévo) (simple past παραχάιδεψα)
επισκευάζω	Verb	επισκευάζω • (episkevázo) (simple past επισκεύασα)
χρεώνομαι	Verb	χρεώνομαι • (chreónomai) (simple past χρεώθηκα, active form χρεώνω, passive)
αναταράζω	Verb	αναταράζω • (anatarázo) (simple past ανατάραξα, passive form αναταράζομαι)
απαρνούμαι	Verb	απαρνούμαι • (aparnoúmai) (simple past απαρνήθηκα, deponent)
σπαράζω	Verb	σπαράζω • (sparázo) (simple past σπάραξα, passive form σπαράζομαι)
είναι	Verb	είναι • (eínai)
αμαυρώνομαι	Verb	αμαυρώνομαι • (amavrónomai) (simple past αμαυρώθηκα, active form αμαυρώνω, passive)
χρηματίζομαι	Verb	χρηματίζομαι • (chrimatízomai) (simple past χρηματίστηκα, active form χρηματίζω, passive)
λαλώ	Verb	λαλώ • (laló) (simple past λάλησα)
ξαναλέγω	Verb	ξαναλέγω • (xanalégo) (simple past ξανάπα or ξαναείπα)
πλάθω	Verb	πλάθω • (plátho) (simple past έπλασα, passive form πλάθομαι, active)
γελιέμαι	Verb	γελιέμαι • (geliémai) (simple past γελάστηκα, active form γελάω, passive)
απασχολώ	Verb	απασχολώ • (apascholó) (simple past απασχόλησα, passive form απασχολούμαι)
σέρνω	Verb	σέρνω • (sérno) (simple past έσυρα, passive form σέρνομαι)
άδω	Verb	άδω • (ádo) (found only in the present and imperfect tenses)
χαϊδεύω	Verb	χαϊδεύω • (chaïdévo) (simple past χάιδεψα)
ψεύδομαι	Verb	ψεύδομαι • (psévdomai) (found only in the present and imperfect tenses, deponent)
ηξεύρω	Verb	ηξεύρω • (ixévro) (simple past ήξευρα)
αξίζω	Verb	αξίζω • (axízo) (found only in the present and imperfect tenses)
αγγλοποιώ	Verb	αγγλοποιώ • (anglopoió) (simple past αγγλοποίησα, passive form αγγλοποιούμαι)
συνεισφέρω	Verb	συνεισφέρω • (syneisféro) (simple past συνεισέφερα)
εξυψώνω	Verb	εξυψώνω • (exypsóno) (simple past εξύψωσα)
προσέχομαι	Verb	προσέχομαι • (proséchomai) (simple past προσέχτηκα, active form προσέχω, passive)
αποτολμώ	Verb	αποτολμώ • (apotolmó) (simple past αποτόλμησα)
ξεμεθάω	Verb	ξεμεθάω • (xemetháo) (simple past ξεμέθυσα)
απλώνω	Verb	απλώνω • (aplóno) (simple past άπλωσα, passive form απλώνομαι)
χτυπώ	Verb	χτυπώ • (chtypó) (simple past χτύπησα)
αφήνω	Verb	αφήνω • (afíno) (simple past άφησα)
καταφέρομαι	Verb	καταφέρομαι • (kataféromai) (simple past καταφέρθηκα, active form καταφέρω, passive)
φθάνω	Verb	φθάνω • (ftháno) (simple past έφθασα, passive form —)
ρουφιέμαι	Verb	ρουφιέμαι • (roufiémai) (simple past ρουφήχτηκα, active form ρουφώ, passive)
νοικιάζομαι	Verb	νοικιάζομαι • (noikiázomai) (simple past νοικιάστηκα, active form νοικιάζω, passive)
λογοκρίνομαι	Verb	λογοκρίνομαι • (logokrínomai) (simple past λογοκρίθηκα, active form λογοκρίνω, passive)
σπάω	Verb	σπάω • (spáo) (simple past έσπασα)
αποτιμώ	Verb	αποτιμώ • (apotimó) (simple past αποτίμησα, passive form αποτιμώμαι)
πουλώ	Verb	πουλώ • (pouló) (simple past πούλησα, passive form πουλιέμαι)
μασώ	Verb	μασώ • (masó) (simple past μάσησα)
βασκαίνω	Verb	βασκαίνω • (vaskaíno) (simple past βάσκανα, passive form βασκαίνομαι)
ευνοώ	Verb	ευνοώ • (evnoó) (simple past ευνόησα)
ανακρίνω	Verb	ανακρίνω • (anakríno) (simple past ανέκρινα or ανάκρινα, passive form ανακρίνομαι)
δημοσιεύω	Verb	δημοσιεύω • (dimosiévo) (simple past δημοσίευσα, passive form δημοσιεύομαι)
τσιμπώ	Verb	τσιμπώ • (tsimpó) (simple past τσίμπησα, passive form τσιμπιέμαι)
μουρμουράω	Verb	μουρμουράω • (mourmouráo) (simple past μουρμούρισα)
επισυνάπτω	Verb	επισυνάπτω • (episynápto) (simple past επισύναψα)
κουβαλώ	Verb	κουβαλώ • (kouvaló) (simple past κουβάλησα, passive form κουβαλιέμαι)
θεραπεύω	Verb	θεραπεύω • (therapévo) (simple past θεράπευσα, passive form θεραπεύομαι)
αθροίζω	Verb	αθροίζω • (athroízo) (simple past άθροισα, passive form αθροίζομαι)
αποστέλλω	Verb	αποστέλλω • (apostéllo) (simple past απέστειλα)
αλείφομαι	Verb	αλείφομαι • (aleífomai) (simple past αλείφτηκα, active form αλείφω, passive)
χωρώ	Verb	χωρώ • (choró) (simple past χώρεσα)
φιλοσοφώ	Verb	φιλοσοφώ • (filosofó) (simple past φιλοσόφησα)
ωφελούμαι	Verb	ωφελούμαι • (ofeloúmai) (simple past ωφελήθηκα, active form ωφελώ, mediopassive)
κάθομαι	Verb	κάθομαι • (káthomai) (simple past κάθισα or έκατσα, deponent)
αρχινίζω	Verb	αρχινίζω • (archinízo) (simple past αρχίνισα)
χρειάζομαι	Verb	χρειάζομαι • (chreiázomai) (simple past χρειάστηκα, deponent)
πλάθομαι	Verb	πλάθομαι • (pláthomai) (simple past πλάστηκα, active form πλάθω, passive)
αγχώνομαι	Verb	αγχώνομαι • (anchónomai) (simple past αγχώθηκα, active form αγχώνω, mediopassive)
ταπεινώνομαι	Verb	ταπεινώνομαι • (tapeinónomai) (simple past ταπεινώθηκα, active form ταπεινώνω, mediopassive)
αλμυρίζω	Verb	αλμυρίζω • (almyrízo) (simple past αλμύρισα)
αληθεύω	Verb	αληθεύω • (alithévo) (simple past αλήθεψα)
προστίθεμαι	Verb	προστίθεμαι • (prostíthemai) (simple past προστέθηκα, active form προσθέτω, passive)
παρεισφρέω	Verb	παρεισφρέω • (pareisfréo) (simple past παρεισέφρησα)
γελάω	Verb	γελάω • (geláo) (simple past γέλασα, passive form γελιέμαι)
χάνω	Verb	χάνω • (cháno) (simple past έχασα, passive form χάνομαι)
τραυματίζω	Verb	τραυματίζω • (travmatízo) (simple past τραυμάτισα)
διπλασιάζω	Verb	διπλασιάζω • (diplasiázo) (simple past διπλασίασα, passive form διπλασιάζομαι)
σαρώνω	Verb	σαρώνω • (saróno) (simple past σάρωσα, passive form σαρώνομαι)
επαναφέρω	Verb	επαναφέρω • (epanaféro) (simple past επανέφερα)
λυπώ	Verb	λυπώ • (lypó) (simple past λύπησα, passive form λυπάμαι or λυπούμαι)
κρατικοποιούμαι	Verb	κρατικοποιούμαι • (kratikopoioúmai) (simple past κρατικοποιήθηκα, active form κρατικοποιώ, passive)
στοιχειώνω	Verb	στοιχειώνω • (stoicheióno) (simple past στοίχειωσα)
εξαπατώ	Verb	εξαπατώ • (exapató) (simple past εξαπάτησα)
αποκοιμίζω	Verb	αποκοιμίζω • (apokoimízo) (simple past αποκοίμισα, passive form αποκοιμίζομαι)
κρατάω	Verb	κρατάω • (kratáo) (simple past κράτησα, passive form κρατιέμαι)
βγάζομαι	Verb	βγάζομαι • (vgázomai) (simple past βγάλθηκα, active form βγάζω, passive)
βλαστάνω	Verb	βλαστάνω • (vlastáno) (simple past βλάστησα)
περπατάω	Verb	περπατάω • (perpatáo) (simple past περπάτησα)
δουλεύομαι	Verb	δουλεύομαι • (doulévomai) (simple past δουλεύτηκα, active form δουλεύω, passive)
αποστάζω	Verb	αποστάζω • (apostázo) (simple past απόσταξα or απέσταξα)
τερματίζομαι	Verb	τερματίζομαι • (termatízomai) (simple past τερματίστηκα, active form τερματίζω, passive)
σερβίρομαι	Verb	σερβίρομαι • (servíromai) (simple past σερβιρίστηκα, active form σερβίρω, passive)
ακονίζω	Verb	ακονίζω • (akonízo) (simple past ακόνισα, passive form ακονίζομαι)
ηχώ	Verb	ηχώ • (ichó) (simple past ήχησα)
μαχαιρώνω	Verb	μαχαιρώνω • (machairóno) (simple past μαχαίρωσα, passive form μαχαιρώνωμαι)
αιτιολογούμαι	Verb	αιτιολογούμαι • (aitiologoúmai) (simple past αιτιολογήθηκα, active form αιτιολογώ, passive)
ενώνω	Verb	ενώνω • (enóno) (simple past ένωσα, passive form ενώνομαι)
αλιεύομαι	Verb	αλιεύομαι • (aliévomai) (simple past αλιεύτηκα or αλιεύθηκα, active form αλιεύω, passive)
πολιορκούμαι	Verb	πολιορκούμαι • (poliorkoúmai) (simple past πολιορκήθηκα, active form πολιορκώ, passive)
απομιμούμαι	Verb	απομιμούμαι • (apomimoúmai) (simple past απομιμήθηκα, deponent)
αγριεύομαι	Verb	αγριεύομαι • (agriévomai) (simple past αγριεύτηκα, active form αγριεύω, passive)
αδελφώνομαι	Verb	αδελφώνομαι • (adelfónomai) (simple past αδελφώθηκα, active form αδελφώνω, passive)
πέρδομαι	Verb	πέρδομαι • (pérdomai) (found only in the present tense, deponent)
καταντάω	Verb	καταντάω • (katantáo) (simple past κατάντησα, passive form —)
παραδίνομαι	Verb	παραδίνομαι • (paradínomai) (simple past παραδόθηκα, active form παραδίνω, mediopassive)
δείχνομαι	Verb	δείχνομαι • (deíchnomai) (simple past δείχτηκα, active form δείχνω, passive)
μεγαλώνω	Verb	μεγαλώνω • (megalóno) (simple past μεγάλωσα)
βαριακούω	Verb	βαριακούω • (variakoúo) (found only in the present tense)
επακολουθώ	Verb	επακολουθώ • (epakolouthó) (simple past ακολούθησα)
παρέχω	Verb	παρέχω • (parécho) (simple past παρείχα, passive form παρέχομαι)
κρυπτογραφώ	Verb	κρυπτογραφώ • (kryptografó) (simple past κρυπτωγράφησα)
σφραγίζω	Verb	σφραγίζω • (sfragízo) (simple past σφράγισα)
ετοιμάζομαι	Verb	ετοιμάζομαι • (etoimázomai) (simple past ετοιμάστηκα, active form ετοιμάζω, mediopassive)
αιτιάζομαι	Verb	αιτιάζομαι • (aitiázomai) (found only in the present tense, deponent)
ράπτω	Verb	ράπτω • (rápto) (simple past —)
αγαπώ	Verb	αγαπώ • (agapó) (simple past αγάπησα, passive form αγαπιέμαι)
διοικώ	Verb	διοικώ • (dioikó) (simple past διοίκησα)
αρκούμαι	Verb	αρκούμαι • (arkoúmai) (simple past αρκέστηκα, active form αρκώ, passive)
ενθαρρύνω	Verb	ενθαρρύνω • (entharrýno) (simple past ενθάρρυνα, passive form ενθαρρύνομαι)
λειαίνομαι	Verb	λειαίνομαι • (leiaínomai) (simple past λειάνθηκα, active form λειαίνω, passive)
δροσίζομαι	Verb	δροσίζομαι • (drosízomai) (simple past δροσίστηκα, active form δροσίζω, passive)
αγριοκοιτάζομαι	Verb	αγριοκοιτάζομαι • (agriokoitázomai) (simple past αγριοκοιτάχτηκα, active form αγριοκοιτάζω, passive)
φρεσκάρω	Verb	φρεσκάρω • (freskáro) (simple past φρέσκαρα or φρεσκάρισα, passive form φρεσκάρομαι, active)
προκαταβάλλομαι	Verb	προκαταβάλλομαι • (prokatavállomai) (simple past προκαταβλήθηκα, active form προκαταβάλλω, passive)
μαρκάρομαι	Verb	μαρκάρομαι • (markáromai) (simple past μαρκαρίστηκα, active form μαρκάρω, passive)
ακολουθούμαι	Verb	ακολουθούμαι • (akolouthoúmai) (simple past ακολουθήθηκα, active form ακολουθώ, passive)
συστήνομαι	Verb	συστήνομαι • (systínomai) (simple past συστήθηκα, active form συστήνω, passive)
φυλώ	Verb	φυλώ • (fyló) (simple past φύλαξα, passive form φυλάγομαι)
κουδουνίζω	Verb	κουδουνίζω • (koudounízo) (simple past κουδούνισα)
αράζω	Verb	αράζω • (arázo) (simple past άραξα)
κλειδώνομαι	Verb	κλειδώνομαι • (kleidónomai) (simple past κλειδώθηκα, active form κλειδώνω, passive)
σπέρνω	Verb	σπέρνω • (spérno) (simple past έσπειρα, passive form σπέρνομαι)
ικανοποιώ	Verb	ικανοποιώ • (ikanopoió) (simple past ικανοποίησα, passive form ινκανοποιούμαι)
ήμουνα	Verb	ήμουνα • (ímouna)
συμπληρώνομαι	Verb	συμπληρώνομαι • (symplirónomai) (simple past συμπληρώθηκα, active form συμπληρώνω, passive)
βιδώνω	Verb	βιδώνω • (vidóno) (simple past βίδωσα)
καρφώνομαι	Verb	καρφώνομαι • (karfónomai) (simple past καρφώθηκα, active form καρφώνω, passive)
δύω	Verb	δύω • (dýo) (simple past έδυσα)
βλέπομαι	Verb	βλέπομαι • (vlépomai) (simple past ειδώθηκα, active form βλέπω, mediopassive)
διαφωνώ	Verb	διαφωνώ • (diafonó) (simple past διαφώνησα, passive form —)
ενδιαφέρω	Verb	ενδιαφέρω • (endiaféro) (passive form ενδιαφέρομαι, found only in the present and imperfect tenses)
κάνω	Verb	κάνω • (káno) (simple past έκανα, passive form —)
πας	Verb	πας • (pas)
αδυνατώ	Verb	αδυνατώ • (adynató) (found only in the present and imperfect tenses)
ματιάζω	Verb	ματιάζω • (matiázo) (simple past μάτιασα)
σκοτώνω	Verb	σκοτώνω • (skotóno) (simple past σκότωσα, passive form σκοτώνομαι)
πλαγιάζω	Verb	πλαγιάζω • (plagiázo) (simple past πλάγιασα)
ακροβατώ	Verb	ακροβατώ • (akrovató) (simple past ακροβάτησα)
προφέρω	Verb	προφέρω • (proféro) (simple past πρόφερα)
καταργώ	Verb	καταργώ • (katargó) (simple past κατάργησα or κατήργησα)
εξατμίζω	Verb	εξατμίζω • (exatmízo) (simple past εξάτμισα, passive form εξατμίζομαι)
πλένομαι	Verb	πλένομαι • (plénomai) (simple past πλύθηκα, active form πλένω, passive)
καταδιώκω	Verb	καταδιώκω • (katadióko) (simple past καταδίωξα, passive form καταδιώκομαι)
εκλέγω	Verb	εκλέγω • (eklégo) (simple past εξέλεξα, passive form εκλέγομαι)
αποφασίζομαι	Verb	αποφασίζομαι • (apofasízomai) (simple past αποφασίστηκα, active form αποφασίζω, passive)
αγαθοφέρνω	Verb	αγαθοφέρνω • (agathoférno) (imperfect αγαθόφερνα, found only in the present and imperfect tenses)
αιφνιδιάζομαι	Verb	αιφνιδιάζομαι • (aifnidiázomai) (simple past αιφνιδιάστηκα, active form αιφνιδιάζω, passive)
ποδηλατώ	Verb	ποδηλατώ • (podilató) (simple past ποδηλάτησα)
βουτάω	Verb	βουτάω • (voutáo) (simple past βούτηξα, passive form βουτιέμαι)
κατονομάζω	Verb	κατονομάζω • (katonomázo) (simple past κατονόμασα)
πολεμώ	Verb	πολεμώ • (polemó) (simple past πολέμησα, passive form πολεμιέμαι)
επιβάλλομαι	Verb	επιβάλλομαι • (epivállomai) (simple past επιβλήθηκα, active form επιβάλλω, passive)
αποπαίρνω	Verb	αποπαίρνω • (apopaírno) (simple past αποπήρα)
μετράω	Verb	μετράω • (metráo) (simple past μέτρησα, passive form μετριέμαι)
καταπολεμώ	Verb	καταπολεμώ • (katapolemó) (simple past καταπολέμησα, passive form καταπολεμούμαι)
χαχανίζω	Verb	χαχανίζω • (chachanízo) (simple past χαχάνισα)
αλληλοβοηθούμαι	Verb	αλληλοβοηθούμαι • (allilovoithoúmai) (simple past αλληλοβοηθήθηκα, deponent)
σκαλίζω	Verb	σκαλίζω • (skalízo) (simple past σκάλισα)
αναβλύζω	Verb	αναβλύζω • (anavlýzo) (simple past ανέβλυσα or ανάβλυσα)
οδηγάω	Verb	οδηγάω • (odigáo) (simple past οδήγησα, passive form οδηγούμαι)
παρηγορούμαι	Verb	παρηγορούμαι • (parigoroúmai) (simple past παρηγορήθηκα, active form παρηγορώ, passive)
αρχινώ	Verb	αρχινώ • (archinó) (simple past αρχίνησα, passive form —)
ξεσκίζω	Verb	ξεσκίζω • (xeskízo) (simple past ξέσκισα, passive form ξεσκίζομαι)
ενοχλώ	Verb	ενοχλώ • (enochló) (simple past ενόχλησα, passive form ενοχλούμαι)
επιχειρούμαι	Verb	επιχειρούμαι • (epicheiroúmai) (simple past επιχειρήθηκα, active form επιχειρώ, passive)
ενισχύομαι	Verb	ενισχύομαι • (enischýomai) (simple past ενισχύθηκα, active form ενισχύω, passive)
αεροποιούμαι	Verb	αεροποιούμαι • (aeropoioúmai) (simple past αεροποιήθηκα, active form αεροποιώ, passive)
γεμίζω	Verb	γεμίζω • (gemízo) (simple past γέμισα)
δειγματίζομαι	Verb	δειγματίζομαι • (deigmatízomai) (simple past δειγματίστηκα, active form δειγματίζω, passive)
συναντάω	Verb	συναντάω • (synantáo) (simple past συνάντησα, passive form συναντιέμαι or συναντώμαι)
σαγηνεύω	Verb	σαγηνεύω • (saginévo) (simple past σαγήνεψα, passive form σαγηνεύομαι)
σιγοβράζω	Verb	σιγοβράζω • (sigovrázo) (simple past σιγόβρασα)
πουστεύω	Verb	πουστεύω • (poustévo) (simple past πούστεψα)
ελέγχω	Verb	ελέγχω • (eléncho) (simple past έλεγξα, passive form ελέγχομαι)
παρηγορώ	Verb	παρηγορώ • (parigoró) (simple past παρηγόρησα, passive form παρηγορούμαι or παρηγοριέμαι)
βραχυκυκλώνω	Verb	βραχυκυκλώνω • (vrachykyklóno) (simple past βραχυκύκλωσα, passive form βραχυκυκλώνομαι)
αιματοκυλίζω	Verb	αιματοκυλίζω • (aimatokylízo) (simple past αιματοκύλισα, passive form αιματοκυλίζομαι)
αναταράζομαι	Verb	αναταράζομαι • (anatarázomai) (simple past αναταράχτηκα, active form αναταράζω, passive)
χλιμιντράω	Verb	χλιμιντράω • (chlimintráo) (simple past χλιμίντρισα)
κολυμπάω	Verb	κολυμπάω • (kolympáo) (simple past κολύμπησα)
μετακομίζω	Verb	μετακομίζω • (metakomízo) (simple past μετακόμισα)
λούζομαι	Verb	λούζομαι • (loúzomai) (simple past λούστηκα, active form λούζω, mediopassive)
θα είσαστε	Verb	θα είσαστε • (tha eísaste) (tha eísaste)
δειλιάζω	Verb	δειλιάζω • (deiliázo) (simple past δείλιασα, passive form —)
αντιπαραβάλλομαι	Verb	αντιπαραβάλλομαι • (antiparavállomai) (simple past αντιπαραβλήθηκα, active form αντιπαραβάλλω, passive)
ξεχνάω	Verb	ξεχνάω • (xechnáo) (simple past ξέχασα, passive form ξεχνιέμαι)
κλίνω	Verb	κλίνω • (klíno) (simple past έκλινα, passive form κλίνομαι)
αλληλοαπάγομαι	Verb	αλληλοαπάγομαι • (alliloapágomai) (simple past αλληλοαπάχθηκα, deponent)
εκπίπτω	Verb	εκπίπτω • (ekpípto) (simple past εξέπεσα, passive form —)
απομονώνω	Verb	απομονώνω • (apomonóno) (simple past απομόνωσα, passive form απομονώνομαι)
βασίζω	Verb	βασίζω • (vasízo) (simple past βάσισα, passive form βασίζομαι)
απεχθάνομαι	Verb	απεχθάνομαι • (apechthánomai) (found only in the present and imperfect tenses)
κατουριέμαι	Verb	κατουριέμαι • (katouriémai) (simple past κατουρήθηκα, active form κατουρώ, passive)
γλεντώ	Verb	γλεντώ • (glentó) (simple past γλέντησα, passive form —)
θεωρώ	Verb	θεωρώ • (theoró) (simple past θεώρησα, passive form θεωρούμαι)
συνέρχομαι	Verb	συνέρχομαι • (synérchomai) (simple past συνήλθα, passive form deponent)
κινούμαι	Verb	κινούμαι • (kinoúmai) (simple past κινήθηκα, active form κινάω, passive)
απαστράπτω	Verb	απαστράπτω • (apastrápto) (simple past —, found only in the present tense)
αποβάλλομαι	Verb	αποβάλλομαι • (apovállomai) (simple past αποβλήθηκα, active form αποβάλλω, passive)
αμελώ	Verb	αμελώ • (ameló) (simple past αμέλησα)
αγνωμονώ	Verb	αγνωμονώ • (agnomonó) (found only in the present and imperfect tenses)
ζυγίζω	Verb	ζυγίζω • (zygízo) (simple past ζύγισα, passive form ζυγίζομαι)
ασπάζομαι	Verb	ασπάζομαι • (aspázomai) (simple past ασπάστηκα, deponent)
λέγω	Verb	λέγω • (légo) (simple past είπα, passive form λέγομαι)
βρίσκω	Verb	βρίσκω • (vrísko) (simple past βρήκα, passive form βρίσκομαι)
πασπαλίζω	Verb	πασπαλίζω • (paspalízo) (simple past πασπάλισα, passive form πασπαλίζομαι)
μυρίζομαι	Verb	μυρίζομαι • (myrízomai) (simple past μυρίστηκα, active form μυρίζω, passive)
διαθλώ	Verb	διαθλώ • (diathló) (simple past διέθλασα, passive form διαθλώμαι)
μελετιέμαι	Verb	μελετιέμαι • (meletiémai) (simple past μελετήθηκα, active form μελετώ, passive)
αποκτώμαι	Verb	αποκτώμαι • (apoktómai) (simple past αποκτήθηκα, active form αποκτώ, passive)
ανηφορίζω	Verb	ανηφορίζω • (aniforízo) (simple past ανηφόρισα)
συγγράφω	Verb	συγγράφω • (syngráfo) (simple past συνέγραψα)
ακαματεύω	Verb	ακαματεύω • (akamatévo) (simple past ακαμάτεψα)
αγχώνω	Verb	αγχώνω • (anchóno) (simple past άγχωσα, passive form αγχώνομαι)
αβγατίζω	Verb	αβγατίζω • (avgatízo) (simple past αβγάτισα, passive form αβγατίζομαι)
απατάω	Verb	απατάω • (apatáo) (simple past απάτησα, passive form απατώμαι)
ακονίζομαι	Verb	ακονίζομαι • (akonízomai) (simple past ακονίστηκα, active form ακονίζω, passive)
ζαλίζομαι	Verb	ζαλίζομαι • (zalízomai) (simple past ζαλίστηκα, active form ζαλίζω, passive)
προσδοκώ	Verb	προσδοκώ • (prosdokó) (simple past —, passive form προσδοκώμαι, found only in the present and imperfect tenses)
ορκίζω	Verb	ορκίζω • (orkízo) (simple past όρκισα, passive form ορκίζομαι)
αποστειρώνω	Verb	αποστειρώνω • (aposteiróno) (simple past αποστείρωσα, passive form αποστειρώνομαι)
αγκομαχώ	Verb	αγκομαχώ • (agkomachó) (imperfect αγκομαχούσα, passive form —)
αποκεφαλίζομαι	Verb	αποκεφαλίζομαι • (apokefalízomai) (simple past αποκεφαλίστηκα, active form αποκεφαλίζω, passive)
είχαμε	Verb	είχαμε • (eíchame)
καταδίνω	Verb	καταδίνω • (katadíno) (simple past κατέδωσα or κατάδωσα, passive form καταδίνομαι)
αναστέλλομαι	Verb	αναστέλλομαι • (anastéllomai) (active form αναστέλλω, found only in the present and imperfect tenses, passive)
αστειεύομαι	Verb	αστειεύομαι • (asteiévomai) (simple past αστειεύτηκα, deponent)
κοιτώ	Verb	κοιτώ • (koitó) (simple past κοίταξα, passive form κοιτιέμαι)
διευρύνω	Verb	διευρύνω • (dievrýno) (simple past διεύρυνα, passive form διευρύνομαι)
ζητιανεύω	Verb	ζητιανεύω • (zitianévo) (simple past ζητιάνεψα)
ζητιέμαι	Verb	ζητιέμαι • (zitiémai) (simple past ζητήθηκα, active form ζητώ, mediopassive)
ξεθυμαίνω	Verb	ξεθυμαίνω • (xethymaíno) (simple past ξεθύμανα)
ξεριζώνομαι	Verb	ξεριζώνομαι • (xerizónomai) (simple past ξεριζώθηκα, active form ξεριζώνω, passive)
πωλούμαι	Verb	πωλούμαι • (poloúmai) (simple past πωλήθηκα, active form πωλώ, passive)
ισχυρίζομαι	Verb	ισχυρίζομαι • (ischyrízomai) (simple past ισχυρίστηκα, deponent)
αποφεύγομαι	Verb	αποφεύγομαι • (apofévgomai) (simple past αποφεύχθηκα, active form αποφεύγω, passive)
αλαργεύω	Verb	αλαργεύω • (alargévo) (simple past αλάργεψα)
φοράω	Verb	φοράω • (foráo) (simple past φόρεσα, passive form φοριέμαι)
έχετε	Verb	έχετε • (échete)
λειαίνω	Verb	λειαίνω • (leiaíno) (simple past λείανα, passive form λειαίνομαι)
αρδεύω	Verb	αρδεύω • (ardévo) (simple past άρδευσα, passive form αρδεύομαι)
αερίζομαι	Verb	αερίζομαι • (aerízomai) (simple past αερίστηκα, active form αερίζω, mediopassive)
φωνάζω	Verb	φωνάζω • (fonázo) (simple past φώναξα, passive form —)
χτίζομαι	Verb	χτίζομαι • (chtízomai) (simple past χτίστηκα, active form χτίζω, passive)
αναδείκνομαι	Verb	αναδείκνομαι • (anadeíknomai) (simple past αναδείχθηκα or αναδείχτηκα, active form αναδείχνω, passive)
γλεντοκοπώ	Verb	γλεντοκοπώ • (glentokopó) (simple past γλεντοκόπησα, passive form —)
δωροδοκούμαι	Verb	δωροδοκούμαι • (dorodokoúmai) (simple past δωροδοκήθηκα, active form δωροδοκώ, passive)
μελετάω	Verb	μελετάω • (meletáo) (simple past μελέτησα, passive form μελετώμαι)
σταματάω	Verb	σταματάω • (stamatáo) (simple past σταμάτησα, passive form —)
σώζομαι	Verb	σώζομαι • (sózomai) (simple past σώθηκα, active form σώζω, passive)
στρώνω	Verb	στρώνω • (stróno) (simple past έστρωσα)
ετοιμάζω	Verb	ετοιμάζω • (etoimázo) (simple past ετοίμασα, passive form ετοιμάζομαι)
απολύω	Verb	απολύω • (apolýo) (simple past απέλυσα or απόλυσα, passive form απολύομαι)
πιστεύω	Verb	πιστεύω • (pistévo) (simple past πίστεψα, passive form πιστεύεται)
επισκέπτομαι	Verb	επισκέπτομαι • (episképtomai) (simple past επισκέφτηκα or επισκέφθηκα, deponent)
καρφώνω	Verb	καρφώνω • (karfóno) (simple past κάρφωσα, passive form καρφώνομαι)
σταχώνω	Verb	σταχώνω • (stachóno) (simple past στάχωσα)
χλιμιντρίζω	Verb	χλιμιντρίζω • (chlimintrízo) (simple past χλιμίντρισα)
εμπνέω	Verb	εμπνέω • (empnéo) (simple past ενέπνευσα, passive form εμπνέομαι)
κουλάρω	Verb	κουλάρω • (kouláro) (simple past κούλαρα or κουλάρισα)
φωτογραφίζω	Verb	φωτογραφίζω • (fotografízo) (simple past φωτογράφισα)
γαλβανίζομαι	Verb	γαλβανίζομαι • (galvanízomai) (simple past γαλβανίστηκα, active form γαλβανίζω, passive)
διαφημίζω	Verb	διαφημίζω • (diafimízo) (simple past διαφήμισα, passive form διαφημίζομαι)
λούζω	Verb	λούζω • (loúzo) (simple past έλουσα, passive form λούζομαι)
φοριέμαι	Verb	φοριέμαι • (foriémai) (simple past φορέθηκα, active form φορώ, passive)
διαβλέπω	Verb	διαβλέπω • (diavlépo) (simple past διέβλεψα or διείδα, passive form —)
γαμιέμαι	Verb	γαμιέμαι • (gamiémai) (simple past γαμήθηκα, active form γαμώ, passive)
αποσύρω	Verb	αποσύρω • (aposýro) (simple past απέσυρα or απόσυρα, passive form αποσύρομαι)
γεννιέμαι	Verb	γεννιέμαι • (genniémai) (simple past γεννήθηκα, active form γεννώ, passive)
σιωπώ	Verb	σιωπώ • (siopó) (simple past σιώπησα)
προλαμβάνω	Verb	προλαμβάνω • (prolamváno) (simple past πρόλαβα, passive form προλαμβάνομαι)
ανανεώνω	Verb	ανανεώνω • (ananeóno) (simple past ανανέωσα, passive form ανανεώνομαι)
φωσφορίζω	Verb	φωσφορίζω • (fosforízo) (simple past φωσφόρισα)
έχω	Verb	έχω • (écho) (imperfect είχα)
ανιχνεύομαι	Verb	ανιχνεύομαι • (anichnévomai) (simple past ανιχνεύτηκα or ανιχνεύθηκα, active form ανιχνεύω, passive)
κορώνω	Verb	κορώνω • (koróno) (simple past κόρωσα)
ομιλώ	Verb	ομιλώ • (omiló) (simple past —, passive form ομιλούμαι) (chiefly in the present tense)
αρχίζω	Verb	αρχίζω • (archízo) (simple past άρχισα, passive form άρχομαι)
διατρυπώ	Verb	διατρυπώ • (diatrypó) (simple past διατρύπησα)
γυρίζω	Verb	γυρίζω • (gyrízo) (simple past γύρισα, passive form γυρίζομαι)
αιθεροβατώ	Verb	αιθεροβατώ • (aitherovató) (simple past αιθεροβάτησα)
απονέμομαι	Verb	απονέμομαι • (aponémomai) (simple past απονεμήθηκα, active form απονέμω, passive)
σπάνω	Verb	σπάνω • (spáno) (simple past έσπασα)
εξετάζομαι	Verb	εξετάζομαι • (exetázomai) (simple past εξετάστηκα, active form εξετάζω, passive)
σημαίνω	Verb	σημαίνω • (simaíno) (simple past σήμανα, passive form —)
δυσκολεύω	Verb	δυσκολεύω • (dyskolévo) (simple past δυσκόλεψα, passive form δυσκολεύομαι)
βασίζομαι	Verb	βασίζομαι • (vasízomai) (simple past βασίστηκα, active form βασίζω, passive)
βρέχω	Verb	βρέχω • (vrécho) (simple past έβρεξα, passive form βρέχομαι)
αιματοκυλώ	Verb	αιματοκυλώ • (aimatokyló) (simple past αιματοκύλισα, passive form αιματοκυλιέμαι)
εμπνέομαι	Verb	εμπνέομαι • (empnéomai) (simple past εμπνεύστηκα, active form εμπνέω, passive)
ακυρώνομαι	Verb	ακυρώνομαι • (akyrónomai) (simple past ακυρώθηκα, active form ακυρώνω, passive)
αβγοκόβω	Verb	αβγοκόβω • (avgokóvo) (simple past αβγόκοψα)
κολυμπώ	Verb	κολυμπώ • (kolympó) (simple past κολύμπησα)
τηλεφωνώ	Verb	τηλεφωνώ • (tilefonó) (simple past τηλεφώνησα)
μεταρρυθμίζω	Verb	μεταρρυθμίζω • (metarrythmízo) (simple past μεταρρύθμισα, passive form μεταρρυθμίζομαι)
πασπαλίζομαι	Verb	πασπαλίζομαι • (paspalízomai) (simple past πασπαλίστηκα, active form πασπαλίζω, passive)
τρυπάω	Verb	τρυπάω • (trypáo) (simple past τρύπησα)
ψοφάω	Verb	ψοφάω • (psofáo) (simple past ψόφησα)
ρεύομαι	Verb	ρεύομαι • (révomai) (simple past ρεύτηκα, deponent)
αλληλοπαντρεύομαι	Verb	αλληλοπαντρεύομαι • (allilopantrévomai) (simple past αλληλοπαντρεύτηκα, deponent)
προειδοποιώ	Verb	προειδοποιώ • (proeidopoió) (simple past προειδοποίησα, passive form προειδοποιούμαι)
καταλήγω	Verb	καταλήγω • (katalígo) (simple past κατέληξα, passive form —)
αίρω	Verb	αίρω • (aíro) (simple past ήρα, passive form αίρομαι)
μυρίζω	Verb	μυρίζω • (myrízo) (simple past μύρισα, passive form μυρίζομαι)
διοργανώνω	Verb	διοργανώνω • (diorganóno) (simple past διοργάνωσα, passive form διοργανώνομαι)
βερνικώνομαι	Verb	βερνικώνομαι • (vernikónomai) (simple past βερνικώθηκα, active form βερνικώνω, passive)
παραβάλλω	Verb	παραβάλλω • (paravállo) (simple past παρέβαλα)
δημιουργούμαι	Verb	δημιουργούμαι • (dimiourgoúmai) (simple past δημιουργήθηκα, active form δημιουργώ, passive)
κουλουριάζομαι	Verb	κουλουριάζομαι • (koulouriázomai) (simple past κουλουριάστηκα, active form κουλουριάζω, passive)
πυροδοτώ	Verb	πυροδοτώ • (pyrodotó) (simple past πυροδότησα)
γαργαλεύομαι	Verb	γαργαλεύομαι • (gargalévomai) (simple past γαργαλεύτηκα, active form γαργαλεύω, passive)
παραγγέλλω	Verb	παραγγέλλω • (parangéllo) (simple past παρήγγειλα or παράγγειλα, passive form παραγγέλλομαι)
χαράζω	Verb	χαράζω • (charázo) (simple past χάραξα, passive form χαράζομαι)
αναποδογυρίζω	Verb	αναποδογυρίζω • (anapodogyrízo) (simple past αναποδογύρισα, passive form αναποδογυρίζομαι)
συμπαθώ	Verb	συμπαθώ • (sympathó) (simple past συμπάθησα)
ξιφομαχώ	Verb	ξιφομαχώ • (xifomachó) (simple past ξιφομάχησα)
αναγεννώμαι	Verb	αναγεννώμαι • (anagennómai) (simple past αναγεννήθηκα, active form αναγεννώ, passive)
μεταφράζω	Verb	μεταφράζω • (metafrázo) (simple past μετέφρασα, passive form μεταφράζομαι)
ανατινάσσω	Verb	ανατινάσσω • (anatinásso) (simple past ανατίναξα)
αναπαύομαι	Verb	αναπαύομαι • (anapávomai) (simple past αναπαύτηκα or αναπαύθηκα, active form αναπαύω, mediopassive)
σχηματίζω	Verb	σχηματίζω • (schimatízo) (simple past σκημάτισα, passive form σχηματίζομαι)
αρνιέμαι	Verb	αρνιέμαι • (arniémai) (simple past αρνήθηκα, deponent)
αποδεικνύω	Verb	αποδεικνύω • (apodeiknýo) (simple past απέδειξα or απόδειξα, passive form αποδεικνύομαι)
βαστάω	Verb	βαστάω • (vastáo) (simple past βάσταξα or βάστηξα, passive form βαστιέμαι)
αλληλοσυνδέω	Verb	αλληλοσυνδέω • (allilosyndéo) (simple past αλληλοσυνέδεσα)
στερώ	Verb	στερώ • (steró) (simple past στέρησα, passive form στερούμαι)
ανατρέφω	Verb	ανατρέφω • (anatréfo) (simple past ανάθρεψα or ανέθρεψα, passive form ανατρέφομαι)
καυλώνω	Verb	καυλώνω • (kavlóno) (simple past καύλωσα, passive form —)
προειδοποιούμαι	Verb	προειδοποιούμαι • (proeidopoioúmai) (simple past προειδοποιήθηκα, active form προειδοποιώ, passive)
φέγγω	Verb	φέγγω • (féngo) (simple past έφεξα, passive form —)
κερατώνομαι	Verb	κερατώνομαι • (keratónomai) (simple past κερατώθηκα, active form κερατώνω, passive)
προδίδομαι	Verb	προδίδομαι • (prodídomai) (simple past προδόθηκα, active form προδίδω, mediopassive)
αναταράσσομαι	Verb	αναταράσσομαι • (anatarássomai) (simple past αναταράχθηκα or αναταράχτηκα, active form αναταράσσω, passive)
στρέφω	Verb	στρέφω • (stréfo) (simple past έστρεψα)
προκύπτω	Verb	προκύπτω • (prokýpto) (simple past προέκυψα)
αλλάσσω	Verb	αλλάσσω • (allásso) (simple past άλλαξα)
παρακαλάω	Verb	παρακαλάω • (parakaláo) (simple past παρακάλεσα)
αβαράρω	Verb	αβαράρω • (avaráro) (simple past αβαβάρισα)
μελετώμαι	Verb	μελετώμαι • (meletómai) (simple past μελετήθηκα, active form μελετώ, passive)
καίγομαι	Verb	καίγομαι • (kaígomai) (simple past κάηκα, active form καίω, passive)
τοποθετώ	Verb	τοποθετώ • (topothetó) (simple past τοποθέτησα, passive form τοποθετούμαι)
αφαιρούμαι	Verb	αφαιρούμαι • (afairoúmai) (simple past αφαιρέθηκα, active form αφαιρώ, passive)
κτυπάω	Verb	κτυπάω • (ktypáo) (simple past κτύπησα)
μαλώνω	Verb	μαλώνω • (malóno) (simple past μάλωσα)
βλάφτω	Verb	βλάφτω • (vláfto) (simple past έβλαψα, passive form βλάπτομαι)
δημεύομαι	Verb	δημεύομαι • (dimévomai) (simple past δημεύτηκα or δημεύθηκα, active form δημεύω, passive)
απάγω	Verb	απάγω • (apágo) (simple past απήγαγα, passive form απάγομαι)
συνεχίζω	Verb	συνεχίζω • (synechízo) (simple past συνέχισα, passive form συνεχίζομαι)
διανθίζω	Verb	διανθίζω • (dianthízo) (simple past διάνθισα, passive form διανθίζομαι)
αγρικώ	Verb	αγρικώ • (agrikó) (simple past αγρίκησα)
γλεντοκοπάω	Verb	γλεντοκοπάω • (glentokopáo) (simple past γλεντοκόπησα, passive form —)
βυζαίνω	Verb	βυζαίνω • (vyzaíno) (simple past βύζαξα, passive form βυζαίνομαι)
αγγλοφέρνω	Verb	αγγλοφέρνω • (angloférno) (simple past αγγλόφερα)
επαναλαμβάνω	Verb	επαναλαμβάνω • (epanalamváno) (simple past επανέλαβα, passive form επαναλαμβάνομαι)
ωχριώ	Verb	ωχριώ • (ochrió) (simple past ωχρίασα)
προφτάνω	Verb	προφτάνω • (proftáno) (simple past πρόφτασα)
εκδίδομαι	Verb	εκδίδομαι • (ekdídomai) (simple past εκδόθηκα, active form εκδίδω, passive)
αποθαρρύνω	Verb	αποθαρρύνω • (apotharrýno) (simple past αποθάρρυνα, passive form αποθαρρύνομαι)
φταίω	Verb	φταίω • (ftaío) (simple past έφταιξα)
αγκαλιάζομαι	Verb	αγκαλιάζομαι • (agkaliázomai) (simple past αγκαλιάστηκα, active form αγκαλιάζω, passive)
χρησιμοποιούμαι	Verb	χρησιμοποιούμαι • (chrisimopoioúmai) (simple past χρησιμοποιήθηκα, active form χρησιμοποιώ, passive)
δωρίζω	Verb	δωρίζω • (dorízo) (simple past δώρισα, passive form δωρίζομαι)
ανέχομαι	Verb	ανέχομαι • (anéchomai) (simple past ανέχτηκα, deponent)
κυβερνάω	Verb	κυβερνάω • (kyvernáo) (simple past κυβέρνησα, passive form κυβερνιέμαι)
βράζω	Verb	βράζω • (vrázo) (simple past έβρασα)
ξαλμυρίζω	Verb	ξαλμυρίζω • (xalmyrízo) (simple past ξαλμύρισα)
περιπολώ	Verb	περιπολώ • (peripoló) (found only in the present and imperfect tenses)
εκτίθεμαι	Verb	εκτίθεμαι • (ektíthemai) (simple past εκτέθηκα, active form εκθέτω, passive)
μασάω	Verb	μασάω • (masáo) (simple past μάσησα)
αγροικώ	Verb	αγροικώ • (agroikó) (simple past αγροίκησα)
κουράζομαι	Verb	κουράζομαι • (kourázomai) (simple past κουράστηκα, active form κουράζω, passive)
αγγαρεύω	Verb	αγγαρεύω • (angarévo) (simple past αγγάρεψα, passive form αγγαρεύομαι)
ελαφραίνω	Verb	ελαφραίνω • (elafraíno) (simple past ελάφρυνα)
ανταλλάσσω	Verb	ανταλλάσσω • (antallásso) (simple past αντάλλαξα, passive form ανταλλάσσομαι)
κοροϊδεύομαι	Verb	κοροϊδεύομαι • (koroïdévomai) (simple past κοροϊδεύτηκα, active form κοροϊδεύω, passive)
βρίσκομαι	Verb	βρίσκομαι • (vrískomai) (simple past βρέθηκα, active form βρίσκω, passive)
αμπαλάρομαι	Verb	αμπαλάρομαι • (ampaláromai) (simple past αμπαλαρίστηκα, active form αμπαλάρω, passive)
αιματοκυλιέμαι	Verb	αιματοκυλιέμαι • (aimatokyliémai) (simple past αιματοκυλίστηκα, active form αιματοκυλώ, passive)
εγκολπώνομαι	Verb	εγκολπώνομαι • (egkolpónomai) (simple past εγκολπώθηκα, deponent)
ακκίζομαι	Verb	ακκίζομαι • (akkízomai) (simple past ακκίστηκα, deponent)
αιτιώμαι	Verb	αιτιώμαι • (aitiómai) (found only in the present tense, deponent)
βάλλω	Verb	βάλλω • (vállo) (simple past έβαλα, passive form βάλλομαι)
χλωμιάζω	Verb	χλωμιάζω • (chlomiázo) (simple past χλώμιασα)
φωλιάζω	Verb	φωλιάζω • (foliázo) (simple past φώλιασα)
ήσασταν	Verb	ήσασταν • (ísastan)
συγκεντρώνω	Verb	συγκεντρώνω • (sygkentróno) (simple past συγκέντρωσα, passive form συγκεντρώνομαι)
περικλείω	Verb	περικλείω • (perikleío) (simple past περιέκλεισα, passive form περικλείομαι)
βουτυρώνομαι	Verb	βουτυρώνομαι • (voutyrónomai) (simple past βουτυρώθηκα, active form βουτυρώνω, passive)
τυλίγομαι	Verb	τυλίγομαι • (tylígomai) (simple past τυλίχτηκα, active form τυλίγω, passive)
αντιλέγω	Verb	αντιλέγω • (antilégo) (simple past αντείπα, passive form —)
απειθώ	Verb	απειθώ • (apeithó) (simple past απείθησα)
αδικοπραγώ	Verb	αδικοπραγώ • (adikopragó) (simple past αδικοπράγησα, passive form —)
γλείφω	Verb	γλείφω • (gleífo) (simple past έγλειψα)
υπερασπίζομαι	Verb	υπερασπίζομαι • (yperaspízomai) (simple past υπερασπίστηκα, active form υπερασπίζω, passive)
σοβαρολογώ	Verb	σοβαρολογώ • (sovarologó) (simple past σοβαρολόγησα)
υμνώ	Verb	υμνώ • (ymnó) (simple past ύμνησα)
καθίσταμαι	Verb	καθίσταμαι • (kathístamai) (simple past —, active form καθιστώ, mediopassive)
αναιρούμαι	Verb	αναιρούμαι • (anairoúmai) (simple past αναιρέθηκα, active form αναιρώ, passive)
μαραίνομαι	Verb	μαραίνομαι • (maraínomai) (simple past μαράθηκα, active form μαραίνω, passive)
κοτσάρω	Verb	κοτσάρω • (kotsáro) (simple past κότσαρα or κοτσάρισα)
αλατοπιπερώνω	Verb	αλατοπιπερώνω • (alatopiperóno) (simple past αλατοπιπέρωσα)
αλιεύω	Verb	αλιεύω • (aliévo) (simple past αλίευσα, passive form αλιεύομαι)
ζηλεύω	Verb	ζηλεύω • (zilévo) (simple past ζήλεψα, passive form ζηλεύομαι)
αμύνομαι	Verb	αμύνομαι • (amýnomai) (simple past αμύνθηκα, deponent)
εμπιστεύομαι	Verb	εμπιστεύομαι • (empistévomai) (simple past εμπιστεύτηκα or εμπιστεύθηκα, deponent)
στειρώνω	Verb	στειρώνω • (steiróno) (simple past στείρωσα, passive form στειρώνομαι)
σβήνομαι	Verb	σβήνομαι • (svínomai) (simple past σβήστηκα, active form σβήνω, passive)
προβλέπομαι	Verb	προβλέπομαι • (provlépomai) (simple past προβλέφθηκα, active form προβλέπω, passive)
αναλαμβάνομαι	Verb	αναλαμβάνομαι • (analamvánomai) (simple past αναλήφθηκα, active form αναλαμβάνω, passive)
παρατώ	Verb	παρατώ • (parató) (simple past παράτησα)
καταδύομαι	Verb	καταδύομαι • (katadýomai) (simple past καταδύθηκα, deponent)
γεννώ	Verb	γεννώ • (gennó) (simple past γέννησα, passive form γεννιέμαι)
συζητιέμαι	Verb	συζητιέμαι • (syzitiémai) (simple past συζητήθηκα, active form συζητώ, mediopassive)
κατεβαίνω	Verb	κατεβαίνω • (katevaíno) (simple past κατέβηκα, passive form —)
πνέω	Verb	πνέω • (pnéo) (simple past έπνευσα)
εκθειάζω	Verb	εκθειάζω • (ektheiázo) (simple past εκθείασα)
αδελφώνω	Verb	αδελφώνω • (adelfóno) (simple past αδέλφωσα, passive form αδελφώνομαι)
συναντώ	Verb	συναντώ • (synantó) (simple past συνάντησα, passive form συναντιέμαι or συναντώμαι)
μπαινοβγαίνω	Verb	μπαινοβγαίνω • (bainovgaíno) (simple past μπαινοβγήκα)
επαπειλώ	Verb	επαπειλώ • (epapeiló) (simple past επαπείλησα, passive form επαπειλούμαι)
πηδιέμαι	Verb	πηδιέμαι • (pidiémai) (simple past πηδήχτηκα, active form πηδώ, passive)
ενηλικιώνομαι	Verb	ενηλικιώνομαι • (enilikiónomai) (simple past ενηλικιώθηκα, deponent)
εξημερώνομαι	Verb	εξημερώνομαι • (eximerónomai) (simple past εξημερώθηκα, active form εξημερώνω, passive)
προσφέρω	Verb	προσφέρω • (prosféro) (simple past προσέφερα or πρόσφερα, passive form προσφέρομαι)
γνωρίζω	Verb	γνωρίζω • (gnorízo) (simple past γνώρισα, passive form γνωρίζομαι)
αγριεύω	Verb	αγριεύω • (agriévo) (simple past αγρίεψα, passive form αγριεύομαι)
σκέπτομαι	Verb	σκέπτομαι • (sképtomai) (simple past σκέφτηκα or σκέφθηκα, deponent)
ενισχύω	Verb	ενισχύω • (enischýo) (simple past ενίσχυσα, passive form ενισχύομαι)
κτυπώ	Verb	κτυπώ • (ktypó) (simple past κτύπησα)
αποκλίνω	Verb	αποκλίνω • (apoklíno) (simple past απέκλινα)
συνδέω	Verb	συνδέω • (syndéo) (simple past συνέδεσα)
αμείβω	Verb	αμείβω • (ameívo) (simple past άμειψα, passive form αμείβομαι)
αερίζω	Verb	αερίζω • (aerízo) (simple past αέρισα, passive form αερίζομαι)
εξατμίζομαι	Verb	εξατμίζομαι • (exatmízomai) (simple past εξατμίστηκα, active form εξατμίζω, passive)
αλυσοδένω	Verb	αλυσοδένω • (alysodéno) (simple past αλυσόδεσα, passive form αλυσοδένομαι)
πατώ	Verb	πατώ • (pató) (simple past πάτησα, passive form πατιέμαι)
αποκρυσταλλώνω	Verb	αποκρυσταλλώνω • (apokrystallóno) (simple past αποκρυστάλλωσα, passive form αποκρυσταλλώνομαι)
σωπαίνω	Verb	σωπαίνω • (sopaíno) (simple past σώπασα)
αισθηματολογώ	Verb	αισθηματολογώ • (aisthimatologó) (found only in the present and imperfect tenses)
συντομέυομαι	Verb	συντομέυομαι • (syntoméyomai) (simple past συντομεύτηκα or συντομεύθηκα, active form συντομέυω, passive)
αναγκάζω	Verb	αναγκάζω • (anagkázo) (simple past ανάγκασα, passive form αναγκάζομαι)
φυλάσσω	Verb	φυλάσσω • (fylásso) (simple past φύλαξα, passive form φυλάγομαι)
αναδείχνω	Verb	αναδείχνω • (anadeíchno) (simple past ανέδειξα or ανάδειξα, passive form αναδείκνομαι)
πολιορκώ	Verb	πολιορκώ • (poliorkó) (simple past πολιόρκησα, passive form πολιορκούμαι)
υπερχειλίζω	Verb	υπερχειλίζω • (ypercheilízo) (simple past υπερχείλισα)
αφορίζω	Verb	αφορίζω • (aforízo) (simple past αφόρισα, passive form αφορίζομαι)
ακριτολογώ	Verb	ακριτολογώ • (akritologó) (simple past ακριτολόγησα)
απευθύνομαι	Verb	απευθύνομαι • (apefthýnomai) (simple past απευθύνθηκα, active form απευθύνω, passive)
ψήνομαι	Verb	ψήνομαι • (psínomai) (simple past ψήθηκα, active form ψήνω, passive)
χασμουριέμαι	Verb	χασμουριέμαι • (chasmouriémai) (simple past χασμουρήθηκα, deponent)
ανακαινίζω	Verb	ανακαινίζω • (anakainízo) (simple past ανακαίνισα, passive form ανακαινίζομαι)
στέκομαι	Verb	στέκομαι • (stékomai) (simple past στάθηκα, deponent)
απολυμαίνω	Verb	απολυμαίνω • (apolymaíno) (simple past απολύμανα, passive form απολυμαίνομαι)
διαγωνίζομαι	Verb	διαγωνίζομαι • (diagonízomai) (simple past διαγωνίστηκα, deponent)
αλληλεπικοινωνώ	Verb	αλληλεπικοινωνώ • (allilepikoinonó) (simple past αλληλεπικοινώνησα)
προκαταβάλω	Verb	προκαταβάλω • (prokataválo) (simple past προκατέβαλα, passive form προκαταβάλομαι)
ξεκωλώνω	Verb	ξεκωλώνω • (xekolóno) (simple past ξεκώλωσα, passive form ξεκωλώνομαι)
πιέζομαι	Verb	πιέζομαι • (piézomai) (simple past πιέστηκα, active form πιέζω, passive)
περικυκλώνω	Verb	περικυκλώνω • (perikyklóno) (simple past περικύκλωσα, passive form περικυκλώνομαι)
ξαναλέω	Verb	ξαναλέω • (xanaléo) (simple past ξανάπα or ξαναείπα)
διαφέρω	Verb	διαφέρω • (diaféro) (simple past διέφερα)
γαμώ	Verb	γαμώ • (gamó) (simple past γάμησα, passive form γαμιέμαι)
ειδοποιούμαι	Verb	ειδοποιούμαι • (eidopoioúmai) (simple past ειδοποιήθηκα, active form ειδοποιώ, passive)
αποκτιέμαι	Verb	αποκτιέμαι • (apoktiémai) (simple past αποκτήθηκα, active form αποκτώ, passive)
αντιμετωπίζω	Verb	αντιμετωπίζω • (antimetopízo) (simple past αντιμετώπισα, passive form αντιμετωπίζομαι)
βραχυκυκλώνομαι	Verb	βραχυκυκλώνομαι • (vrachykyklónomai) (simple past βραχυκυκλώθηκα, active form βραχυκυκλώνω, passive)
πηγαίνω	Verb	πηγαίνω • (pigaíno) (simple past πήγα)
ηρεμώ	Verb	ηρεμώ • (iremó) (simple past ηρέμησα)
δίδω	Verb	δίδω • (dído) (simple past έδωσα)
σκοπεύω	Verb	σκοπεύω • (skopévo) (simple past σκόπευσα, passive form —)
κεντώ	Verb	κεντώ • (kentó) (simple past κέντησα, passive form κεντιέμαι)
περικλείομαι	Verb	περικλείομαι • (perikleíomai) (active form περικλείω, found only in the present and imperfect tenses, passive)
υπερτιμάω	Verb	υπερτιμάω • (ypertimáo) (simple past υπερτίμησα, passive form υπερτιμώμαι)
καλύπτω	Verb	καλύπτω • (kalýpto) (simple past κάλυψα, passive form καλύπτομαι)
καταπολεμιέμαι	Verb	καταπολεμιέμαι • (katapolemiémai) (simple past καταπολεμήθηκα, active form καταπολεμώ, passive)
τραγουδιέμαι	Verb	τραγουδιέμαι • (tragoudiémai) (simple past τραγουδήθηκα, active form τραγουδώ, passive)
μαζεύομαι	Verb	μαζεύομαι • (mazévomai) (simple past μαζεύτηκα, active form μαζεύω, mediopassive)
επιδιορθώνω	Verb	επιδιορθώνω • (epidiorthóno) (simple past επιδιόρθωσα)
γουργουρίζω	Verb	γουργουρίζω • (gourgourízo) (simple past γουργούρισα)
μένω	Verb	μένω • (méno) (simple past έμεινα, passive form —)
αναγεννιέμαι	Verb	αναγεννιέμαι • (anagenniémai) (simple past αναγεννήθηκα, active form αναγεννώ, passive)
πυροβολώ	Verb	πυροβολώ • (pyrovoló) (simple past πυροβόλησα, passive form πυροβολούμαι)
βρίζομαι	Verb	βρίζομαι • (vrízomai) (simple past βρίστηκα, active form βρίζω)
παραλείπομαι	Verb	παραλείπομαι • (paraleípomai) (simple past παραλείφθηκα, active form παραλείπω, passive)
ματώνω	Verb	ματώνω • (matóno) (simple past μάτωσα)
κλέβω	Verb	κλέβω • (klévo) (simple past έκλεψα)
θάβω	Verb	θάβω • (thávo) (simple past έθαψα)
επαινούμαι	Verb	επαινούμαι • (epainoúmai) (simple past επαινέθηκα, active form επαινώ, passive)
δικάζω	Verb	δικάζω • (dikázo)
λουφάρω	Verb	λουφάρω • (loufáro) (simple past λούφαρα or λουφάρισα)
ρουφάω	Verb	ρουφάω • (roufáo) (simple past ρούφηξα, passive form ρουφιέμαι)
υπόσχομαι	Verb	υπόσχομαι • (ypóschomai) (simple past υποσχέθηκα, deponent)
κλείνω	Verb	κλείνω • (kleíno) (simple past έκλεισα, passive form κλείνομαι)
χαραμίζω	Verb	χαραμίζω • (charamízo) (simple past χαράμισα, passive form χαραμίζομαι)
αγριομιλώ	Verb	αγριομιλώ • (agriomiló) (simple past αγριομίλησα)
αποταμιεύω	Verb	αποταμιεύω • (apotamiévo) (simple past αποταμίευσα, passive form αποταμιεύομαι)
μαχαιρώνωμαι	Verb	μαχαιρώνωμαι • (machairónomai) (simple past μαχαιρώθηκα, active form μαχαιρώνω, passive)
κοινωνάω	Verb	κοινωνάω • (koinonáo) (simple past κοινώνησα, passive form —)
αυξομειώνομαι	Verb	αυξομειώνομαι • (afxomeiónomai) (simple past αυξομειώθηκα, active form αυξομειώνω, passive)
περιφράζω	Verb	περιφράζω • (perifrázo) (simple past περιέφραξα)
παραπονούμαι	Verb	παραπονούμαι • (paraponoúmai) (simple past παραπονέθηκα, deponent)
πλέκω	Verb	πλέκω • (pléko) (simple past έπλεξα, passive form πλέκομαι, active)
αναδεικνύομαι	Verb	αναδεικνύομαι • (anadeiknýomai) (simple past αναδείχθηκα or αναδείχτηκα, active form αναδεικνύω, passive)
αιωρούμαι	Verb	αιωρούμαι • (aioroúmai) (simple past αιωρήθηκα, deponent)
αλληλοβρίζομαι	Verb	αλληλοβρίζομαι • (allilovrízomai) (simple past αλληλοβρίστηκα, deponent)
εννοώ	Verb	εννοώ • (ennoó) (simple past εννόησα, passive form εννοούμαι)
κατουρώ	Verb	κατουρώ • (katouró) (simple past κατούρησα, passive form κατουριέμαι)
ενοποιώ	Verb	ενοποιώ • (enopoió) (simple past ενοποίησα)
μεταθέτω	Verb	μεταθέτω • (metathéto) (simple past μετέθεσα)
ανακουφίζομαι	Verb	ανακουφίζομαι • (anakoufízomai) (simple past ανακουφίστηκα, active form ανακουφίζω, passive)
αποξενώνομαι	Verb	αποξενώνομαι • (apoxenónomai) (simple past αποξενώθηκα, active form αποξενώνω, passive)
αρταίνομαι	Verb	αρταίνομαι • (artaínomai) (simple past αρτύθηκα, active form αρταίνω, passive)
αρδεύομαι	Verb	αρδεύομαι • (ardévomai) (simple past αρδεύτηκα or αρδεύθηκα, active form αρδεύω, passive)
εισπνέω	Verb	εισπνέω • (eispnéo) (simple past εισέπνευσα)
αποθησαυρίζω	Verb	αποθησαυρίζω • (apothisavrízo) (simple past αποθησαύρισα, passive form αποθησαυρίζομαι)
γελώ	Verb	γελώ • (geló) (simple past γέλασα, passive form γελιέμαι)
ξεχνώ	Verb	ξεχνώ • (xechnó) (simple past ξέχασα, passive form ξεχνιέμαι)
σταματώ	Verb	σταματώ • (stamató) (simple past σταμάτησα, passive form —)
ανακρίνομαι	Verb	ανακρίνομαι • (anakrínomai) (simple past ανακρίθηκα, active form ανακρίνω, passive)
εκπέμπω	Verb	εκπέμπω • (ekpémpo) (simple past εξέπεμψα, passive form εκπέμπομαι)
χαλώ	Verb	χαλώ • (chaló) (simple past χάλασα, passive form —)
αναχωρώ	Verb	αναχωρώ • (anachoró) (simple past αναχώρησα, passive form —)
κατουράω	Verb	κατουράω • (katouráo) (simple past κατούρησα, passive form κατουριέμαι)
ήμαστε	Verb	ήμαστε • (ímaste)
γυρνάω	Verb	γυρνάω • (gyrnáo) (simple past γύρισα, passive form γυρίζομαι)
πληκτρολογούμαι	Verb	πληκτρολογούμαι • (pliktrologoúmai) (simple past πληκτρολογήθηκα, active form πληκτρολογώ, passive)
ξαναπερνώ	Verb	ξαναπερνώ • (xanapernó) (simple past ξαναπέρασα, passive form ξαναπερνιέμαι)
καρβουνιάζω	Verb	καρβουνιάζω • (karvouniázo) (simple past καρβούνιασα)
αποκαθιστώ	Verb	αποκαθιστώ • (apokathistó) (simple past αποκατέστησα or αποκατάστησα, passive form αποκαθίσταμαι)
αγγελοκρούομαι	Verb	αγγελοκρούομαι • (angelokroúomai) (simple past αγγελιάστηκα, deponent)
διατυπώνομαι	Verb	διατυπώνομαι • (diatypónomai) (simple past διατυπώθηκα, active form διατυπώνω, passive)
σκουντώ	Verb	σκουντώ • (skountó) (simple past σκούντηξα or σκούντησα, passive form —)
έχεις	Verb	έχεις • (écheis)
αναμορφώνομαι	Verb	αναμορφώνομαι • (anamorfónomai) (simple past αναμορφώθηκα, active form αναμορφώνω, passive)
συγκολλώ	Verb	συγκολλώ • (sygkolló) (simple past συγκόλλησα)
αγγίζω	Verb	αγγίζω • (angízo) (simple past άγγιξα, passive form αγγίζομαι, active)
αερομαχώ	Verb	αερομαχώ • (aeromachó) (found only in the present tense)
στοιβάζω	Verb	στοιβάζω • (stoivázo) (simple past στοίβαξα, passive form στοιβάζομαι)
αντιπαθώ	Verb	αντιπαθώ • (antipathó) (simple past αντιπάθησα)
γνέθω	Verb	γνέθω • (gnétho) (simple past έγνεψα)
παύω	Verb	παύω • (pávo) (simple past έπαψα or έπαυσα)
αγγλοποιούμαι	Verb	αγγλοποιούμαι • (anglopoioúmai) (simple past αγγλοποιήθηκα, active form αγγλοποιώ, passive)
ντουμπλάρω	Verb	ντουμπλάρω • (doumpláro) (simple past ντούμπλαρα or ντουμπλάρισα)
αδιαθετώ	Verb	αδιαθετώ • (adiathetó) (simple past αδιαθέτησα)
πολλαπλασιάζω	Verb	πολλαπλασιάζω • (pollaplasiázo) (simple past πολλαπλασίασα)
αεροβατώ	Verb	αεροβατώ • (aerovató) (found only in the present and imperfect tenses)
βγάζω	Verb	βγάζω • (vgázo) (simple past έβγαλα, passive form βγάζομαι)
σιωπάω	Verb	σιωπάω • (siopáo) (simple past σιώπησα)
στοιχηματίζω	Verb	στοιχηματίζω • (stoichimatízo) (simple past στοιχημάτισα)
βαριέμαι	Verb	βαριέμαι • (variémai) (simple past βαρέθηκα, passive)
ζαχαρώνομαι	Verb	ζαχαρώνομαι • (zacharónomai) (simple past ζαχαρώθηκα, active form ζαχαρώνω, passive)
τολμώ	Verb	τολμώ • (tolmó) (simple past τόλμησα, passive form τολμώμαι)
εκκενώνω	Verb	εκκενώνω • (ekkenóno) (simple past εκκένωσα, passive form εκκενώνομαι)
ξεκινάω	Verb	ξεκινάω • (xekináo) (simple past ξεκίνησα)
αφαιρώ	Verb	αφαιρώ • (afairó) (simple past αφαίρεσα, passive form αφαιρούμαι)
φυλλομετρώ	Verb	φυλλομετρώ • (fyllometró) (simple past φυλλομέτρησα)
αγωνίζομαι	Verb	αγωνίζομαι • (agonízomai) (simple past αγωνίστηκα, deponent)
ακουμπάω	Verb	ακουμπάω • (akoumpáo) (simple past ακούμπησα, passive form ακουμπιέμαι)
αναστατώνομαι	Verb	αναστατώνομαι • (anastatónomai) (simple past αναστατώθηκα, active form αναστατώνω, passive)
αρχινάω	Verb	αρχινάω • (archináo) (simple past αρχίνησα, passive form —)
αλλάζω	Verb	αλλάζω • (allázo) (simple past άλλαξα, passive form αλλάζομαι)
ακομπανιάρω	Verb	ακομπανιάρω • (akompaniáro) (simple past ακομπανιάρισα, passive form —)
πυροβολούμαι	Verb	πυροβολούμαι • (pyrovoloúmai) (simple past πυροβολήθηκα, active form πυροβολώ, passive)
κλάνω	Verb	κλάνω • (kláno) (simple past έκλασα)
αποδεικνύομαι	Verb	αποδεικνύομαι • (apodeiknýomai) (simple past αποδείχθηκα or αποδείχτηκα, active form αποδεικνύω, passive)
συζητώ	Verb	συζητώ • (syzitó) (simple past συζήτησα, passive form συζητιέμαι or συζητούμαι)
φτάνω	Verb	φτάνω • (ftáno) (simple past έφτασα)
σπάζομαι	Verb	σπάζομαι • (spázomai) (simple past σπάστηκα, active form σπάζω, passive)
ανταποκρίνομαι	Verb	ανταποκρίνομαι • (antapokrínomai) (simple past ανταποκρίθηκα)
χρίω	Verb	χρίω • (chrío) (simple past έχρισα)
αναλογίζομαι	Verb	αναλογίζομαι • (analogízomai) (simple past αναλογίστηκα, deponent)
αποδείχνω	Verb	αποδείχνω • (apodeíchno) (simple past απέδειξα, passive form αποδείχνομαι)
αναθέτομαι	Verb	αναθέτομαι • (anathétomai) (simple past ανατέθηκα, active form αναθέτω, passive)
γλιστράω	Verb	γλιστράω • (glistráo) (simple past γλίστρησα)
ξεκωλιάζω	Verb	ξεκωλιάζω • (xekoliázo) (simple past ξεκώλιασα, passive form ξεκωλιάζομαι)
έχοντας	Verb	έχοντας • (échontas)
ερωτεύομαι	Verb	ερωτεύομαι • (erotévomai) (simple past ερωτεύτηκα, deponent)
δαμάζω	Verb	δαμάζω • (damázo) (simple past δάμασα, passive form δαμάζομαι)
προπονούμαι	Verb	προπονούμαι • (proponoúmai) (simple past προπονήθηκα, active form προπονώ, passive)
διώχνω	Verb	διώχνω • (dióchno) (simple past έδιωξα, passive form διώχνομαι)
βογγάω	Verb	βογγάω • (vongáo) (simple past βόγγηξα, passive form —)
διαβαίνω	Verb	διαβαίνω • (diavaíno) (simple past διάβηκα, passive form —)
ξαναπερνιέμαι	Verb	ξαναπερνιέμαι • (xanaperniémai) (simple past ξαναπεράστηκα, active form ξαναπερνώ, passive)
ελαφρώνω	Verb	ελαφρώνω • (elafróno) (simple past ελάφρωσα)
πειράζομαι	Verb	πειράζομαι • (peirázomai) (simple past πειράχτηκα, active form πειράζω, passive)
τιμωρούμαι	Verb	τιμωρούμαι • (timoroúmai) (simple past τιμωρήθηκα, active form τιμωρώ, passive)
ξαναπερνάω	Verb	ξαναπερνάω • (xanapernáo) (simple past ξαναπέρασα, passive form ξαναπερνιέμαι)
δονώ	Verb	δονώ • (donó) (simple past δόνησα, passive form δονούμαι)
ανταγωνίζομαι	Verb	ανταγωνίζομαι • (antagonízomai) (simple past ανταγωνίστηκα, deponent)
ρίχνω	Verb	ρίχνω • (ríchno) (simple past έριξα, passive form ρίχνομαι)
πεινάω	Verb	πεινάω • (peináo) (simple past πείνασα)
διαδηλώνω	Verb	διαδηλώνω • (diadilóno) (simple past διαδήλωσα, passive form διαδηλώνομαι)
κουμπώνομαι	Verb	κουμπώνομαι • (koumpónomai) (simple past κουμπώθηκα, active form κουμπώνω, passive)
αποκλιμακώνω	Verb	αποκλιμακώνω • (apoklimakóno) (simple past αποκλιμάκωσα, passive form αποκλιμακώνομαι)
πταίω	Verb	πταίω • (ptaío) (simple past έφταιξα)
βεβαιώνω	Verb	βεβαιώνω • (vevaióno) (simple past βεβαίωσα)
προσαρτώ	Verb	προσαρτώ • (prosartó) (simple past προσάρτησα, passive form προσαρτώμαι)
ξανασυναντώ	Verb	ξανασυναντώ • (xanasynantó) (simple past ξανασυνάντησα, passive form ξανασυναντιέμαι)
αναρωτιέμαι	Verb	αναρωτιέμαι • (anarotiémai) (simple past αναρωτήθηκα, deponent)
σφυρίζω	Verb	σφυρίζω • (sfyrízo) (simple past σφύριξα)
χτυπάω	Verb	χτυπάω • (chtypáo) (simple past χτύπησα)
αντισταθμίζομαι	Verb	αντισταθμίζομαι • (antistathmízomai) (simple past αντισταθμίστηκα, active form αντισταθμίζω)
αυτοκτονώ	Verb	αυτοκτονώ • (aftoktonó) (simple past αυτοκτόνησα)
ψάχνω	Verb	ψάχνω • (psáchno) (simple past έψαξα, passive form ψάχνομαι)
απορροφώ	Verb	απορροφώ • (aporrofó) (simple past απορρόφησα)
χτίζω	Verb	χτίζω • (chtízo) (simple past έχτισα, passive form χτίζομαι)
θυμώνω	Verb	θυμώνω • (thymóno) (simple past θύμωσα)
δωρίζομαι	Verb	δωρίζομαι • (dorízomai) (simple past δωρίστηκα, active form δωρίζω, passive)
δημαγωγώ	Verb	δημαγωγώ • (dimagogó) (simple past δημαγώγησα, passive form —)
αποκρούω	Verb	αποκρούω • (apokroúo) (simple past απέκρουσα, passive form αποκρούομαι)
εισάγω	Verb	εισάγω • (eiságo) (simple past εισήγαγα, passive form εισάγομαι)
φρενιάζω	Verb	φρενιάζω • (freniázo) (simple past φρένιασα)
καθιερώνομαι	Verb	καθιερώνομαι • (kathierónomai) (simple past καθιερώθηκα, active form καθιερώνω, passive)
αιματοκυλίζομαι	Verb	αιματοκυλίζομαι • (aimatokylízomai) (simple past αιματοκυλίστηκα, active form αιματοκυλίζω, passive)
πλακώνομαι	Verb	πλακώνομαι • (plakónomai) (simple past πλακώθηκα, active form πλακώνω, passive)
λυτρώνω	Verb	λυτρώνω • (lytróno) (simple past λύτρωσα)
διανέμομαι	Verb	διανέμομαι • (dianémomai) (simple past διανεμήθηκα, active form διανέμω, passive)
δείχνω	Verb	δείχνω • (deíchno) (simple past έδειξα, passive form δείχνομαι)
αποδοκιμάζομαι	Verb	αποδοκιμάζομαι • (apodokimázomai) (simple past αποδοκιμάστηκα, active form αποδοκιμάζω, passive)
δέχομαι	Verb	δέχομαι • (déchomai) (simple past δέχτηκα or δέχθηκα, deponent)
γερνάω	Verb	γερνάω • (gernáo) (simple past γέρασα, passive form —)
παρακολουθώ	Verb	παρακολουθώ • (parakolouthó) (simple past παρακολούθησα, passive form παρακολουθούμαι)
αισθητοποιώ	Verb	αισθητοποιώ • (aisthitopoió) (simple past αισθητοποίησα, passive form αισθητοποιούμαι)
συνάπτω	Verb	συνάπτω • (synápto) (simple past σύναψα or συνήψα, passive form συνάπτομαι)
ακτινοβολάω	Verb	ακτινοβολάω • (aktinovoláo) (simple past ακτινοβόλησα)
διοργανώνομαι	Verb	διοργανώνομαι • (diorganónomai) (simple past διοργανώθηκα, active form διοργανώνω, passive)
αποφεύγω	Verb	αποφεύγω • (apofévgo) (simple past απέφυγα or απόφυγα, passive form αποφεύγομαι)
παραδέχομαι	Verb	παραδέχομαι • (paradéchomai) (simple past παραδέχτηκα or παραδέχθηκα, deponent)
πλέω	Verb	πλέω • (pléo) (simple past έπλευσα, passive form —)
εμβολιάζω	Verb	εμβολιάζω • (emvoliázo) (simple past εμβολίασα, passive form εμβολιάζομαι)
σέβομαι	Verb	σέβομαι • (sévomai) (simple past σεβάστηκα, deponent)
αντιτάσσομαι	Verb	αντιτάσσομαι • (antitássomai) (simple past αντιτάχθηκα or αντιτάχτηκα, active form αντιτάσσω, passive)
παραλείπω	Verb	παραλείπω • (paraleípo) (simple past παρέλειψα, passive form παραλείπομαι)
αποσβένομαι	Verb	αποσβένομαι • (aposvénomai) (simple past αποσβέστηκα, active form αποσβένω, passive)
διαχωρίζομαι	Verb	διαχωρίζομαι • (diachorízomai) (simple past διαχωρίστηκα, active form διαχωρίζω, passive)
δημεύω	Verb	δημεύω • (dimévo) (simple past δήμευσα, passive form δημεύομαι)
αγριοκοιτάω	Verb	αγριοκοιτάω • (agriokoitáo) (simple past αγριοκοίταξα)
ακινητοποιούμαι	Verb	ακινητοποιούμαι • (akinitopoioúmai) (simple past ακινητοποιήθηκα, active form ακινητοποιώ, passive)
επικροτώ	Verb	επικροτώ • (epikrotó) (simple past επικρότησα)
ποτίζω	Verb	ποτίζω • (potízo) (simple past πότισα, passive form ποτίζομαι)
τσεπώνω	Verb	τσεπώνω • (tsepóno) (simple past τσέπωσα)
επιβλέπω	Verb	επιβλέπω • (epivlépo) (simple past επέβλεψα)
κλυδωνίζομαι	Verb	κλυδωνίζομαι • (klydonízomai) (simple past κλυδωνίστηκα, deponent)
ενοικιάζω	Verb	ενοικιάζω • (enoikiázo) (simple past ενοικίασα)
θαυμάζω	Verb	θαυμάζω • (thavmázo) (simple past θαύμασα)
απογειώνω	Verb	απογειώνω • (apogeióno) (simple past απογείωσα, passive form απογειώνομαι)
σκουπίζω	Verb	σκουπίζω • (skoupízo) (simple past σκούπισα)
οικοδομώ	Verb	οικοδομώ • (oikodomó) (simple past οικοδόμησα, passive form οικοδομούμαι)
σταθμεύω	Verb	σταθμεύω • (stathmévo) (simple past στάθμευσα, passive form —)
θα είναι	Verb	θα είναι • (tha eínai)
ποτίζομαι	Verb	ποτίζομαι • (potízomai) (simple past ποτίστηκα, active form ποτίζω, passive)
συζητούμαι	Verb	συζητούμαι • (syzitoúmai) (simple past συζητήθηκα, active form συζητώ, mediopassive)
περιγράφω	Verb	περιγράφω • (perigráfo) (simple past περιέγραψα, passive form περιγράφομαι)
δέρνομαι	Verb	δέρνομαι • (dérnomai) (simple past δάρθηκα, active form δέρνω, passive)
φτιάχνω	Verb	φτιάχνω • (ftiáchno) (simple past έφτιαξα, passive form φτιάχνομαι, active)
αρέσω	Verb	αρέσω • (aréso) (simple past άρεσα, passive form —)
αδροπληρώνω	Verb	αδροπληρώνω • (adropliróno) (simple past αδροπλήρωσα)
γερνώ	Verb	γερνώ • (gernó) (simple past γέρασα, passive form —)
προφητεύω	Verb	προφητεύω • (profitévo) (simple past προφήτευσα)
τολμάω	Verb	τολμάω • (tolmáo) (simple past τόλμησα)
ψαρεύω	Verb	ψαρεύω • (psarévo) (simple past ψάρεψα)
απασχολούμαι	Verb	απασχολούμαι • (apascholoúmai) (simple past απασχολήθηκα, active form απασχολώ, passive)
συμπεθερεύω	Verb	συμπεθερεύω • (sympetherévo) (simple past συμπεθέρεψα)
ονομάζω	Verb	ονομάζω • (onomázo) (simple past ονόμασα, passive form ονομάζομαι)
αμβλύνομαι	Verb	αμβλύνομαι • (amvlýnomai) (simple past αμβλύνθηκα, active form αμβλύνω, passive)
αλφαδιάζομαι	Verb	αλφαδιάζομαι • (alfadiázomai) (simple past αλφαδιάστηκα, active form αλφαδιάζω, passive)
πετυχαίνω	Verb	πετυχαίνω • (petychaíno) (simple past πέτυχα or επέτυχα, passive form επιτυγχάνομαι)
αγάλλομαι	Verb	αγάλλομαι • (agállomai) (active form αγαλλιάζω, found only in the present tense, passive)
φιλάω	Verb	φιλάω • (filáo) (simple past φίλησα)
κυοφορούμαι	Verb	κυοφορούμαι • (kyoforoúmai) (simple past κυοφορήθηκα, active form κυοφορώ, passive)
έχουνε	Verb	έχουνε • (échoune)
εγκαθιστώ	Verb	εγκαθιστώ • (egkathistó) (simple past εγκατέστησα, passive form εγκαθίσταμαι)
αγιογραφώ	Verb	αγιογραφώ • (agiografó) (simple past αγιογράφησα, passive form αγιογραφούμαι)
σπέρνομαι	Verb	σπέρνομαι • (spérnomai) (simple past σπάρθηκα, active form σπέρνω, passive)
ξεσκατώνομαι	Verb	ξεσκατώνομαι • (xeskatónomai) (simple past ξεσκατώθηκα, active form ξεσκατώνω, passive)
γαλουχώ	Verb	γαλουχώ • (galouchó) (simple past γαλούχησα)
αντιστέκομαι	Verb	αντιστέκομαι • (antistékomai) (simple past αντιστάθηκα)
ελπίζω	Verb	ελπίζω • (elpízo) (simple past έλπισα or ήλπισα, passive form —)
αλυχτώ	Verb	αλυχτώ • (alychtó) (simple past αλύχτησα)
τρέπω	Verb	τρέπω • (trépo) (simple past έτρεψα, passive form τρέπομαι)
απογαλακτίζω	Verb	απογαλακτίζω • (apogalaktízo) (simple past απογαλάκτισα, passive form απογαλακτίζομαι)
αμπαρώνομαι	Verb	αμπαρώνομαι • (amparónomai) (simple past αμπαρώθηκα, active form αμπαρώνω, passive)
αποχτώ	Verb	αποχτώ • (apochtó) (simple past απόκτησα or απέκτησα)
αντιγράφω	Verb	αντιγράφω • (antigráfo) (simple past αντέγραψα, passive form αντιγράφομαι)
ξαρμυρίζω	Verb	ξαρμυρίζω • (xarmyrízo) (simple past ξαρμύρισα)
προσκαλώ	Verb	προσκαλώ • (proskaló) (simple past προσκάλεσα, passive form προσκαλούμαι)
ξεκουράζω	Verb	ξεκουράζω • (xekourázo) (simple past ξεκούρασα, passive form ξεκουράζομαι)
ακροάζομαι	Verb	ακροάζομαι • (akroázomai) (simple past ακροάστηκα, deponent)
διαθλώμαι	Verb	διαθλώμαι • (diathlómai) (simple past διαθλάστηκα, active form διαθλώ, passive)
απονέμω	Verb	απονέμω • (aponémo) (simple past απένειμα or απόνειμα, passive form απονέμομαι)
αποχαιρετάω	Verb	αποχαιρετάω • (apochairetáo) (simple past αποχαιρέτησα)
βαστώ	Verb	βαστώ • (vastó) (simple past βάσταξα or βάστηξα, passive form βαστιέμαι)
αναπολώ	Verb	αναπολώ • (anapoló) (simple past αναπόλησα)
σημαδεύω	Verb	σημαδεύω • (simadévo) (simple past σημάδεψα)
προκόβω	Verb	προκόβω • (prokóvo) (simple past πρόκοψα)
αμαλγαμώνω	Verb	αμαλγαμώνω • (amalgamóno) (simple past αμαλγάμωσα)
γαργαλίζομαι	Verb	γαργαλίζομαι • (gargalízomai) (simple past γαργαλίστηκα, active form γαργαλίζω, passive)
αναπτύσσομαι	Verb	αναπτύσσομαι • (anaptýssomai) (simple past αναπτύχθηκα, active form αναπτύσσω, mediopassive)
πίνομαι	Verb	πίνομαι • (pínomai) (active form πίνω, found only in the present and imperfect tenses, passive)
εκδίδω	Verb	εκδίδω • (ekdído) (simple past εξέδωσα, passive form εκδίδομαι)
τρομάζω	Verb	τρομάζω • (tromázo) (simple past τρόμαξα)
αδιαφορώ	Verb	αδιαφορώ • (adiaforó) (simple past αδιαφόρησα, passive form —)
καταδιώκομαι	Verb	καταδιώκομαι • (katadiókomai) (simple past καταδιώχτηκα or καταδιώχθηκα, active form καταδιώκω, passive)
ανυψώνω	Verb	ανυψώνω • (anypsóno) (simple past ανύψωσα, passive form ανυψώνομαι)
μαζεύω	Verb	μαζεύω • (mazévo) (simple past μάζεψα, passive form μαζεύομαι, active)
ανταποδίδω	Verb	ανταποδίδω • (antapodído) (simple past ανταπέδωσα)
λιποθυμάω	Verb	λιποθυμάω • (lipothymáo) (simple past λιποθύμησα, passive form —)
αμερικανίζω	Verb	αμερικανίζω • (amerikanízo) (found only in the present and imperfect tenses)
απογοητεύω	Verb	απογοητεύω • (apogoitévo) (simple past απογοήτευσα, passive form απογοητεύομαι)
αναπτερώνομαι	Verb	αναπτερώνομαι • (anapterónomai) (simple past αναπτερώθηκα, active form αναπτερώνω, passive)
αναστενάζω	Verb	αναστενάζω • (anastenázo) (simple past αναστέναξα, passive form —)
αγγαρεύομαι	Verb	αγγαρεύομαι • (angarévomai) (simple past αγγαρεύτηκα, active form αγγαρεύω, passive)
οικονομώ	Verb	οικονομώ • (oikonomó) (simple past οικονόμησα, passive form οικονομιέμαι)
αντανακλώμαι	Verb	αντανακλώμαι • (antanaklómai) (simple past αντανακλάστηκα, active form αντανακλώ, passive)
γαργαλιέμαι	Verb	γαργαλιέμαι • (gargaliémai) (simple past γαργαλήθηκα, active form γαργαλώ, passive)
ρίχνομαι	Verb	ρίχνομαι • (ríchnomai) (simple past ρίχτηκα, active form ρίχνω, passive)
παραδίδω	Verb	παραδίδω • (paradído) (simple past παρέδωσα or παράδωσα, passive form παραδίδομαι)
βγάζω άκρη	Verb	βγάζω άκρη • (vgázo ákri) (simple past έβγαλα άκρη)
ταιριάζω	Verb	ταιριάζω • (tairiázo) (simple past ταίριαξα)
στείβω	Verb	στείβω • (steívo) (simple past έστειψα)
διαβάζω	Verb	διαβάζω • (diavázo) (simple past διάβασα, passive form διαβάζομαι)
καταστρέφομαι	Verb	καταστρέφομαι • (katastréfomai) (simple past καταστράφηκα, active form καταστρέφω, passive)
αποτυχαίνω	Verb	αποτυχαίνω • (apotychaíno) (simple past απέτυχα or απότυχα)
απαλλάσσω	Verb	απαλλάσσω • (apallásso) (simple past απάλλαξα, passive form απαλάσσομαι)
βεβαιώνομαι	Verb	βεβαιώνομαι • (vevaiónomai) (simple past βεβαιώθηκα, active form βεβαιώνω, passive)
πανικοβάλλομαι	Verb	πανικοβάλλομαι • (panikovállomai) (simple past πανικοβλήθηκα, active form πανικοβάλλω)
ανατρέφομαι	Verb	ανατρέφομαι • (anatréfomai) (simple past ανατράφηκα, active form ανατρέφω, passive)
αδρανοποιούμαι	Verb	αδρανοποιούμαι • (adranopoioúmai) (simple past αδρανοποιήθηκα, active form αδρανοποιώ, passive)
τεκμηριώνω	Verb	τεκμηριώνω • (tekmirióno) (simple past τεκμηρίωσα)
πίνω	Verb	πίνω • (píno) (simple past ήπια, passive form πίνομαι)
θα έχουν	Verb	θα έχουν • (tha échoun)
διανθίζομαι	Verb	διανθίζομαι • (dianthízomai) (simple past διανθίστηκα, active form διανθίζω, passive)
ασθμαίνω	Verb	ασθμαίνω • (asthmaíno) (found only in the present and imperfect tenses)
αγγέλλομαι	Verb	αγγέλλομαι • (angéllomai) (simple past αγγέλθηκα, active form αγγέλλω, passive)
είχες	Verb	είχες • (eíches)
φεύγω	Verb	φεύγω • (févgo) (simple past έφυγα)
θεωρούμαι	Verb	θεωρούμαι • (theoroúmai) (simple past θεωρήθηκα, active form θεωρώ, passive)
πουλάω	Verb	πουλάω • (pouláo) (simple past πούλησα, passive form πουλιέμαι)
φοβίζω	Verb	φοβίζω • (fovízo) (simple past φόβισα, passive form —)
αλληθωρίζω	Verb	αλληθωρίζω • (allithorízo) (simple past αλληθώρισα)
αντικαθιστώ	Verb	αντικαθιστώ • (antikathistó) (simple past αντικατέστησα or αντικατάστησα)
γλεντάω	Verb	γλεντάω • (glentáo) (simple past γλέντησα, passive form —)
προσθέτω	Verb	προσθέτω • (prosthéto) (simple past πρόσθεσα, passive form προστίθεμαι or προσθέτομαι)
ωθώ	Verb	ωθώ • (othó) (simple past ώθησα)
φέρω	Verb	φέρω • (féro) (simple past έφερα, passive form φέρνομαι)
αλαφραίνω	Verb	αλαφραίνω • (alafraíno) (simple past αλάφρυνα)
βολιδοσκοπούμαι	Verb	βολιδοσκοπούμαι • (volidoskopoúmai) (simple past βολιδοσκοπήθηκα, active form βολιδοσκοπώ, passive)
πανικοβάλλω	Verb	πανικοβάλλω • (panikovállo) (simple past πανικόβαλα, passive form πανικοβάλλομαι)
κυνηγώ	Verb	κυνηγώ • (kynigó) (simple past κυνήγησα)
συγχαίρω	Verb	συγχαίρω • (synchaíro) (simple past συγχάρηκα)
αφορίζομαι	Verb	αφορίζομαι • (aforízomai) (simple past αφορίστηκα, active form αφορίζω, passive)
θα έχετε	Verb	θα έχετε • (tha échete)
αποφέρω	Verb	αποφέρω • (apoféro) (simple past απέφερα)
κατηγορούμαι	Verb	κατηγορούμαι • (katigoroúmai) (simple past κατηγορήθηκα, active form κατηγορώ, passive)
ακτινοβολώ	Verb	ακτινοβολώ • (aktinovoló) (simple past ακτινοβόλησα)
ασελγώ	Verb	ασελγώ • (aselgó) (simple past ασέλγησα)
αρματώνω	Verb	αρματώνω • (armatóno) (simple past αρμάτωσα, passive form αρματώνομαι)
χώρα	Verb	χώρα • (chóra)
ταχυδρομώ	Verb	ταχυδρομώ • (tachydromó) (simple past ταχυδρόμησα)
αποκτώ	Verb	αποκτώ • (apoktó) (simple past απέκτησα or απόκτησα, passive form αποκτιέμαι or αποκτώμαι)
περιορίζομαι	Verb	περιορίζομαι • (periorízomai) (simple past περιορίστηκα, active form περιορίζω, passive)
αποτιμώμαι	Verb	αποτιμώμαι • (apotimómai) (simple past αποτιμήθηκα, active form αποτιμώ, passive)
παραλύω	Verb	παραλύω • (paralýo) (simple past παρέλυσα or παράλυσα)
μιαίνω	Verb	μιαίνω • (miaíno) (simple past μίανα, passive form μιαίνομαι)
αλαλάζω	Verb	αλαλάζω • (alalázo) (simple past αλάλαξα)
παραλαβαίνω	Verb	παραλαβαίνω • (paralavaíno) (simple past παρέλαβα, passive form —)
ρεζιλεύομαι	Verb	ρεζιλεύομαι • (rezilévomai) (simple past ρεζιλεύτηκα, active form ρεζιλεύω, passive)
διαπερνώ	Verb	διαπερνώ • (diapernó) (simple past διαπέρασα, passive form διαπερνιέμαι)
αγγέλλω	Verb	αγγέλλω • (angéllo) (simple past άγγειλα or ήγγειλα, passive form αγγέλλομαι)
στέλνω	Verb	στέλνω • (stélno) (simple past έστειλα, passive form στέλνομαι)
πεθαίνω	Verb	πεθαίνω • (pethaíno) (simple past πέθανα)
εξετάζω	Verb	εξετάζω • (exetázo) (simple past εξέτασα, passive form εξετάζομαι)
θυμούμαι	Verb	θυμούμαι • (thymoúmai) (simple past θυμήθηκα, deponent)
σπαταλώ	Verb	σπαταλώ • (spataló) (simple past σπατάλησα)
μουρμουρίζω	Verb	μουρμουρίζω • (mourmourízo) (simple past μουρμούρισα)
αλλάζομαι	Verb	αλλάζομαι • (allázomai) (simple past αλλάχτηκα, active form αλλάζω, passive)
απαλάσσω	Verb	απαλάσσω • (apalásso) (simple past απάλλαξα, passive form απαλάσσομαι)
καταφέρνω	Verb	καταφέρνω • (kataférno) (simple past κατάφερα, passive form —)
απομακρύνω	Verb	απομακρύνω • (apomakrýno) (simple past απομάκρυνα)
αγνοώ	Verb	αγνοώ • (agnoó) (simple past αγνόησα, passive form αγνοούμαι)
κουράζω	Verb	κουράζω • (kourázo) (simple past κούρασα, passive form κουράζομαι)
δοκιμάζομαι	Verb	δοκιμάζομαι • (dokimázomai) (simple past δοκιμάστηκα, active form δοκιμάζω, passive)
ανακινώ	Verb	ανακινώ • (anakinó) (simple past ανακίνησα, passive form ανακινούμαι)
ξυπνώ	Verb	ξυπνώ • (xypnó) (simple past ξύπνησα)
αγκυροβολώ	Verb	αγκυροβολώ • (agkyrovoló) (simple past αγκυροβόλησα)
τηλεφωνάω	Verb	τηλεφωνάω • (tilefonáo) (simple past τηλεφώνησα)
φυτεύω	Verb	φυτεύω • (fytévo) (simple past φύτεψα, passive form φυτεύομαι)
τηγανίζομαι	Verb	τηγανίζομαι • (tiganízomai) (simple past τηγανίστηκα, active form τηγανίζω, passive)
κοιτάω	Verb	κοιτάω • (koitáo) (simple past κοίταξα, passive form κοιτιέμαι)
πουλιέμαι	Verb	πουλιέμαι • (pouliémai) (simple past πουλήθηκα, active form πουλώ, passive)
παρακαλώ	Verb	παρακαλώ • (parakaló) (simple past παρακάλεσα)
χτικιάζομαι	Verb	χτικιάζομαι • (chtikiázomai) (simple past χτικιάστηκα, active form χτικιάζω, passive)
οικοδομούμαι	Verb	οικοδομούμαι • (oikodomoúmai) (simple past οικοδομήθηκα, active form οικοδομώ, passive)
απειλούμαι	Verb	απειλούμαι • (apeiloúmai) (simple past απειλήθηκα, active form απειλώ, passive)
γυμνάζω	Verb	γυμνάζω • (gymnázo) (simple past γύμνασα, passive form γυμνάζομαι)
ονομάζομαι	Verb	ονομάζομαι • (onomázomai) (simple past ονομάστηκα, active form ονομάζω, passive)
αναμένω	Verb	αναμένω • (anaméno) (simple past ανέμεινα)
αγαναχτώ	Verb	αγαναχτώ • (aganachtó) (simple past αγανάχτησα)
αναγραμματίζω	Verb	αναγραμματίζω • (anagrammatízo) (simple past αναγραμμάτισα)
φασκιώνομαι	Verb	φασκιώνομαι • (faskiónomai) (simple past φασκιώθηκα, active form φασκιώνω, passive)
κλαίγω	Verb	κλαίγω • (klaígo) (simple past έκλαψα, passive form κλαίγομαι)
προσγειώνω	Verb	προσγειώνω • (prosgeióno) (simple past προσγείωσα, passive form προσγειώνομαι)
διδάσκω	Verb	διδάσκω • (didásko) (simple past δίδαξα, passive form διδάσκομαι)
μοιράζω	Verb	μοιράζω • (moirázo) (simple past μοίρασα, passive form μοιράζομαι)
εκλέγομαι	Verb	εκλέγομαι • (eklégomai) (simple past εκλέχτηκα or εκλέχθηκα, active form εκλέγω, passive)
αθυμώ	Verb	αθυμώ • (athymó) (simple past αθύμησα)
αδρανώ	Verb	αδρανώ • (adranó) (simple past αδράνησα)
χειροκροτώ	Verb	χειροκροτώ • (cheirokrotó) (simple past χειροκρότησα)
ζω	Verb	ζω • (zo) (simple past έζησα)
κλαίγομαι	Verb	κλαίγομαι • (klaígomai) (simple past κλαύτηκα, active form κλαίω, passive)
ευημερώ	Verb	ευημερώ • (evimeró) (found only in the present and imperfect tenses)
βολιδοσκοπώ	Verb	βολιδοσκοπώ • (volidoskopó) (simple past βολιδοσκόπησα, passive form βολιδοσκοπούμαι)
ορίζοντας	Verb	ορίζοντας • (orízontas)
ξοδεύομαι	Verb	ξοδεύομαι • (xodévomai) (simple past ξοδεύτηκα, active form ξοδεύω, mediopassive)
προσγειώνομαι	Verb	προσγειώνομαι • (prosgeiónomai) (simple past προσγειώθηκα, active form προσγειώνω, passive)
περιποιούμαι	Verb	περιποιούμαι • (peripoioúmai) (simple past περιποιήθηκα, deponent)
πουστοφέρνω	Verb	πουστοφέρνω • (poustoférno) (found only in the present and imperfect tenses)
αναστηλώνω	Verb	αναστηλώνω • (anastilóno) (simple past αναστήλωσα, passive form αναστηλώνομαι)
καταθέτω	Verb	καταθέτω • (katathéto) (simple past κατέθεσα, passive form κατατίθεμαι)
ακριβοπληρώνω	Verb	ακριβοπληρώνω • (akrivopliróno) (simple past ακριβοπλήρωσα)
ακυρολεκτώ	Verb	ακυρολεκτώ • (akyrolektó) (simple past ακυρολέκησα)
ενεδρεύω	Verb	ενεδρεύω • (enedrévo) (simple past —, found only in the present and imperfect tenses)
επιδοκιμάζω	Verb	επιδοκιμάζω • (epidokimázo) (simple past επιδοκίμασα, passive form επιδοκιμάζομαι)
κηρύσσω	Verb	κηρύσσω • (kirýsso) (simple past κήρυξα, passive form κηρύσσομαι)
προετοιμάζομαι	Verb	προετοιμάζομαι • (proetoimázomai) (simple past προετοιμάστηκα, active form προετοιμάζω, passive)
ανεβοκατεβαίνω	Verb	ανεβοκατεβαίνω • (anevokatevaíno) (simple past ανεβοκατέβηκα, passive form —)
είχα	Verb	είχα • (eícha)
λαμβάνομαι	Verb	λαμβάνομαι • (lamvánomai) (simple past —, active form λαμβάνω, passive)
διαλύομαι	Verb	διαλύομαι • (dialýomai) (simple past διαλύθηκα, active form διαλύω, passive)
ιατρεύω	Verb	ιατρεύω • (iatrévo) (simple past ιάτρεψα)
υπακούω	Verb	υπακούω • (ypakoúo) (simple past υπάκουσα)
μιαίνομαι	Verb	μιαίνομαι • (miaínomai) (simple past μιάνθηκα, active form μιαίνω, passive)
τρώγω	Verb	τρώγω • (trógo) (simple past έφαγα, passive form τρώγομαι)
ακούω	Verb	ακούω • (akoúo) (simple past άκουσα, passive form ακούγομαι)
τρελαίνω	Verb	τρελαίνω • (trelaíno) (simple past τρέλανα, passive form τρελαίνομαι)
εμώ	Verb	εμώ • (emó) (simple past εξέμεσα)
ενεργώ	Verb	ενεργώ • (energó) (simple past ενέργησα)
ανακαλώ	Verb	ανακαλώ • (anakaló) (simple past ανακάλεσα, passive form ανακαλούμαι)
αποχωρώ	Verb	αποχωρώ • (apochoró) (simple past αποχώρησα)
παραπέμπω	Verb	παραπέμπω • (parapémpo) (simple past παρέπεμψα)
μαθεύομαι	Verb	μαθεύομαι • (mathévomai) (simple past μαθεύτηκε, deponent)
γίνομαι	Verb	γίνομαι • (gínomai) (simple past έγινα, deponent)
ξαίνω	Verb	ξαίνω • (xaíno) (simple past έξανα)
ξεριζώνω	Verb	ξεριζώνω • (xerizóno) (simple past ξερίζωσα, passive form ξεριζώνομαι)
παρακινώ	Verb	παρακινώ • (parakinó) (simple past παρακίνησα)
αίρομαι	Verb	αίρομαι • (aíromai) (simple past άρθηκα, active form αίρω, passive)
συλλογίζομαι	Verb	συλλογίζομαι • (syllogízomai) (simple past συλλογίστηκα, deponent)
μελετώ	Verb	μελετώ • (meletó) (simple past μελέτησα, passive form μελετώμαι)
βογκώ	Verb	βογκώ • (vogkó) (simple past βόγκηξα, passive form —)
τρώω	Verb	τρώω • (tróo) (simple past έφαγα, passive form τρώγομαι)
καταφρονώ	Verb	καταφρονώ • (katafronó) (simple past καταφρόνησα, passive form καταφρονούμαι)
γαργαλεύω	Verb	γαργαλεύω • (gargalévo) (simple past γαργάλεψα, passive form γαργαλεύομαι)
επιβάλλω	Verb	επιβάλλω • (epivállo) (simple past επέβαλα, passive form επιβάλλομαι)
ροχαλίζω	Verb	ροχαλίζω • (rochalízo) (simple past ροχάλισα)
λησμονάω	Verb	λησμονάω • (lismonáo) (simple past αλησμόνησα)
αναβάλλω	Verb	αναβάλλω • (anavállo) (simple past ανέβαλα, passive form αναβάλλομαι)
σιχαίνομαι	Verb	σιχαίνομαι • (sichaínomai) (simple past σιχάθηκα, deponent)
μισθώνομαι	Verb	μισθώνομαι • (misthónomai) (simple past μισθώθηκα, active form μισθώνω, passive)
αγκυλώνομαι	Verb	αγκυλώνομαι • (agkylónomai) (simple past αγκυλώθηκα, active form αγκυλώνω, passive)
επικρατώ	Verb	επικρατώ • (epikrató) (simple past επικράτησα, passive form —)
χάφτω	Verb	χάφτω • (cháfto) (simple past έχαψα)
ανταμείβομαι	Verb	ανταμείβομαι • (antameívomai) (simple past ανταμείφθηκα or ανταμείφτηκα, active form ανταμείβω, passive)
εισρέω	Verb	εισρέω • (eisréo) (simple past εισέρρευσα)
βαθμολογούμαι	Verb	βαθμολογούμαι • (vathmologoúmai) (simple past βαθμολογήθηκα, active form βαθμολογώ, passive)
αρνιούμαι	Verb	αρνιούμαι • (arnioúmai) (simple past αρνήθηκα, deponent)
ξεραίνω	Verb	ξεραίνω • (xeraíno) (simple past ξέρανα, passive form ξεραίνομαι)
αδειάζομαι	Verb	αδειάζομαι • (adeiázomai) (simple past αδειάστηκα, active form αδειάζω, passive)
τρύπα	Verb	τρύπα • (trýpa)
αναδιοργανώνομαι	Verb	αναδιοργανώνομαι • (anadiorganónomai) (simple past αναδιοργανώθηκα, active form αναδιοργανώνω, passive)
συγχωράω	Verb	συγχωράω • (synchoráo) (simple past συγχώρεσα or συγχώρησα, passive form συγχωρούμαι)
κεντάω	Verb	κεντάω • (kentáo) (simple past κέντησα, passive form κεντιέμαι)
κρύβομαι	Verb	κρύβομαι • (krývomai) (simple past κρύφτηκα, active form κρύβω, passive)
μαθαίνω	Verb	μαθαίνω • (mathaíno) (simple past έμαθα, passive form —)
καθαρίζομαι	Verb	καθαρίζομαι • (katharízomai) (simple past καθαρίστηκα, active form καθαρίζω, passive)
γαργαλάω	Verb	γαργαλάω • (gargaláo) (simple past γαργάλησα, passive form γαργαλιέμαι)
τραβιέμαι	Verb	τραβιέμαι • (traviémai) (simple past τραβήχτηκα, active form τραβάω, passive)
προπονώ	Verb	προπονώ • (proponó) (simple past προπόνησα, passive form προπονούμαι)
σερβιρίζω	Verb	σερβιρίζω • (servirízo) (simple past σερβίρισα, passive form σερβιρίζομαι)
παρακοιμάμαι	Verb	παρακοιμάμαι • (parakoimámai) (simple past παρακοιμήθηκα, deponent)
ακρωτηριάζω	Verb	ακρωτηριάζω • (akrotiriázo) (simple past ακρωτηρίασα, passive form ακρωτηριάζομαι)
σηκώνομαι	Verb	σηκώνομαι • (sikónomai) (simple past σηκώθηκα, active form σηκώνω, active)
αποσυνδέω	Verb	αποσυνδέω • (aposyndéo) (simple past αποσύνδεσα, passive form αποσυνδέομαι)
πονάω	Verb	πονάω • (ponáo) (simple past πόνεσα)
χέζομαι	Verb	χέζομαι • (chézomai) (simple past χέστηκα, active form χέζω, passive)
βουλώνω	Verb	βουλώνω • (voulóno) (simple past βούλωσα)
δημοσιεύομαι	Verb	δημοσιεύομαι • (dimosiévomai) (simple past δημοσιεύτηκα or δημοσιεύθηκα, active form δημοσιεύω, passive)
ζαλίζω	Verb	ζαλίζω • (zalízo) (simple past ζάλισα, passive form ζαλίζομαι)
αιτιολογώ	Verb	αιτιολογώ • (aitiologó) (simple past αιτιολόγησα, passive form αιτιολούμαι)
κοπανίζω	Verb	κοπανίζω • (kopanízo) (simple past κοπάνισα)
αγγελιάζομαι	Verb	αγγελιάζομαι • (angeliázomai) (simple past αγγελιάστηκα, deponent)
επικοινωνώ	Verb	επικοινωνώ • (epikoinonó) (simple past επικοινώνησα)
εξαρτήθηκα	Verb	εξαρτήθηκα • (exartíthika)
μισώ	Verb	μισώ • (misó) (simple past μίσησα, passive form μισούμαι)
αγκριώνω	Verb	αγκριώνω • (agkrióno) (simple past αγκρίωσα)
φαρμακώνω	Verb	φαρμακώνω • (farmakóno) (simple past φαρμάκωσα, passive form φαρμακώνομαι)
περιγράφομαι	Verb	περιγράφομαι • (perigráfomai) (simple past περιγράφηκα or περιγράφτηκα, active form περιγράφω, passive)
δίνομαι	Verb	δίνομαι • (dínomai) (simple past δόθηκα, active form δίνω, mediopassive)
πορδίζω	Verb	πορδίζω • (pordízo) (simple past πόρδισα)
ρωτώ	Verb	ρωτώ • (rotó) (simple past ρώτησα, passive form ρωτιέμαι)
κανονίζω	Verb	κανονίζω • (kanonízo) (simple past κανόνισα, passive form κανονίζομαι)
αποτραβώ	Verb	αποτραβώ • (apotravó) (simple past αποτράβηξα, passive form αποτραβιέμαι)
ανακηρύσσομαι	Verb	ανακηρύσσομαι • (anakirýssomai) (simple past ανακηρύχθηκα or ανακηρύχτηκα, active form ανακηρύσσω, passive)
προέρχομαι	Verb	προέρχομαι • (proérchomai) (simple past προήλθα, deponent)
αποζημιώνομαι	Verb	αποζημιώνομαι • (apozimiónomai) (simple past αποζημιώθηκα, active form αποζημιώνω, passive)
καβουρντίζω	Verb	καβουρντίζω • (kavourntízo) (simple past καβούρντισα, passive form καβουρντίζομαι)
θέλω	Verb	θέλω • (thélo) (simple past θέλησα, passive form —)
δηλώνω	Verb	δηλώνω • (dilóno) (simple past δήλωσα, passive form δηλώνομαι)
δέρνω	Verb	δέρνω • (dérno) (simple past έδειρα, passive form δέρνομαι)
σπουδάζω	Verb	σπουδάζω • (spoudázo) (simple past σπούδασα)
θειαφίζομαι	Verb	θειαφίζομαι • (theiafízomai) (simple past θειαφίστηκα, active form θειαφίζω, passive)
δίνω	Verb	δίνω • (díno) (simple past έδωσα, passive form δίνομαι)
ακροώμαι	Verb	ακροώμαι • (akroómai) (simple past ακροάστηκα, deponent)
κατευνάζομαι	Verb	κατευνάζομαι • (katevnázomai) (simple past κατευνάστηκα, active form κατευνάζω, passive)
υπερτιμώμαι	Verb	υπερτιμώμαι • (ypertimómai) (simple past υπερτιμήθηκα, active form υπερτιμώ, passive)
δωροδοκώ	Verb	δωροδοκώ • (dorodokó) (simple past δωροδόκησα, passive form δωροδοκούμαι)
συγχωρούμαι	Verb	συγχωρούμαι • (synchoroúmai) (simple past συγχωρήθηκα, active form συγχωρώ, passive)
ήμασταν	Verb	ήμασταν • (ímastan)
παραβιάζω	Verb	παραβιάζω • (paraviázo) (simple past παραβίασα)
σέρνομαι	Verb	σέρνομαι • (sérnomai) (simple past σύρθηκα, active form σέρνω, mediopassive)
πλεονάζω	Verb	πλεονάζω • (pleonázo) (simple past πλεόνασα)
ακολουθάω	Verb	ακολουθάω • (akoloutháo) (simple past ακολούθησα, passive form ακολουθούμαι or ακολουθιέμαι)
πατιέμαι	Verb	πατιέμαι • (patiémai) (simple past πατήθηκα, active form πατάω, passive)
υποπτεύομαι	Verb	υποπτεύομαι • (ypoptévomai) (simple past υποπτεύτηκα or υποπτεύθηκα, deponent)
περιπλέκω	Verb	περιπλέκω • (peripléko) (simple past περιέπλεξα)
λέω	Verb	λέω • (léo) (simple past είπα, passive form λέγομαι)
ρωτιέμαι	Verb	ρωτιέμαι • (rotiémai) (simple past ρωτήθηκα, active form ρωτάω, passive)
νιώθω	Verb	νιώθω • (niótho) (simple past ένιωσα, passive form —)
αρματώνομαι	Verb	αρματώνομαι • (armatónomai) (simple past αρματώθηκα, active form αρματώνω, passive)
ανακάθομαι	Verb	ανακάθομαι • (anakáthomai) (simple past ανακάθησα, deponent)
κυοφορώ	Verb	κυοφορώ • (kyoforó) (simple past κυοφόρησα, passive form κυοφορούμαι)
γυρεύω	Verb	γυρεύω • (gyrévo) (simple past γύρεψα)
εξασφαλίζω	Verb	εξασφαλίζω • (exasfalízo) (simple past εξασφάλισα, passive form εξασφαλίζομαι)
επιπλέω	Verb	επιπλέω • (epipléo) (simple past επέπλευσα)
απλώνομαι	Verb	απλώνομαι • (aplónomai) (simple past απλώθηκα, active form απλώνω, passive)
κερατώνω	Verb	κερατώνω • (keratóno) (simple past κεράτωσα, passive form κερατώνομαι)
αναπληρώνομαι	Verb	αναπληρώνομαι • (anaplirónomai) (simple past αναπληρώθηκα, active form αναπληρώνω, passive)
αλείβω	Verb	αλείβω • (aleívo) (simple past άλειψα, passive form αλείβομαι, active)
ατακτώ	Verb	ατακτώ • (ataktó) (simple past ατάκτησα)
νοιάζομαι	Verb	νοιάζομαι • (noiázomai) (simple past νοιάστηκα, deponent)
ισχύω	Verb	ισχύω • (ischýo) (simple past ίσχυσα)
κατασκοπεύω	Verb	κατασκοπεύω • (kataskopévo) (simple past κατασκόπευσα or κατασκόπεψα)
ανορθώνομαι	Verb	ανορθώνομαι • (anorthónomai) (simple past ανορθώθηκα, active form ανορθώνω, passive)
επιτρέπω	Verb	επιτρέπω • (epitrépo) (simple past επέτρεψα, passive form επιτρέπομαι)
ζητώ	Verb	ζητώ • (zitó) (simple past ζήτησα, passive form ζητούμαι or ζητιέμαι)
ανακοινώνω	Verb	ανακοινώνω • (anakoinóno) (simple past ανακοίνωσα, passive form ανακοινώνομαι)
μακρηγορώ	Verb	μακρηγορώ • (makrigoró) (simple past μακρηγόρησα)
τσιμπουκώνομαι	Verb	τσιμπουκώνομαι • (tsimpoukónomai) (simple past τσιμπουκώθηκα, active form τσιμπουκώνω, passive)
κρατιέμαι	Verb	κρατιέμαι • (kratiémai) (simple past κρατήθηκα, active form κρατάω, mediopassive)
γαρνίρω	Verb	γαρνίρω • (garníro) (simple past γαρνίρισα, passive form γαρνίρομαι)
καλουπώνω	Verb	καλουπώνω • (kaloupóno) (simple past καλούπωσα, passive form καλουπώνομαι)}}
αγγέλω	Verb	αγγέλω • (angélo) (simple past ήγγειλα or άγγειλα, passive form αγγέλλομαι)
προκαταβάλλω	Verb	προκαταβάλλω • (prokatavállo) (simple past προκατέβαλα, passive form προκαταβάλλομαι)
οπλίζομαι	Verb	οπλίζομαι • (oplízomai) (simple past οπλίστηκα, active form οπλίζω, passive)
καταλύω	Verb	καταλύω • (katalýo) (simple past κατέλυσα)
εφευρίσκομαι	Verb	εφευρίσκομαι • (efevrískomai) (simple past εφευρέθηκα, active form εφευρίσκω, passive)
αποικίζω	Verb	αποικίζω • (apoikízo) (simple past αποίκισα, passive form αποικίζομαι)
βογγώ	Verb	βογγώ • (vongó) (simple past βόγγηξα, passive form —)
αποσύρομαι	Verb	αποσύρομαι • (aposýromai) (simple past αποσύρθηκα, active form αποσύρω, mediopassive)
αποτελώ	Verb	αποτελώ • (apoteló) (simple past αποτέλεσα, passive form αποτελούμαι)
διανέμω	Verb	διανέμω • (dianémo) (simple past διένειμα, passive form διανέμομαι)
αλευροποιώ	Verb	αλευροποιώ • (alevropoió) (simple past αλευροποίησα)
σκοτώνομαι	Verb	σκοτώνομαι • (skotónomai) (simple past σκοτώθηκα, active form σκοτώνω, passive)
αιφνιδιάζω	Verb	αιφνιδιάζω • (aifnidiázo) (simple past αιφνιδίασα, passive form αιφνιδιάζομαι)
ολοκληρώνω	Verb	ολοκληρώνω • (olokliróno) (simple past ολοκλήρωσα)
αποκρίνομαι	Verb	αποκρίνομαι • (apokrínomai) (simple past αποκρίθηκα, deponent)
παραμένω	Verb	παραμένω • (paraméno) (simple past παράμεινα or παρέμεινα, passive form —)
χρωματίζω	Verb	χρωματίζω • (chromatízo) (simple past χρωμάτισα)
συνδυάζω	Verb	συνδυάζω • (syndyázo) (simple past συνδύασα, passive form συνδυάζομαι)
συγχρονίζομαι	Verb	συγχρονίζομαι • (synchronízomai) (simple past συγχρονίστηκα, active form συγχρονίζω, passive)
αλητεύω	Verb	αλητεύω • (alitévo) (simple past αλήτεψα)
λιπαίνω	Verb	λιπαίνω • (lipaíno) (simple past λίπανα)
γαλβανίζω	Verb	γαλβανίζω • (galvanízo) (simple past γαλβάνισα, passive form γαλβανίζομαι)
ενυδατώνω	Verb	ενυδατώνω • (enydatóno) (simple past ενυδάτωσα)
πεινώ	Verb	πεινώ • (peinó) (simple past πείνασα)
παντρεύομαι	Verb	παντρεύομαι • (pantrévomai) (simple past παντρεύτηκα, active form παντρεύω, passive)
μπερδεύομαι	Verb	μπερδεύομαι • (berdévomai) (simple past μπερδεύτηκα, active form μπερδεύω, mediopassive)
διστάζω	Verb	διστάζω • (distázo) (simple past δίστασα)
ανατέλλω	Verb	ανατέλλω • (anatéllo) (simple past ανέτειλα or ανάτειλα, passive form —)
γιατρεύω	Verb	γιατρεύω • (giatrévo) (simple past γιάτρεψα)
αναφέρομαι	Verb	αναφέρομαι • (anaféromai) (simple past αναφέρθηκα, active form αναφέρω, mediopassive)
χρεώνω	Verb	χρεώνω • (chreóno) (simple past χρέωσα, passive form χρεώνομαι)
ξεμουδιάζω	Verb	ξεμουδιάζω • (xemoudiázo) (simple past ξεμούδιασα)
δραπετεύω	Verb	δραπετεύω • (drapetévo) (simple past δραπέτευσα)
απογοητεύομαι	Verb	απογοητεύομαι • (apogoitévomai) (simple past απογοητεύτηκα or απογοητεύθηκα, active form απογοητεύω, mediopassive)
αποσαθρώνομαι	Verb	αποσαθρώνομαι • (aposathrónomai) (simple past αποσαθρώθηκα, active form αποσαθρώνω, passive)
ισοσκελίζω	Verb	ισοσκελίζω • (isoskelízo) (simple past ισοσκέλισα)
αθετούμαι	Verb	αθετούμαι • (athetoúmai) (simple past αθετήθηκα, active form αθετώ, passive)
αλληλοσκοτώνομαι	Verb	αλληλοσκοτώνομαι • (alliloskotónomai) (simple past αλληλοσκοτώθηκα, deponent)
είχατε	Verb	είχατε • (eíchate)
αρμυρίζω	Verb	αρμυρίζω • (armyrízo) (simple past αρμύρισα)
αγκιστρώνομαι	Verb	αγκιστρώνομαι • (agkistrónomai) (simple past αγκιστρώθηκα, active form αγκιστρώνω, passive)
οδηγώ	Verb	οδηγώ • (odigó) (simple past οδήγησα, passive form οδηγούμαι)
μαρτυράω	Verb	μαρτυράω • (martyráo) (simple past μαρτύρησα, passive form —)
ορίζομαι	Verb	ορίζομαι • (orízomai) (simple past ορίστηκα, active form ορίζω, passive)
ακολουθώ	Verb	ακολουθώ • (akolouthó) (simple past ακολούθησα, passive form ακολουθούμαι or ακολουθιέμαι)
υπαγορεύω	Verb	υπαγορεύω • (ypagorévo) (simple past υπαγόρευσα)
γροικώ	Verb	γροικώ • (groikó) (simple past γροίκησα)
απλοποιούμαι	Verb	απλοποιούμαι • (aplopoioúmai) (simple past απλοποιήθηκα, active form απλοποιώ, passive)
λυπούμαι	Verb	λυπούμαι • (lypoúmai) (simple past λυπήθηκα, active form λυπώ, passive)
αλληλοϋποστηρίζομαι	Verb	αλληλοϋποστηρίζομαι • (alliloÿpostirízomai) (deponent)
αναβρύζω	Verb	αναβρύζω • (anavrýzo) (simple past ανέβρυσα or ανάβρυσα)
αποσιωπώμαι	Verb	αποσιωπώμαι • (aposiopómai) (simple past αποσιωπήθηκα, active form αποσιωπώ, passive)
ασκώ	Verb	ασκώ • (askó) (simple past άσκησα, passive form ασκούμαι)
ανακαλύπτομαι	Verb	ανακαλύπτομαι • (anakalýptomai) (simple past ανακαλύφθηκα or ανακαλύφτηκα, active form ανακαλύπτω, passive)
οξυγονοκολλώ	Verb	οξυγονοκολλώ • (oxygonokolló) (simple past οξυγονοκόλλησα)
ορκίζομαι	Verb	ορκίζομαι • (orkízomai) (simple past ορκίστηκα, active form ορκίζω, passive)
υποθηκεύω	Verb	υποθηκεύω • (ypothikévo) (simple past υποθήκευσα, passive form υποθηκεύομαι)
συνειδητοποιώ	Verb	συνειδητοποιώ • (syneiditopoió) (simple past συνειδητοποίησα)
δαγκώνω	Verb	δαγκώνω • (dagkóno) (simple past δάγκωσα, passive form δαγκώνομαι)
λερώνομαι	Verb	λερώνομαι • (lerónomai) (simple past λερώθηκα, active form λερώνω, passive)
αιτούσα	Verb	αιτούσα • (aitoúsa)
ζαχαρώνω	Verb	ζαχαρώνω • (zacharóno) (simple past ζαχάρωσα, passive form ζαχαρώνομαι)
αυξάνω	Verb	αυξάνω • (afxáno) (simple past αύξησα, passive form αυξάνομαι)
χρωστώ	Verb	χρωστώ • (chrostó) (imperfect χρωστούσα, found only in the imperfective tenses)
μεταφέρω	Verb	μεταφέρω • (metaféro) (simple past μετέφερα)
αλφαδιάζω	Verb	αλφαδιάζω • (alfadiázo) (simple past αλφαδίασα, passive form αλφαδιάζομαι)
φονεύω	Verb	φονεύω • (fonévo) (simple past φόνευσα)
βλάπτω	Verb	βλάπτω • (vlápto) (simple past έβλαψα, passive form βλάπτομαι)
εξολοθρεύομαι	Verb	εξολοθρεύομαι • (exolothrévomai) (simple past εξολοθρεύτηκα or εξολοθρεύθηκα, active form εξολοθρεύω, passive)
επιτρέπομαι	Verb	επιτρέπομαι • (epitrépomai) (simple past επιτράπηκα, active form επιτρέπω, passive)
εξεγείρομαι	Verb	εξεγείρομαι • (exegeíromai) (simple past εξεγέρθηκα, active form εξεγείρω, passive)
προστατεύω	Verb	προστατεύω • (prostatévo) (simple past προστάτεψα, passive form προστατεύομαι)
είσαστε	Verb	είσαστε • (eísaste)
διευρύνομαι	Verb	διευρύνομαι • (dievrýnomai) (simple past διευρύνθηκα, active form διευρύνω, passive)
αυνανίζομαι	Verb	αυνανίζομαι • (avnanízomai) (simple past αυνανίστηκα, deponent)
τιμώμαι	Verb	τιμώμαι • (timómai) (simple past τιμήθηκα, active form τιμώ, passive)
ισοδυναμώ	Verb	ισοδυναμώ • (isodynamó) (found only in the present and imperfect tenses)
πιπώνω	Verb	πιπώνω • (pipóno) (simple past πίπωσα, passive form πιπώνομαι)
αναλώ	Verb	αναλώ • (analó) (simple past ανέλυσα or ανάλυσα)
τοποθετούμαι	Verb	τοποθετούμαι • (topothetoúmai) (simple past τοποθετήθηκα, active form τοποθετώ, passive)
εκτιμώμαι	Verb	εκτιμώμαι • (ektimómai) (simple past εκτιμήθηκα, active form εκτιμώ, passive)
κηρύττω	Verb	κηρύττω • (kirýtto) (simple past κήρυξα, passive form κηρύττομαι)
αποκατασταίνω	Verb	αποκατασταίνω • (apokatastaíno) (simple past αποκατάστησα)   (present tense only according to some sources)
προκαταβάλομαι	Verb	προκαταβάλομαι • (prokataválomai) (simple past προκαταβλήθηκα, active form προκαταβάλω, passive)
αναμορφώνω	Verb	αναμορφώνω • (anamorfóno) (simple past αναμόρφωσα, passive form αναμορφώνομαι)
τραπεζώνω	Verb	τραπεζώνω • (trapezóno) (simple past τραπέζωσα)
ανορθώνω	Verb	ανορθώνω • (anorthóno) (simple past ανόρθωσα, passive form ανορθώνομαι)
βερνικώνω	Verb	βερνικώνω • (vernikóno) (simple past βερνίκωσα, passive form βερνικώνομαι)
θυμιατίζομαι	Verb	θυμιατίζομαι • (thymiatízomai) (simple past θυμιατίστηκα, active form θυμιατίζω, passive)
αξιοποιώ	Verb	αξιοποιώ • (axiopoió) (simple past αξιοποίησα)
ομολογούμαι	Verb	ομολογούμαι • (omologoúmai) (simple past ομολογήθηκα, active form ομολογώ, passive)
καπνίζω	Verb	καπνίζω • (kapnízo) (simple past κάπνισα)
δεικνύω	Verb	δεικνύω • (deiknýo) (simple past έδειξα)
αερολογώ	Verb	αερολογώ • (aerologó) (simple past αερολόγησα)
ορίζω	Verb	ορίζω • (orízo) (simple past όρισα, passive form ορίζομαι, active)
λησμονούμαι	Verb	λησμονούμαι • (lismonoúmai) (simple past λησμονήθηκα, active form λησμονώ, passive)
παγιδεύω	Verb	παγιδεύω • (pagidévo) (simple past παγίδευσα or παγίδεψα)
αταχτώ	Verb	αταχτώ • (atachtó) (simple past ατάχτησα)
νυστάζω	Verb	νυστάζω • (nystázo) (simple past νύσταξα)
δυσκολεύομαι	Verb	δυσκολεύομαι • (dyskolévomai) (simple past δυσκολεύτηκα, active form δυσκολεύω, passive)
αποχαιρετώ	Verb	αποχαιρετώ • (apochairetó) (simple past αποχαιρέτησα, passive form αποχαιρετιέμαι)
διαφεύγω	Verb	διαφεύγω • (diafévgo) (simple past διέφυγα)
τσιμπιέμαι	Verb	τσιμπιέμαι • (tsimpiémai) (simple past τσιμπήθηκα, active form τσιμπάω, passive)
απολαβαίνω	Verb	απολαβαίνω • (apolavaíno) (simple past απόλαυσα)
διαπερνιέμαι	Verb	διαπερνιέμαι • (diaperniémai) (simple past διαπεράστηκα, active form διαπερνώ, passive)
περνιέμαι	Verb	περνιέμαι • (perniémai) (simple past περάστηκα, passive form περνώ or περνάω, passive)
μάσα	Verb	μάσα • (mása)
χαλάω	Verb	χαλάω • (chaláo) (simple past χάλασα, passive form χαλάζομαι)
συσσωρεύομαι	Verb	συσσωρεύομαι • (syssorévomai) (simple past συσσωρεύτηκα or συσσωρεύθηκα, active form συσσωρεύω, passive)
απαιτώ	Verb	απαιτώ • (apaitó) (simple past απαίτησα, passive form απαιτούμαι)
αμαρταίνω	Verb	αμαρταίνω • (amartaíno) (simple past αμάρτησα, passive form —)
βαθμολογώ	Verb	βαθμολογώ • (vathmologó) (simple past βαθμολόγησα, passive form βαθμολογούμαι)
μισούμαι	Verb	μισούμαι • (misoúmai) (simple past μισήθηκα, active form μισώ, passive)
στραβώνω	Verb	στραβώνω • (stravóno) (simple past στράβωσα, passive form στραβώνομαι)
ανακαλούμαι	Verb	ανακαλούμαι • (anakaloúmai) (simple past ανακλήθηκα, active form ανακαλώ, passive)
συγχωνεύω	Verb	συγχωνεύω • (synchonévo) (simple past συγχώνευσα)
καταβάλλω	Verb	καταβάλλω • (katavállo) (simple past κατέβαλα, passive form καταβάλλομαι)
αγρυπνώ	Verb	αγρυπνώ • (agrypnó) (simple past αγρύπνησα, passive form —)
στρίβω	Verb	στρίβω • (strívo) (simple past έστριψα, passive form στρίβομαι)
σιδερώνω	Verb	σιδερώνω • (sideróno) (simple past σιδέρωσα)
χαλκοκολλώ	Verb	χαλκοκολλώ • (chalkokolló) (simple past χαλκοκόλλησα)
κουνάω	Verb	κουνάω • (kounáo) (simple past κούνησα)
ανασταίνω	Verb	ανασταίνω • (anastaíno) (simple past ανάστησα, passive form ανασταίνομαι)
αγαλλιώ	Verb	αγαλλιώ • (agallió) (simple past αγαλλίασα, passive form αγάλλομαι)
ικανοποιούμαι	Verb	ικανοποιούμαι • (ikanopoioúmai) (simple past ικανοποιήθηκα, active form ικανοποιώ, passive)
εισάγομαι	Verb	εισάγομαι • (eiságomai) (simple past —, active form εισάγω, passive)
θα είμαι	Verb	θα είμαι • (tha eímai)
λαμπρύνομαι	Verb	λαμπρύνομαι • (lamprýnomai) (simple past λαμπρύθηκα, active form λαμπρύνω, passive)
γαβγίζω	Verb	γαβγίζω • (gavgízo) (simple past γάβγισα)
ματοκυλιέμαι	Verb	ματοκυλιέμαι • (matokyliémai) (simple past ματοκυλίστηκα, active form ματοκυλώ, passive)
συνοδεύω	Verb	συνοδεύω • (synodévo) (simple past συνόδεψα, passive form συνοδεύομαι)
χειρονομώ	Verb	χειρονομώ • (cheironomó) (found only in the present and imperfect tenses)
υπερφορτώνομαι	Verb	υπερφορτώνομαι • (yperfortónomai) (simple past υπερφορτώθηκα, active form υπερφορτώνω, passive)
τερματίζω	Verb	τερματίζω • (termatízo) (simple past τερμάτισα, passive form τερματίζομαι)
βαλσαμώνω	Verb	βαλσαμώνω • (valsamóno) (simple past βαλσάμωσα, passive form βαλσαμώνομαι)
αμπαρώνω	Verb	αμπαρώνω • (amparóno) (simple past αμπάρωσα, passive form αμπαρώνομαι)
καταστρέφω	Verb	καταστρέφω • (katastréfo) (simple past κατέστρεψα or κατάστρεψα, passive form καταστρέφομαι)
τιμωρώ	Verb	τιμωρώ • (timoró) (simple past τιμώρησα, passive form τιμωρούμαι)
ελέγχομαι	Verb	ελέγχομαι • (elénchomai) (simple past ελέγχθηκα or ελέγχτηκα, active form ελέγχω, passive)
καλύπτομαι	Verb	καλύπτομαι • (kalýptomai) (simple past καλύφθηκα, active form καλύπτω, passive)
εξημερώνω	Verb	εξημερώνω • (eximeróno) (simple past εξημέρωσα, passive form εξημερώνομαι, active)
αιτούμαι	Verb	αιτούμαι • (aitoúmai) (simple past αιτήθηκα, active form αιτώ, mediopassive)
προσφέρομαι	Verb	προσφέρομαι • (prosféromai) (simple past προσφέρθηκα, active form προσφέρω, mediopassive)
καίω	Verb	καίω • (kaío) (simple past έκαψα, passive form καίγομαι)
ουσιαστικοποιούμαι	Verb	ουσιαστικοποιούμαι • (ousiastikopoioúmai) (simple past ουσιαστικοποιήθηκα, active form ουσιαστικοποιώ, passive)
φέρνω	Verb	φέρνω • (férno) (simple past έφερα, passive form φέρνομαι)
αλληλοβοηθιέμαι	Verb	αλληλοβοηθιέμαι • (allilovoithiémai) (simple past αλληλοβοηθήθηκα, deponent)
κινηματογραφώ	Verb	κινηματογραφώ • (kinimatografó) (simple past κινηματογράφησα)
καβουρντίζομαι	Verb	καβουρντίζομαι • (kavourntízomai) (simple past καβουρντίστηκα, active form καβουρντίζω, passive)
αγαθεύω	Verb	αγαθεύω • (agathévo) (simple past αγάθεψα)
ιδιωτικοποιώ	Verb	ιδιωτικοποιώ • (idiotikopoió) (simple past ιδιωτικοποίησα)
πλακώνω	Verb	πλακώνω • (plakóno) (simple past πλάκωσα, passive form πλακώνομαι)
αποτελούμαι	Verb	αποτελούμαι • (apoteloúmai) (simple past —, active form αποτελώ, passive)
ανατινάζω	Verb	ανατινάζω • (anatinázo) (simple past ανατίναξα, passive form ανατινάζομαι)
χρωστάω	Verb	χρωστάω • (chrostáo) (imperfect χρωστούσα, found only in the imperfective tenses)
αλαφρώνω	Verb	αλαφρώνω • (alafróno) (simple past αλάφρωσα)
σκύβω	Verb	σκύβω • (skývo) (simple past έσκυψα, passive form —)
δένω	Verb	δένω • (déno) (simple past έδεσα, passive form δένομαι)
παίρνω	Verb	παίρνω • (paírno) (simple past πήρα, passive form παίρνομαι)
βασιλεύω	Verb	βασιλεύω • (vasilévo) (simple past βασίλεψα)
ψευδίζω	Verb	ψευδίζω • (psevdízo) (simple past ψεύδισα)
φυσώ	Verb	φυσώ • (fysó) (simple past φύσηξα)
γιουχαΐζω	Verb	γιουχαΐζω • (giouchaḯzo) (simple past γιουχάισα, passive form γιουχαΐζομαι)
απομένω	Verb	απομένω • (apoméno) (simple past απέμεινα or απόμεινα)
σαπίζω	Verb	σαπίζω • (sapízo) (simple past σάπισα)
αντισταθμίζω	Verb	αντισταθμίζω • (antistathmízo) (simple past αντιστάθμισα, passive form αντισταθμίζομαι)
ανακοινώνομαι	Verb	ανακοινώνομαι • (anakoinónomai) (simple past ανακοινώθηκα, active form ανακοινώνω, passive)
αλληλοκατηγορούμαι	Verb	αλληλοκατηγορούμαι • (allilokatigoroúmai) (simple past αλληλοκατηγορήθηκα, deponent)
καταδίνομαι	Verb	καταδίνομαι • (katadínomai) (simple past καταδόθηκα, active form καταδίνω, passive)
πρωτοστατώ	Verb	πρωτοστατώ • (protostató) (simple past πρωτοστάτησα)
ανθίζω	Verb	ανθίζω • (anthízo) (simple past άνθισα)
αγριοκοιτάζω	Verb	αγριοκοιτάζω • (agriokoitázo) (simple past αγριοκοίταξα, passive form αγριοκοιτάζομαι)
αισθάνομαι	Verb	αισθάνομαι • (aisthánomai) (simple past αισθάνθηκα, deponent)
ξενερώνω	Verb	ξενερώνω • (xeneróno) (simple past ξενέρωσα)
συμπεριλαμβάνω	Verb	συμπεριλαμβάνω • (symperilamváno) (simple past συμπεριέλαβα)
παραδίνω	Verb	παραδίνω • (paradíno) (simple past παρέδωσα, passive form παραδίνομαι)
φυλάγομαι	Verb	φυλάγομαι • (fylágomai) (simple past φυλάχτηκα, active form φυλάσσω, passive)
επιβιβάζομαι	Verb	επιβιβάζομαι • (epivivázomai) (simple past επιβιβάστηκα, active form επιβιβάζω, mediopassive)
αναθρέφομαι	Verb	αναθρέφομαι • (anathréfomai) (simple past αναθράφηκα, active form αναθρέφω, passive)
θεραπεύομαι	Verb	θεραπεύομαι • (therapévomai) (simple past θεραπεύτηκα or θεραπεύθηκα, active form θεραπεύω, passive)
κυκλοφορώ	Verb	κυκλοφορώ • (kykloforó) (simple past κυκλοφόρησα, passive form κυκλοφορούμαι)
ρωτάω	Verb	ρωτάω • (rotáo) (simple past ρώτησα, passive form ρωτιέμαι)
αναλαβαίνω	Verb	αναλαβαίνω • (analavaíno) (simple past ανέλαβα or ανάλαβα)
πετάγομαι	Verb	πετάγομαι • (petágomai) (simple past πετάχτηκα, active form πετάω, passive)
κρίνομαι	Verb	κρίνομαι • (krínomai) (simple past κρίθηκα, active form κρίνω, passive)
αντιδράω	Verb	αντιδράω • (antidráo) (simple past αντέδρασα, passive form —)
ληστεύω	Verb	ληστεύω • (listévo) (simple past λήστεψα, passive form ληστεύομαι)
εξαρτώμαι	Verb	εξαρτώμαι • (exartómai) (simple past εξαρτήθηκα, active form εξαρτώ, passive)
απέχω	Verb	απέχω • (apécho) (simple past απείχα, passive form —)
απογειώνομαι	Verb	απογειώνομαι • (apogeiónomai) (simple past απογειώθηκα, active form απογειώνω, passive)
αβγαταίνω	Verb	αβγαταίνω • (avgataíno) (simple past αβγάτυνα)
απαγορεύω	Verb	απαγορεύω • (apagorévo) (simple past απαγόρευσα or απαγόρεψα, passive form απαγορεύομαι)
αυτομολώ	Verb	αυτομολώ • (aftomoló) (simple past αυτομόλησα)
συνηθίζω	Verb	συνηθίζω • (synithízo) (simple past συνήθισα)
ματαιώνω	Verb	ματαιώνω • (mataióno) (simple past ματαίωσα, passive form ματαιώνομαι)
αντιστρέφω	Verb	αντιστρέφω • (antistréfo) (simple past αντέστρεψα, passive form αντιστρέφομαι)
αηδιάζω	Verb	αηδιάζω • (aidiázo) (simple past αηδίασα, passive form αηδιάζομαι)
αξιώνω	Verb	αξιώνω • (axióno) (simple past αξίωσα)
νικιέμαι	Verb	νικιέμαι • (nikiémai) (simple past νικήθηκα, active form νικώ, passive)
περνάω	Verb	περνάω • (pernáo) (simple past πέρασα)
θα έχει	Verb	θα έχει • (tha échei)
διαψεύδομαι	Verb	διαψεύδομαι • (diapsévdomai) (simple past διαψεύστηκα, active form διαψεύδω, passive)
εκσπερματώνω	Verb	εκσπερματώνω • (ekspermatóno) (simple past εκσπερμάτωσα)
δακτυλογραφούμαι	Verb	δακτυλογραφούμαι • (daktylografoúmai) (simple past δακτυλογραφήθηκα, active form δακτυλογραφώ, passive)
αποσταίνω	Verb	αποσταίνω • (apostaíno) (simple past απόστασα, passive form —)
γαμοσταυρίζω	Verb	γαμοσταυρίζω • (gamostavrízo) (simple past γαμοσταύρισα)
παραλαμβάνομαι	Verb	παραλαμβάνομαι • (paralamvánomai) (simple past παραλήφθηκα, active form παραλαμβάνω, passive)
ζυγίζομαι	Verb	ζυγίζομαι • (zygízomai) (simple past ζυγίστηκα, active form ζυγίζω, passive)
κοιτιέμαι	Verb	κοιτιέμαι • (koitiémai) (simple past κοιτάχτηκα, active form κοιτάζω, passive)
