cors	Adjective	cors (feminine corsa, masculine plural corsos, feminine plural corses)
militar	Adjective	militar (masculine and feminine plural militars)
oromo	Adjective	oromo (masculine and feminine plural oromos)
paranormal	Adjective	paranormal (masculine and feminine plural paranormals)
ferma	Adjective	ferma
cerebral	Adjective	cerebral (masculine and feminine plural cerebrals)
fals	Adjective	fals (feminine falsa, masculine plural falsos, feminine plural falses)
mera	Adjective	mera
ful	Adjective	ful (invariable)
antic	Adjective	antic (feminine antiga, masculine plural antics, feminine plural antigues)
pilot	Adjective	pilot (feminine pilota, masculine plural pilots, feminine plural pilotes)
general	Adjective	general (masculine and feminine plural generals)
tercer	Adjective	tercer (feminine tercera, masculine plural tercers, feminine plural terceres)
plena	Adjective	plena f sg
paus	Adjective	paus
suprem	Adjective	suprem (feminine suprema, masculine plural suprems, feminine plural supremes)
greu	Adjective	greu (feminine greva, masculine plural greus, feminine plural greves)
capitular	Adjective	capitular (feminine capitulara, masculine plural capitulars, feminine plural capitulares)
fatal	Adjective	fatal (masculine and feminine plural fatals)
regional	Adjective	regional (masculine and feminine plural regionals)
homosexual	Adjective	homosexual (masculine and feminine plural homosexuals)
kurds	Adjective	kurds
desolat	Adjective	desolat (feminine desolada, masculine plural desolats, feminine plural desolades)
primer	Adjective	primer (feminine primera, masculine plural primers, feminine plural primeres)
nebulosa	Adjective	nebulosa
dens	Adjective	dens (feminine densa, masculine plural densos, feminine plural denses)
moderat	Adjective	moderat (feminine moderada, masculine plural moderats, feminine plural moderades)
global	Adjective	global (masculine and feminine plural globals)
mala	Adjective	mala f sg
amfibi	Adjective	amfibi (feminine amfíbia, masculine plural amfibis, feminine plural amfíbies)
nocturn	Adjective	nocturn (feminine nocturna, masculine plural nocturns, feminine plural nocturnes)
feudal	Adjective	feudal (masculine and feminine plural feudals)
triangular	Adjective	triangular (masculine and feminine plural triangulars)
gradual	Adjective	gradual (masculine and feminine plural graduals)
tendre	Adjective	tendre (feminine tendra, masculine and feminine plural tendres)
fart	Adjective	fart (feminine farta, masculine plural farts, feminine plural fartes)
coclear	Adjective	coclear (masculine and feminine plural coclears)
portugués	Adjective	portugués (feminine portuguesa, masculine plural portuguesos, feminine plural portugueses)
labial	Adjective	labial (masculine and feminine plural labials)
oral	Adjective	oral (masculine and feminine plural orals)
gras	Adjective	gras (feminine grassa, masculine plural grassos, feminine plural grasses)
recent	Adjective	recent (masculine and feminine plural recents)
rar	Adjective	rar (feminine rara, masculine plural rars, feminine plural rares)
febril	Adjective	febril (masculine and feminine plural febrils)
nou	Adjective	nou (feminine nova, masculine plural nous, feminine plural noves)
gals	Adjective	gals
imperial	Adjective	imperial (masculine and feminine plural imperials)
crus	Adjective	crus
frontal	Adjective	frontal (masculine and feminine plural frontals)
las	Adjective	las (feminine lassa, masculine plural lassos, feminine plural lasses)
fix	Adjective	fix (feminine fixa, masculine plural fixos, feminine plural fixes)
homozigot	Adjective	homozigot (feminine homozigota, masculine plural homozigots, feminine plural homozigotes)
oblic	Adjective	oblic (feminine obliqua, masculine plural oblics, feminine plural obliqües)
cara	Adjective	cara
bengali	Adjective	bengali (masculine and feminine plural bengalis)
balear	Adjective	balear (feminine baleara, masculine plural balears, feminine plural baleares)
sa	Adjective	sa (feminine sana, masculine plural sans, feminine plural sanes)
intern	Adjective	intern (feminine interna, masculine plural interns, feminine plural internes)
altruista	Adjective	altruista (masculine and feminine plural altruistes)
part	Adjective	part (feminine parta, masculine plural parts, feminine plural partes)
rector	Adjective	rector (feminine rectora, masculine plural rectors, feminine plural rectores)
bon	Adjective	bon
motor	Adjective	motor (feminine motora, masculine plural motors, feminine plural motores)
immigrant	Adjective	immigrant (masculine and feminine plural immigrants)
enter	Adjective	enter (feminine entera, masculine plural enters, feminine plural enteres)
aventurer	Adjective	aventurer (feminine aventurera, masculine plural aventurers, feminine plural aventureres)
plantar	Adjective	plantar (masculine and feminine plural plantars)
dolent	Adjective	dolent (feminine dolenta, masculine plural dolents, feminine plural dolentes)
sensorial	Adjective	sensorial (masculine and feminine plural sensorials)
dental	Adjective	dental (masculine and feminine plural dentals)
autista	Adjective	autista (masculine and feminine plural autistes)
abandonat	Adjective	abandonat (feminine abandonada, masculine plural abandonats, feminine plural abandonades)
neutral	Adjective	neutral (masculine and feminine plural neutrals)
fort	Adjective	fort (feminine forta, masculine plural forts, feminine plural fortes)
ideal	Adjective	ideal (masculine and feminine plural ideals)
missionera	Adjective	missionera
pastoral	Adjective	pastoral (masculine and feminine plural pastorals)
mineral	Adjective	mineral (masculine and feminine plural minerals)
onomatopeic	Adjective	onomatopeic (feminine onomatopeica, masculine plural onomatopeics, feminine plural onomatopeiques)
danés	Adjective	danés (feminine danesa, masculine plural danesos, feminine plural daneses)
finit	Adjective	finit (feminine finita, masculine plural finits, feminine plural finites)
piramidal	Adjective	piramidal (masculine and feminine plural piramidals)
mals	Adjective	mals
nua	Adjective	nua f sg
social	Adjective	social (masculine and feminine plural socials)
mans	Adjective	mans (feminine mansa, masculine plural mansos, feminine plural manses)
magre	Adjective	magre (feminine magra, masculine and feminine plural magres)
bo	Adjective	bo (feminine bona, masculine plural bons, feminine plural bones)
instructor	Adjective	instructor (feminine instructora, masculine plural instructors, feminine plural instructores)
boja	Adjective	boja
finlandés	Adjective	finlandés (feminine finlandesa, masculine plural finlandesos, feminine plural finlandeses)
elegant	Adjective	elegant (masculine and feminine plural elegants)
regent	Adjective	regent (feminine regenta, masculine plural regents, feminine plural regentes)
nahua	Adjective	nahua (masculine and feminine plural nahues)
manual	Adjective	manual (masculine and feminine plural manuals)
vertebral	Adjective	vertebral (masculine and feminine plural vertebrals)
favorit	Adjective	favorit (feminine favorita, masculine plural favorits, feminine plural favorites)
invers	Adjective	invers (feminine inversa, masculine plural inversos, feminine plural inverses)
albanés	Adjective	albanés (feminine albanesa, masculine plural albanesos, feminine plural albaneses)
present	Adjective	present (masculine and feminine plural presents)
grec	Adjective	grec (feminine grega, masculine plural grecs, feminine plural gregues)
ferm	Adjective	ferm (feminine ferma, masculine plural ferms, feminine plural fermes)
complex	Adjective	complex (feminine complexa, masculine plural complexos, feminine plural complexes)
cars	Adjective	cars
delirant	Adjective	delirant (masculine and feminine plural delirants)
resistent	Adjective	resistent (masculine and feminine plural resistents)
fluvial	Adjective	fluvial (masculine and feminine plural fluvials)
politeista	Adjective	politeista (masculine and feminine plural politeistes)
mutus	Adjective	mutus
indi	Adjective	indi (feminine índia, masculine plural indis, feminine plural índies)
avara	Adjective	avara
mongol	Adjective	mongol (feminine mongola, masculine plural mongols, feminine plural mongoles)
moral	Adjective	moral (masculine and feminine plural morals)
discret	Adjective	discret (feminine discreta, masculine plural discrets, feminine plural discretes)
molla	Adjective	molla
unit	Adjective	unit (feminine unida, masculine plural units, feminine plural unides)
verda	Adjective	verda
belga	Adjective	belga (masculine and feminine plural belgues)
tot	Adjective	tot (feminine tota, masculine plural tots, feminine plural totes)
alternativa	Adjective	alternativa f sg
nazis	Adjective	nazis
mal	Adjective	mal (feminine mala, masculine plural mals, feminine plural males)
avar	Adjective	avar (masculine and feminine plural avars)
protector	Adjective	protector (feminine protectora, masculine plural protectors, feminine plural protectores)
car	Adjective	car (feminine cara, masculine plural cars, feminine plural cares)
profund	Adjective	profund (feminine profunda, masculine plural profunds, feminine plural profundes)
passat	Adjective	passat (feminine passada, masculine plural passats, feminine plural passades)
omniscient	Adjective	omniscient (masculine and feminine plural omniscients)
jiddisch	Adjective	jiddisch (invariable)
prominent	Adjective	prominent (masculine and feminine plural prominents)
rica	Adjective	rica
abacial	Adjective	abacial (masculine and feminine plural abacials)
prim	Adjective	prim (feminine prima, masculine plural prims, feminine plural primes)
verdes	Adjective	verdes f pl
rural	Adjective	rural (masculine and feminine plural rurals)
analfabet	Adjective	analfabet (feminine analfabeta, masculine plural analfabets, feminine plural analfabetes)
titular	Adjective	titular (masculine and feminine plural titulars)
mental	Adjective	mental (masculine and feminine plural mentals)
forta	Adjective	forta f
animal	Adjective	animal (masculine and feminine plural animals)
dorsal	Adjective	dorsal (masculine and feminine plural dorsals)
inert	Adjective	inert (feminine inerta, masculine plural inerts, feminine plural inertes)
diagonal	Adjective	diagonal (masculine and feminine plural diagonals)
fer	Adjective	fer (feminine fera, masculine plural fers, feminine plural feres)
lunar	Adjective	lunar (masculine and feminine plural lunars)
obsolet	Adjective	obsolet (feminine obsoleta, masculine plural obsolets, feminine plural obsoletes)
principal	Adjective	principal (masculine and feminine plural principals)
futur	Adjective	futur (feminine futura, masculine plural futurs, feminine plural futures)
mortal	Adjective	mortal (masculine and feminine plural mortals)
complet	Adjective	complet (feminine completa, masculine plural complets, feminine plural completes)
zulu	Adjective	zulu (masculine and feminine plural zulus)
major	Adjective	major (masculine and feminine plural majors)
abundant	Adjective	abundant (masculine and feminine plural abundants)
tes	Adjective	tes (feminine tesa, masculine plural tesos, feminine plural teses)
adormit	Adjective	adormit (feminine adormida, masculine plural adormits, feminine plural adormides)
violent	Adjective	violent (feminine violenta, masculine plural violents, feminine plural violentes)
testicular	Adjective	testicular (feminine testiculara, masculine plural testiculars, feminine plural testiculares)
francés	Adjective	francés (feminine francesa, masculine plural francesos, feminine plural franceses)
torta	Adjective	torta
seca	Adjective	seca
rost	Adjective	rost (feminine rosta, masculine plural rosts or rostos, feminine plural rostes)
filial	Adjective	filial (masculine and feminine plural filials)
papal	Adjective	papal (masculine and feminine plural papals)
suahili	Adjective	suahili (masculine and feminine plural suahilis)
intestinal	Adjective	intestinal (masculine and feminine plural intestinals)
central	Adjective	central (masculine and feminine plural centrals)
impulsor	Adjective	impulsor (feminine impulsora, masculine plural impulsors, feminine plural impulsores)
paradoxal	Adjective	paradoxal (masculine and feminine plural paradoxals)
vehement	Adjective	vehement (masculine and feminine plural vehements)
experimentat	Adjective	experimentat (feminine experimentada, masculine plural experimentats, feminine plural experimentades)
monumental	Adjective	monumental (masculine and feminine plural monumentals)
fi	Adjective	fi (feminine fina, masculine plural fins, feminine plural fines)
turc	Adjective	turc (feminine turca, masculine plural turcs, feminine plural turques)
variants	Adjective	variants
aimara	Adjective	aimara (masculine and feminine plural aimares)
hexagonal	Adjective	hexagonal (masculine and feminine plural hexagonals)
fes	Adjective	fes
escalar	Adjective	escalar (feminine escalara, masculine plural escalars, feminine plural escalares)
rosa	Adjective	rosa (masculine and feminine plural roses)
local	Adjective	local (masculine and feminine plural locals)
anormal	Adjective	anormal (masculine and feminine plural anormals)
pur	Adjective	pur (feminine pura, masculine plural purs, feminine plural pures)
lila	Adjective	lila (masculine and feminine plural liles)
brutal	Adjective	brutal (masculine and feminine plural brutals)
legal	Adjective	legal (masculine and feminine plural legals)
proper	Adjective	proper (feminine propera, masculine plural propers, feminine plural properes)
swahili	Adjective	swahili (masculine and feminine plural swahilis)
armat	Adjective	armat (feminine armada, masculine plural armats, feminine plural armades)
consistent	Adjective	consistent (masculine and feminine plural consistents)
extern	Adjective	extern (feminine externa, masculine plural externs, feminine plural externes)
granat	Adjective	granat (feminine granada, masculine plural granats, feminine plural granades)
integral	Adjective	integral (masculine and feminine plural integrals)
dominant	Adjective	dominant (masculine and feminine plural dominants)
immens	Adjective	immens (feminine immensa, masculine plural immensos, feminine plural immenses)
serbi	Adjective	serbi (feminine sèrbia, masculine plural serbis, feminine plural sèrbies)
rosta	Adjective	rosta
potable	Adjective	potable (masculine and feminine plural potables)
musical	Adjective	musical (masculine and feminine plural musicals)
blanca	Adjective	blanca
omnipotent	Adjective	omnipotent (masculine and feminine plural omnipotents)
transparent	Adjective	transparent (masculine and feminine plural transparents)
ros	Adjective	ros (feminine rossa, masculine plural rossos, feminine plural rosses)
gris	Adjective	gris (feminine grisa, masculine plural grisos, feminine plural grises)
nat	Adjective	nat (feminine nada, masculine plural nats, feminine plural nades)
sols	Adjective	sols
gujarati	Adjective	gujarati (masculine and feminine plural gujaratis)
fluid	Adjective	fluid (feminine fluida, masculine plural fluids, feminine plural fluides)
pop	Adjective	pop (invariable)
instrumental	Adjective	instrumental (masculine and feminine plural instrumentals)
celta	Adjective	celta (masculine and feminine plural celtes)
delicat	Adjective	delicat (feminine delicada, masculine plural delicats, feminine plural delicades)
normal	Adjective	normal (masculine and feminine plural normals)
súper	Adjective	súper
fidel	Adjective	fidel (masculine and feminine plural fidels)
important	Adjective	important (masculine and feminine plural importants)
orb	Adjective	orb (feminine orba, masculine plural orbs, feminine plural orbes)
marginal	Adjective	marginal (masculine and feminine plural marginals)
tardans	Adjective	tardans
blanc	Adjective	blanc (feminine blanca, masculine plural blancs, feminine plural blanques)
pali	Adjective	pali (masculine and feminine plural palis)
desena	Adjective	desena
irlandés	Adjective	irlandés (feminine irlandesa, masculine plural irlandesos, feminine plural irlandeses)
molt	Adjective	molt (feminine molta, masculine plural molts, feminine plural moltes)
circular	Adjective	circular (masculine and feminine plural circulars)
vidus	Adjective	vidus
fit	Adjective	fit (feminine fita, masculine plural fits, feminine plural fites)
moderna	Adjective	moderna
adherent	Adjective	adherent (masculine and feminine plural adherents)
vana	Adjective	vana
singular	Adjective	singular (masculine and feminine plural singulars)
agra	Adjective	agra
sola	Adjective	sola f sg
bona	Adjective	bona f
lector	Adjective	lector (feminine lectora, masculine plural lectors, feminine plural lectores)
nominal	Adjective	nominal (masculine and feminine plural nominals)
perfecta	Adjective	perfecta
tip	Adjective	tip (feminine tipa, masculine plural tips, feminine plural tipes)
khmer	Adjective	khmer (masculine and feminine plural khmers)
episcopal	Adjective	episcopal (masculine and feminine plural episcopals)
polar	Adjective	polar (masculine and feminine plural polars)
literal	Adjective	literal (masculine and feminine plural literals)
maca	Adjective	maca
absolut	Adjective	absolut (feminine absoluta, masculine plural absoluts, feminine plural absolutes)
floral	Adjective	floral (masculine and feminine plural florals)
ampla	Adjective	ampla
sexual	Adjective	sexual (masculine and feminine plural sexuals)
posterior	Adjective	posterior (masculine and feminine plural posteriors)
adverbial	Adjective	adverbial (masculine and feminine plural adverbials)
mig	Adjective	mig (feminine mitja, masculine plural migs or mitjos, feminine plural mitges)
accidental	Adjective	accidental (masculine and feminine plural accidentals)
optimista	Adjective	optimista (masculine and feminine plural optimistes)
funcional	Adjective	funcional (masculine and feminine plural funcionals)
feroés	Adjective	feroés (feminine feroesa, masculine plural feroesos, feminine plural feroeses)
nuclear	Adjective	nuclear (masculine and feminine plural nuclears)
alta	Adjective	alta f sg
rude	Adjective	rude (masculine and feminine plural rudes)
referent	Adjective	referent (feminine referenta, masculine plural referents, feminine plural referentes)
beat	Adjective	beat (feminine beata, masculine plural beats, feminine plural beates)
secret	Adjective	secret (feminine secreta, masculine plural secrets, feminine plural secretes)
asexual	Adjective	asexual (masculine and feminine plural asexuals)
federal	Adjective	federal (masculine and feminine plural federals)
marina	Adjective	marina
digital	Adjective	digital (masculine and feminine plural digitals)
subtil	Adjective	subtil (masculine and feminine plural subtils)
pacient	Adjective	pacient (masculine and feminine plural pacients)
monegasc	Adjective	monegasc (feminine monegasca, masculine plural monegascs or monegascos, feminine plural monegasques)
komi	Adjective	komi (masculine and feminine plural komis)
nova	Adjective	nova
vital	Adjective	vital (masculine and feminine plural vitals)
original	Adjective	original (masculine and feminine plural originals)
extrem	Adjective	extrem (feminine extrema, masculine plural extrems, feminine plural extremes)
monoteista	Adjective	monoteista (masculine and feminine plural monoteistes)
atent	Adjective	atent (feminine atenta, masculine plural atents, feminine plural atentes)
mer	Adjective	mer (feminine mera, masculine plural mers, feminine plural meres)
privat	Adjective	privat (feminine privada, masculine plural privats, feminine plural privades)
ortodox	Adjective	ortodox (feminine ortodoxa, masculine plural ortodoxos, feminine plural ortodoxes)
cast	Adjective	cast (feminine casta, masculine plural casts or castos, feminine plural castes)
senil	Adjective	senil (masculine and feminine plural senils)
redundant	Adjective	redundant (masculine and feminine plural redundants)
plural	Adjective	plural (masculine and feminine plural plurals)
mariner	Adjective	mariner (feminine marinera, masculine plural mariners, feminine plural marineres)
completa	Adjective	completa
obedient	Adjective	obedient (masculine and feminine plural obedients)
sentimental	Adjective	sentimental (masculine and feminine plural sentimentals)
terrorista	Adjective	terrorista (masculine and feminine plural terroristes)
alt	Adjective	alt (feminine alta, masculine plural alts, feminine plural altes)
massa	Adjective	massa (masculine plural massos, feminine plural masses)
continental	Adjective	continental (masculine and feminine plural continentals)
ari	Adjective	ari (feminine ària, masculine plural aris, feminine plural àries)
universal	Adjective	universal (masculine and feminine plural universals)
especial	Adjective	especial (masculine and feminine plural especials)
cubans	Adjective	cubans
vehicular	Adjective	vehicular (masculine and feminine plural vehiculars)
tort	Adjective	tort (feminine torta, masculine plural torts, feminine plural tortes)
cert	Adjective	cert (feminine certa, masculine plural certs, feminine plural certes)
manifest	Adjective	manifest (feminine manifesta, masculine plural manifests or manifestos, feminine plural manifestes)
realista	Adjective	realista (masculine and feminine plural realistes)
anual	Adjective	anual (masculine and feminine plural anuals)
salat	Adjective	salat (feminine salada, masculine plural salats, feminine plural salades)
adult	Adjective	adult (feminine adulta, masculine plural adults, feminine plural adultes)
vulgar	Adjective	vulgar (masculine and feminine plural vulgars)
conductor	Adjective	conductor (feminine conductora, masculine plural conductors, feminine plural conductores)
intens	Adjective	intens (feminine intensa, masculine plural intensos, feminine plural intenses)
plens	Adjective	plens
coix	Adjective	coix (feminine coixa, masculine plural coixos, feminine plural coixes)
abdominal	Adjective	abdominal (masculine and feminine plural abdominals)
incomplet	Adjective	incomplet (feminine incompleta, masculine plural incomplets, feminine plural incompletes)
auxiliar	Adjective	auxiliar (masculine and feminine plural auxiliars)
obscur	Adjective	obscur (feminine obscura, masculine plural obscurs, feminine plural obscures)
popular	Adjective	popular (masculine and feminine plural populars)
pansexual	Adjective	pansexual (masculine and feminine plural pansexuals)
egoista	Adjective	egoista (masculine and feminine plural egoistes)
nimi	Adjective	nimi (feminine nímia, masculine plural nimis, feminine plural nímies)
orbital	Adjective	orbital (masculine and feminine plural orbitals)
potent	Adjective	potent (feminine potenta, masculine plural potents, feminine plural potentes)
net	Adjective	net (feminine neta, masculine plural nets, feminine plural netes)
just	Adjective	just (feminine justa, masculine plural justs or justos, feminine plural justes)
tridimensional	Adjective	tridimensional (masculine and feminine plural tridimensionals)
plana	Adjective	plana
real	Adjective	real (masculine and feminine plural reals)
petit	Adjective	petit (feminine petita, masculine plural petits, feminine plural petites)
ambigu	Adjective	ambigu (feminine ambigua, masculine plural ambigus, feminine plural ambigües)
separat	Adjective	separat (feminine separada, masculine plural separats, feminine plural separades)
brillant	Adjective	brillant (masculine and feminine plural brillants)
potencial	Adjective	potencial (masculine and feminine plural potencials)
variant	Adjective	variant (masculine and feminine plural variants)
administrativa	Adjective	administrativa
material	Adjective	material (masculine and feminine plural materials)
purs	Adjective	purs
final	Adjective	final (masculine and feminine plural finals)
rus	Adjective	rus (feminine russa, masculine plural russos, feminine plural russes)
pura	Adjective	pura
formal	Adjective	formal (masculine and feminine plural formals)
portal	Adjective	portal (masculine and feminine plural portals)
viril	Adjective	viril (masculine and feminine plural virils)
infantil	Adjective	infantil (masculine and feminine plural infantils)
moderns	Adjective	moderns
interessant	Adjective	interessant (masculine and feminine plural interessants)
armada	Adjective	armada
permanent	Adjective	permanent (masculine and feminine plural permanents)
liberal	Adjective	liberal (masculine and feminine plural liberals)
heterosexual	Adjective	heterosexual (masculine and feminine plural heterosexuals)
islandés	Adjective	islandés (feminine islandesa, masculine plural islandesos, feminine plural islandeses)
rival	Adjective	rival (masculine and feminine plural rivals)
regular	Adjective	regular (masculine and feminine plural regulars)
dependent	Adjective	dependent (masculine and feminine plural dependents)
superior	Adjective	superior (masculine and feminine plural superiors)
somali	Adjective	somali (masculine and feminine plural somalis)
inferior	Adjective	inferior (masculine and feminine plural inferiors)
modern	Adjective	modern (feminine moderna, masculine plural moderns, feminine plural modernes)
terminal	Adjective	terminal (masculine and feminine plural terminals)
savi	Adjective	savi (feminine sàvia, masculine plural savis, feminine plural sàvies)
tants	Adjective	tants
franc	Adjective	franc (feminine franca, masculine plural francs, feminine plural franques)
certa	Adjective	certa
sec	Adjective	sec (feminine seca, masculine plural secs, feminine plural seques)
adorer	Adjective	adorer (feminine adorera, masculine plural adorers, feminine plural adoreres)
irracional	Adjective	irracional (masculine and feminine plural irracionals)
baptista	Adjective	baptista (masculine and feminine plural baptistes)
total	Adjective	total (masculine and feminine plural totals)
tal	Adjective	tal (masculine and feminine plural tals)
comerciant	Adjective	comerciant (feminine comercianta, masculine plural comerciants, feminine plural comerciantes)
clar	Adjective	clar (feminine clara, masculine plural clars, feminine plural clares)
parta	Adjective	parta
mort	Adjective	mort (feminine morta, masculine plural morts, feminine plural mortes)
merder	Adjective	merder f (plural merders)
basc	Adjective	basc (feminine basca, masculine plural bascs or bascos, feminine plural basques)
trist	Adjective	trist (feminine trista, masculine plural trists or tristos, feminine plural tristes)
franca	Adjective	franca f sg
amens	Adjective	amens
ossi	Adjective	ossi (feminine òssia, masculine plural ossis, feminine plural òssies)
sonor	Adjective	sonor (feminine sonora, masculine plural sonors, feminine plural sonores)
blau	Adjective	blau (feminine blava, masculine plural blaus, feminine plural blaves)
dur	Adjective	dur (feminine dura, masculine plural durs, feminine plural dures)
santa	Adjective	santa
mut	Adjective	mut (feminine muda, masculine plural muts, feminine plural mudes)
excitat	Adjective	excitat (feminine excitada, masculine plural excitats, feminine plural excitades)
vella	Adjective	vella
moll	Adjective	moll (feminine molla, masculine plural molls, feminine plural molles)
gros	Adjective	gros (feminine grossa, masculine plural grossos, feminine plural grosses)
financer	Adjective	financer (feminine financera, masculine plural financers, feminine plural financeres)
altra	Adjective	altra
tant	Adjective	tant (feminine tanta, masculine plural tants, feminine plural tantes)
anterior	Adjective	anterior (masculine and feminine plural anteriors)
mundial	Adjective	mundial (masculine and feminine plural mundials)
oficial	Adjective	oficial (masculine and feminine plural oficials)
continu	Adjective	continu (feminine contínua, masculine plural continus, feminine plural contínues)
particular	Adjective	particular (masculine and feminine plural particulars)
falsa	Adjective	falsa
arrogant	Adjective	arrogant (masculine and feminine plural arrogants)
sol	Adjective	sol (feminine sola, masculine plural sols, feminine plural soles)
bones	Adjective	bones
civil	Adjective	civil (masculine and feminine plural civils)
monocrom	Adjective	monocrom (feminine monocroma, masculine plural monocroms, feminine plural monocromes)
gran	Adjective	gran (masculine and feminine plural grans)
hindi	Adjective	hindi (masculine and feminine plural hindis)
genial	Adjective	genial (masculine and feminine plural genials)
lenta	Adjective	lenta
tanta	Adjective	tanta
absent	Adjective	absent (masculine and feminine plural absents)
juvenil	Adjective	juvenil (masculine and feminine plural juvenils)
mutu	Adjective	mutu (feminine mútua, masculine plural mutus, feminine plural mútues)
marxista	Adjective	marxista (masculine and feminine plural marxistes)
viva	Adjective	viva
renal	Adjective	renal (masculine and feminine plural renals)
cornut	Adjective	cornut (feminine cornuda, masculine plural cornuts, feminine plural cornudes)
alegre	Adjective	alegre (masculine and feminine plural alegres)
modular	Adjective	modular (masculine and feminine plural modulars)
cultural	Adjective	cultural (masculine and feminine plural culturals)
crua	Adjective	crua
telugu	Adjective	telugu (masculine and feminine plural telugus)
solar	Adjective	solar (masculine and feminine plural solars)
viral	Adjective	viral (masculine and feminine plural virals)
maori	Adjective	maori (masculine and feminine plural maoris)
expert	Adjective	expert (feminine experta, masculine plural experts, feminine plural expertes)
novena	Adjective	novena
viu	Adjective	viu (feminine viva, masculine plural vius, feminine plural vives)
divers	Adjective	divers (feminine diversa, masculine plural diversos, feminine plural diverses)
alb	Adjective	alb (feminine alba, masculine plural albs, feminine plural albes)
kurd	Adjective	kurd (feminine kurda, masculine plural kurds, feminine plural kurdes)
bisexual	Adjective	bisexual (masculine and feminine plural bisexuals)
tebi	Adjective	tebi (feminine tèbia, masculine plural tebis, feminine plural tèbies)
interior	Adjective	interior (feminine interiora, masculine plural interiors, feminine plural interiores)
fred	Adjective	fred (feminine freda, masculine plural freds, feminine plural fredes)
aberrant	Adjective	aberrant (masculine and feminine plural aberrants)
inventor	Adjective	inventor (feminine inventora, masculine plural inventors, feminine plural inventores)
equivalent	Adjective	equivalent (masculine and feminine plural equivalents)
ambulant	Adjective	ambulant (masculine and feminine plural ambulants)
territorial	Adjective	territorial (masculine and feminine plural territorials)
racista	Adjective	racista (masculine and feminine plural racistes)
absurd	Adjective	absurd (feminine absurda, masculine plural absurds, feminine plural absurdes)
