𐍂𐌹𐌵𐌹𐌶𐌴𐌹𐌽𐍃	Adjective	𐍂𐌹𐌵𐌹𐌶𐌴𐌹𐌽𐍃 • (riqizeins)
𐌻𐌹𐌿𐌷𐌰𐌳𐌴𐌹𐌽𐍃	Adjective	𐌻𐌹𐌿𐌷𐌰𐌳𐌴𐌹𐌽𐍃 • (liuhadeins)
𐍂𐌴𐌹𐌺𐌹𐍃𐍄𐍃	Adjective	𐍂𐌴𐌹𐌺𐌹𐍃𐍄𐍃 • (reikists)
𐌰𐌺𐍂𐌰𐌽𐌰𐌻𐌰𐌿𐍃	Adjective	𐌰𐌺𐍂𐌰𐌽𐌰𐌻𐌰𐌿𐍃 • (akranalaus)
𐌻𐌰𐌲𐌲𐍃	Adjective	𐌻𐌰𐌲𐌲𐍃 • (laggs)
𐍅𐌹𐍄𐍉𐌳𐌰𐌻𐌰𐌿𐍃	Adjective	𐍅𐌹𐍄𐍉𐌳𐌰𐌻𐌰𐌿𐍃 • (witōdalaus)
𐌱𐍂𐌰𐌹𐌸𐍃	Adjective	𐌱𐍂𐌰𐌹𐌸𐍃 • (braiþs)
𐌲𐌰𐌻𐌰𐌿𐌱𐌴𐌹𐌽𐍃	Adjective	𐌲𐌰𐌻𐌰𐌿𐌱𐌴𐌹𐌽𐍃 • (galaubeins)
𐌰𐍂𐌼𐍉𐍃𐍄𐍃	Adjective	𐌰𐍂𐌼𐍉𐍃𐍄𐍃 • (armōsts)
𐍆𐌹𐌳𐌿𐍂𐌳𐍉𐌲𐍃	Adjective	𐍆𐌹𐌳𐌿𐍂𐌳𐍉𐌲𐍃 • (fidurdōgs)
𐌰𐌱𐍂𐍃	Adjective	𐌰𐌱𐍂𐍃 • (abrs)
𐍆𐌹𐌼𐍆𐍄𐌰	Adjective	𐍆𐌹𐌼𐍆𐍄𐌰 • (fimfta)
𐌱𐍂𐌿𐌺𐍃	Adjective	𐌱𐍂𐌿𐌺𐍃 • (brūks)
𐌲𐍂𐌴𐌳𐌰𐌲𐍃	Adjective	𐌲𐍂𐌴𐌳𐌰𐌲𐍃 • (grēdags)
𐌷𐌰𐌿𐌷𐍃	Adjective	𐌷𐌰𐌿𐌷𐍃 • (hauhs) (comparative *𐌷𐌰𐌿𐌷𐌹𐌶𐌰, superlative 𐌷𐌰𐌿𐌷𐌹𐍃𐍄𐍃)
𐍃𐍅𐌹𐌽𐌸𐍉𐌶𐌰	Adjective	𐍃𐍅𐌹𐌽𐌸𐍉𐌶𐌰 • (swinþōza)
𐍅𐌴𐌹𐌽𐌽𐌰𐍃	Adjective	𐍅𐌴𐌹𐌽𐌽𐌰𐍃 • (weinnas)
𐌲𐌰𐍅𐌰𐌹𐍂𐌸𐌴𐌹𐌲𐍃	Adjective	𐌲𐌰𐍅𐌰𐌹𐍂𐌸𐌴𐌹𐌲𐍃 • (gawairþeigs)
𐍃𐌹𐌽𐍄𐌴𐌹𐌽𐍃	Adjective	𐍃𐌹𐌽𐍄𐌴𐌹𐌽𐍃 • (sinteins)
𐌱𐌰𐍄𐌹𐍃𐍄𐍃	Adjective	𐌱𐌰𐍄𐌹𐍃𐍄𐍃 • (batists)
𐍅𐍉𐌸𐌴𐌹𐍃	Adjective	𐍅𐍉𐌸𐌴𐌹𐍃 • (wōþeis)
𐍃𐌰𐌼𐌰𐌺𐌿𐌽𐍃	Adjective	𐍃𐌰𐌼𐌰𐌺𐌿𐌽𐍃 • (samakuns)
𐍄𐌰𐌹𐌷𐍃𐍅𐌰	Adjective	𐍄𐌰𐌹𐌷𐍃𐍅𐌰 • (taihswa)
𐌳𐌰𐌿𐌸𐍃	Adjective	𐌳𐌰𐌿𐌸𐍃 • (dauþs)
𐌷𐌰𐌽𐌳𐌿𐌲𐍃	Adjective	𐌷𐌰𐌽𐌳𐌿𐌲𐍃 • (handugs) (comparative 𐌷𐌰𐌽𐌳𐌿𐌲𐍉𐌶𐌰)
𐍆𐍂𐌿𐌼𐌹𐍃𐍄𐍃	Adjective	𐍆𐍂𐌿𐌼𐌹𐍃𐍄𐍃 • (frumists)
𐌱𐌰𐍄𐌹𐌶𐌰	Adjective	𐌱𐌰𐍄𐌹𐌶𐌰 • (batiza)
𐌲𐌿𐌳𐌰𐌻𐌰𐌿𐍃	Adjective	𐌲𐌿𐌳𐌰𐌻𐌰𐌿𐍃 • (gudalaus)
𐌷𐌰𐍆𐍄𐍃	Adjective	𐌷𐌰𐍆𐍄𐍃 • (hafts)
𐌱𐌻𐌴𐌹𐌸𐍃	Adjective	𐌱𐌻𐌴𐌹𐌸𐍃 • (bleiþs)
𐌷𐌰𐌿𐌷𐌷𐌰𐌹𐍂𐍄𐍃	Adjective	𐌷𐌰𐌿𐌷𐌷𐌰𐌹𐍂𐍄𐍃 • (hauhhairts)
𐌰𐌲𐌻𐌿𐍃	Adjective	𐌰𐌲𐌻𐌿𐍃 • (aglus)
𐍃𐌺𐌰𐌿𐌽𐍃	Adjective	𐍃𐌺𐌰𐌿𐌽𐍃 • (skauns)
𐌽𐌹𐌿𐌾𐌹𐍃	Adjective	𐌽𐌹𐌿𐌾𐌹𐍃 • (niujis)
𐍄𐍂𐌹𐌲𐌲𐍅𐍃	Adjective	𐍄𐍂𐌹𐌲𐌲𐍅𐍃 • (triggws)
𐌰𐌹𐍅𐌴𐌹𐌽𐍃	Adjective	𐌰𐌹𐍅𐌴𐌹𐌽𐍃 • (aiweins)
𐍅𐌰𐌹𐌽𐌰𐌷𐍃	Adjective	𐍅𐌰𐌹𐌽𐌰𐌷𐍃 • (wainahs)
𐍅𐌰𐌿𐍂𐍃𐍄𐍅𐌴𐌹𐌲𐍃	Adjective	𐍅𐌰𐌿𐍂𐍃𐍄𐍅𐌴𐌹𐌲𐍃 • (waurstweigs)
𐌼𐌰𐌹𐌶𐌰	Adjective	𐌼𐌰𐌹𐌶𐌰 • (maiza)
𐍆𐍂𐌰𐍅𐌰𐌿𐍂𐌷𐍄𐍃	Adjective	𐍆𐍂𐌰𐍅𐌰𐌿𐍂𐌷𐍄𐍃 • (frawaurhts)
𐍄𐌰𐌹𐌷𐌿𐌽𐌳𐌰	Adjective	𐍄𐌰𐌹𐌷𐌿𐌽𐌳𐌰 • (taihunda)
𐍅𐌴𐌹𐌷𐍃	Adjective	𐍅𐌴𐌹𐌷𐍃 • (weihs)
𐌷𐌰𐌹𐌻𐌰𐌲𐍃	Adjective	𐌷𐌰𐌹𐌻𐌰𐌲𐍃 • (ᚺᚨᛁᛚᚨᚷᛊ, hailags)
𐌰𐍂𐌼𐍃	Adjective	𐌰𐍂𐌼𐍃 • (arms) (superlative 𐌰𐍂𐌼𐍉𐍃𐍄𐍃)
𐌼𐌹𐌳𐌾𐌹𐍃	Adjective	𐌼𐌹𐌳𐌾𐌹𐍃 • (midjis)
𐌰𐌲𐌻𐍃	Adjective	𐌰𐌲𐌻𐍃 • (agls)
𐍆𐌰𐌹𐌷𐌿𐍆𐍂𐌹𐌺𐍃	Adjective	𐍆𐌰𐌹𐌷𐌿𐍆𐍂𐌹𐌺𐍃 • (faihufriks)
𐌴𐌹𐍃𐌰𐍂𐌽𐌴𐌹𐌽𐍃	Adjective	𐌴𐌹𐍃𐌰𐍂𐌽𐌴𐌹𐌽𐍃 • (eisarneins)
𐌻𐌹𐌿𐍄𐍃	Adjective	𐌻𐌹𐌿𐍄𐍃 • (liuts)
𐌳𐌰𐌿𐍆𐍃	Adjective	𐌳𐌰𐌿𐍆𐍃 • (daufs)
𐌲𐌰𐌱𐌹𐌲𐍃	Adjective	𐌲𐌰𐌱𐌹𐌲𐍃 • (gabigs)
𐌼𐌰𐌹𐍃𐍄𐍃	Adjective	𐌼𐌰𐌹𐍃𐍄𐍃 • (maists)
𐌰𐌹𐍂𐌹𐌶𐌰	Adjective	𐌰𐌹𐍂𐌹𐌶𐌰 • (airiza)
𐌰𐌹𐌽𐌰𐌷𐍃	Adjective	𐌰𐌹𐌽𐌰𐌷𐍃 • (ainahs)
𐌰𐍆𐍄𐌿𐌼𐌰	Adjective	𐌰𐍆𐍄𐌿𐌼𐌰 • (aftuma) (superlative 𐌰𐍆𐍄𐌿𐌼𐌹𐍃𐍄𐍃)
𐍃𐍅𐌴𐍂𐍃	Adjective	𐍃𐍅𐌴𐍂𐍃 • (swērs)
𐌿𐌽𐍃𐌴𐌻𐍃	Adjective	𐌿𐌽𐍃𐌴𐌻𐍃 • (unsēls)
𐍅𐌰𐌹𐍂𐌸	Adjective	𐍅𐌰𐌹𐍂𐌸 • (wairþ)
𐌻𐌹𐌿𐍆𐍃	Adjective	𐌻𐌹𐌿𐍆𐍃 • (liufs)
𐌲𐌰𐌼𐌰𐌹𐌽𐍃	Adjective	𐌲𐌰𐌼𐌰𐌹𐌽𐍃 • (gamains)
𐍃𐌿𐍄𐌹𐍃	Adjective	𐍃𐌿𐍄𐌹𐍃 • (sutis)
𐌲𐌰𐌼𐌰𐌹𐌽𐌾𐌰	Adjective	𐌲𐌰𐌼𐌰𐌹𐌽𐌾𐌰 • (gamainja)
𐍆𐍂𐌴𐌹𐍃	Adjective	𐍆𐍂𐌴𐌹𐍃 • (freis)
𐍅𐌰𐌹𐍂𐍃𐌹𐌶𐌰	Adjective	𐍅𐌰𐌹𐍂𐍃𐌹𐌶𐌰 • (wairsiza)
𐍄𐌿𐌻𐌲𐌿𐍃	Adjective	𐍄𐌿𐌻𐌲𐌿𐍃 • (tulgus)
𐌽𐌹𐌿𐌽𐌳𐌰	Adjective	𐌽𐌹𐌿𐌽𐌳𐌰 • (niunda)
𐌰𐌹𐍂𐌸𐌴𐌹𐌽𐍃	Adjective	𐌰𐌹𐍂𐌸𐌴𐌹𐌽𐍃 • (airþeins)
𐍃𐌰𐌹𐌷𐍃𐍄𐌰	Adjective	𐍃𐌰𐌹𐌷𐍃𐍄𐌰 • (saihsta)
𐌰𐌹𐌽𐌰𐌺𐌻𐍃	Adjective	𐌰𐌹𐌽𐌰𐌺𐌻𐍃 • (ainakls)
𐌰𐌽𐍃𐍄𐌴𐌹𐌲𐍃	Adjective	𐌰𐌽𐍃𐍄𐌴𐌹𐌲𐍃 • (ansteigs)
𐌰𐌻𐌴𐍅𐌾𐌰	Adjective	𐌰𐌻𐌴𐍅𐌾𐌰 • (alēwja)
𐌰𐌽𐌳𐌹𐌻𐌰𐌿𐍃	Adjective	𐌰𐌽𐌳𐌹𐌻𐌰𐌿𐍃 • (andilaus)
𐌻𐌹𐌿𐌱𐌰𐌻𐌴𐌹𐌺𐍃	Adjective	𐌻𐌹𐌿𐌱𐌰𐌻𐌴𐌹𐌺𐍃 • (liubaleiks)
𐌰𐌷𐌼𐌴𐌹𐌽𐍃	Adjective	𐌰𐌷𐌼𐌴𐌹𐌽𐍃 • (ahmeins)
𐌷𐍂𐍉𐌸𐌴𐌹𐌲𐍃	Adjective	𐌷𐍂𐍉𐌸𐌴𐌹𐌲𐍃 • (hrōþeigs)
𐌷𐌰𐌽𐌳𐌿𐌲𐍉𐌶𐌰	Adjective	𐌷𐌰𐌽𐌳𐌿𐌲𐍉𐌶𐌰 • (handugōza)
𐌰𐌿𐌸𐌴𐌹𐍃	Adjective	𐌰𐌿𐌸𐌴𐌹𐍃 • (auþeis)
𐍃𐌴𐌻𐍃	Adjective	𐍃𐌴𐌻𐍃 • (sēls)
𐌷𐌰𐌿𐌷𐌹𐍃𐍄𐍃	Adjective	𐌷𐌰𐌿𐌷𐌹𐍃𐍄𐍃 • (hauhists)
𐌼𐌹𐌽𐌽𐌹𐍃𐍄𐍃	Adjective	𐌼𐌹𐌽𐌽𐌹𐍃𐍄𐍃 • (minnists)
𐌳𐌿𐌼𐌱𐍃	Adjective	𐌳𐌿𐌼𐌱𐍃 • (dumbs)
𐌼𐌰𐌽𐌽𐌹𐍃𐌺𐍃	Adjective	𐌼𐌰𐌽𐌽𐌹𐍃𐌺𐍃 • (mannisks)
𐌻𐌴𐌹𐌺𐌴𐌹𐌽𐍃	Adjective	𐌻𐌴𐌹𐌺𐌴𐌹𐌽𐍃 • (leikeins)
𐌺𐌰𐌿𐍂𐌿𐍃	Adjective	𐌺𐌰𐌿𐍂𐌿𐍃 • (kaurus)
𐌰𐌹𐌽𐍆𐌰𐌻𐌸𐍃	Adjective	𐌰𐌹𐌽𐍆𐌰𐌻𐌸𐍃 • (ainfalþs)
𐍅𐌴𐌹𐌷𐌰𐌽	Adjective	𐍅𐌴𐌹𐌷𐌰𐌽 • (weihan)
𐌷𐍂𐌰𐌹𐌽𐍃	Adjective	𐌷𐍂𐌰𐌹𐌽𐍃 • (hrains)
𐌰𐌹𐍂𐌸𐌰𐌺𐌿𐌽𐌳𐍃	Adjective	𐌰𐌹𐍂𐌸𐌰𐌺𐌿𐌽𐌳𐍃 • (airþakunds)
𐌰𐍆𐌳𐌰𐌿𐌹𐌸𐍃	Adjective	𐌰𐍆𐌳𐌰𐌿𐌹𐌸𐍃 • (afdauiþs)
𐌱𐌰𐌹𐍄𐍂𐍃	Adjective	𐌱𐌰𐌹𐍄𐍂𐍃 • (baitrs)
𐌰𐌻𐌻𐌰𐍅𐌰𐌿𐍂𐍃𐍄𐍅𐌰	Adjective	𐌰𐌻𐌻𐌰𐍅𐌰𐌿𐍂𐍃𐍄𐍅𐌰 • (allawaurstwa)
𐍃𐌹𐌻𐌳𐌰𐌻𐌴𐌹𐌺𐍃	Adjective	𐍃𐌹𐌻𐌳𐌰𐌻𐌴𐌹𐌺𐍃 • (sildaleiks)
𐌱𐌰𐌹𐍂𐌷𐍄𐍃	Adjective	𐌱𐌰𐌹𐍂𐌷𐍄𐍃 • (bairhts)
𐌷𐌰𐌻𐌱𐍃	Adjective	𐌷𐌰𐌻𐌱𐍃 • (halbs)
𐌼𐌹𐌺𐌹𐌻𐍃	Adjective	𐌼𐌹𐌺𐌹𐌻𐍃 • (mikils) (comparative 𐌼𐌰𐌹𐌶𐌰, superlative 𐌼𐌰𐌹𐍃𐍄𐍃)
𐌻𐌴𐌹𐍄𐌹𐌻𐍃	Adjective	𐌻𐌴𐌹𐍄𐌹𐌻𐍃 • (leitils) (comparative 𐌼𐌹𐌽𐌽𐌹𐌶𐌰, superlative 𐌼𐌹𐌽𐌽𐌹𐍃𐍄𐍃)
𐍅𐌹𐌻𐌸𐌴𐌹𐍃	Adjective	𐍅𐌹𐌻𐌸𐌴𐌹𐍃 • (wilþeis)
𐌼𐌹𐌽𐌽𐌹𐌶𐌰	Adjective	𐌼𐌹𐌽𐌽𐌹𐌶𐌰 • (minniza)
𐌿𐌱𐌹𐌻𐍃	Adjective	𐌿𐌱𐌹𐌻𐍃 • (ubils) (comparative 𐍅𐌰𐌹𐍂𐍃𐌹𐌶𐌰, superlative 𐍅𐌰𐌹𐍂𐍃𐌹𐍃𐍄𐍃)
𐌷𐌰𐌹𐌸𐌹𐍅𐌹𐍃𐌺𐍃	Adjective	𐌷𐌰𐌹𐌸𐌹𐍅𐌹𐍃𐌺𐍃 • (haiþiwisks)
𐌷𐌰𐍂𐌳𐌿𐍃	Adjective	𐌷𐌰𐍂𐌳𐌿𐍃 • (hardus) (comparative 𐌷𐌰𐍂𐌳𐌹𐌶𐌰, superlative 𐌷𐌰𐍂𐌳𐌹𐍃𐍄𐍃)
𐌰𐌲𐌲𐍅𐌿𐍃	Adjective	𐌰𐌲𐌲𐍅𐌿𐍃 • (aggwus)
𐌰𐌷𐍄𐌿𐌳𐌰	Adjective	𐌰𐌷𐍄𐌿𐌳𐌰 • (ahtuda)
𐌰𐌻𐌸𐌹𐌶𐌰	Adjective	𐌰𐌻𐌸𐌹𐌶𐌰 • (alþiza)
𐍃𐌹𐌽𐌴𐌹𐌲𐍃	Adjective	𐍃𐌹𐌽𐌴𐌹𐌲𐍃 • (sineigs) (comparative 𐍃𐌹𐌽𐌹𐌶𐌰, superlative 𐍃𐌹𐌽𐌹𐍃𐍄𐍃)
𐌰𐌻𐌰𐌸𐌰𐍂𐌱𐌰	Adjective	𐌰𐌻𐌰𐌸𐌰𐍂𐌱𐌰 • (alaþarba)
𐍈𐌴𐌹𐍄𐍃	Adjective	𐍈𐌴𐌹𐍄𐍃 • (ƕeits)
𐌷𐌰𐌻𐌱𐌰	Adjective	𐌷𐌰𐌻𐌱𐌰 • (halba)
𐍃𐍅𐌹𐌽𐌸𐍃	Adjective	𐍃𐍅𐌹𐌽𐌸𐍃 • (swinþs) (comparative 𐍃𐍅𐌹𐌽𐌸𐍉𐌶𐌰)
𐌰𐌽𐌸𐌰𐍂	Adjective	𐌰𐌽𐌸𐌰𐍂 • (anþar)
𐍃𐌿𐌽𐌾𐌰	Adjective	𐍃𐌿𐌽𐌾𐌰 • (sunja)
𐌰𐌽𐌰𐌻𐌰𐌿𐌲𐌽𐍃	Adjective	𐌰𐌽𐌰𐌻𐌰𐌿𐌲𐌽𐍃 • (analaugns)
𐍃𐍅𐌹𐌺𐌽𐍃	Adjective	𐍃𐍅𐌹𐌺𐌽𐍃 • (swikns)
𐌲𐌰𐌿𐍂𐍃	Adjective	𐌲𐌰𐌿𐍂𐍃 • (gaurs)
𐌲𐍉𐌸𐍃	Adjective	𐌲𐍉𐌸𐍃 • (gōþs) (comparative 𐌱𐌰𐍄𐌹𐌶𐌰, superlative 𐌱𐌰𐍄𐌹𐍃𐍄𐍃)
𐌰𐌿𐌳𐌰𐌷𐌰𐍆𐍄𐍃	Adjective	𐌰𐌿𐌳𐌰𐌷𐌰𐍆𐍄𐍃 • (audahafts)
𐌸𐍂𐌹𐌳𐌾𐌰	Adjective	𐌸𐍂𐌹𐌳𐌾𐌰 • (þridja)
𐌱𐌻𐌹𐌽𐌳𐍃	Adjective	𐌱𐌻𐌹𐌽𐌳𐍃 • (blinds)
𐌰𐌹𐍂𐌶𐌴𐌹𐍃	Adjective	𐌰𐌹𐍂𐌶𐌴𐌹𐍃 • (airzeis)
𐌿𐌽𐍃𐍅𐌴𐍂𐍃	Adjective	𐌿𐌽𐍃𐍅𐌴𐍂𐍃 • (unswērs)
𐌰𐌲𐌻𐌰𐌹𐍄𐌲𐌰𐍃𐍄𐌰𐌻𐌳𐍃	Adjective	𐌰𐌲𐌻𐌰𐌹𐍄𐌲𐌰𐍃𐍄𐌰𐌻𐌳𐍃 • (aglaitgastalds)
𐍆𐍂𐍉𐌸𐍃	Adjective	𐍆𐍂𐍉𐌸𐍃 • (frōþs)
𐌰𐌽𐌰𐌷𐌰𐌹𐌼𐌴𐌹𐍃	Adjective	𐌰𐌽𐌰𐌷𐌰𐌹𐌼𐌴𐌹𐍃 • (anahaimeis)
𐌷𐌻𐌿𐍄𐍂𐍃	Adjective	𐌷𐌻𐌿𐍄𐍂𐍃 • (hlūtrs)
𐌰𐍆𐌼𐌰𐌿𐌹𐌳𐍃	Adjective	𐌰𐍆𐌼𐌰𐌿𐌹𐌳𐍃 • (afmauids)
𐌰𐍂𐌼𐌰𐌷𐌰𐌹𐍂𐍄𐍃	Adjective	𐌰𐍂𐌼𐌰𐌷𐌰𐌹𐍂𐍄𐍃 • (armahairts)
𐌰𐌷𐍄𐌰𐌿𐌳𐍉𐌲𐍃	Adjective	𐌰𐌷𐍄𐌰𐌿𐌳𐍉𐌲𐍃 • (ahtaudōgs)
𐌲𐌰𐌻𐌴𐌹𐌺𐍃	Adjective	𐌲𐌰𐌻𐌴𐌹𐌺𐍃 • (galeiks)
𐍃𐌺𐌴𐌹𐍂𐍃	Adjective	𐍃𐌺𐌴𐌹𐍂𐍃 • (skeirs)
𐌼𐌰𐌷𐍄𐌴𐌹𐌲𐍃	Adjective	𐌼𐌰𐌷𐍄𐌴𐌹𐌲𐍃 • (mahteigs)
𐍃𐌿𐌽𐌾𐌹𐍃	Adjective	𐍃𐌿𐌽𐌾𐌹𐍃 • (sunjis)
𐍆𐍂𐌿𐌼𐌰	Adjective	𐍆𐍂𐌿𐌼𐌰 • (fruma)
𐌰𐍆𐍄𐌿𐌼𐌹𐍃𐍄𐍃	Adjective	𐌰𐍆𐍄𐌿𐌼𐌹𐍃𐍄𐍃 • (aftumists)
𐌸𐍅𐌰𐌹𐍂𐌷𐍃	Adjective	𐌸𐍅𐌰𐌹𐍂𐌷𐍃 • (þwairhs)
𐍀𐌰𐌿𐍂𐍀𐌿𐍂𐍉𐌸𐍃	Adjective	𐍀𐌰𐌿𐍂𐍀𐌿𐍂𐍉𐌸𐍃 • (paurpurōþs)
𐌻𐌰𐌿𐍃	Adjective	𐌻𐌰𐌿𐍃 • (laus)
𐍅𐌰𐌹𐍂𐌸𐍃	Adjective	𐍅𐌰𐌹𐍂𐌸𐍃 • (wairþs)
𐍆𐌿𐌻𐌻𐍃	Adjective	𐍆𐌿𐌻𐌻𐍃 • (fulls)
𐌰𐌻𐌾𐌰𐌺𐌿𐌽𐍃	Adjective	𐌰𐌻𐌾𐌰𐌺𐌿𐌽𐍃 • (aljakuns)
𐍅𐌰𐌹𐍂𐍃𐌹𐍃𐍄𐍃	Adjective	𐍅𐌰𐌹𐍂𐍃𐌹𐍃𐍄𐍃 • (wairsists)
𐌻𐌹𐍃𐍄𐌴𐌹𐌲𐍃	Adjective	𐌻𐌹𐍃𐍄𐌴𐌹𐌲𐍃 • (listeigs)
𐌷𐌰𐌹𐌻𐍃	Adjective	𐌷𐌰𐌹𐌻𐍃 • (hails)
𐌳𐍅𐌰𐌻𐍃	Adjective	𐌳𐍅𐌰𐌻𐍃 • (dwals)
𐌳𐌹𐌿𐍀𐍃	Adjective	𐌳𐌹𐌿𐍀𐍃 • (diups)
𐍂𐌰𐌿𐌸𐍃	Adjective	𐍂𐌰𐌿𐌸𐍃 • (rauþs)
𐍂𐌴𐌹𐌺𐌴𐌹𐍃	Adjective	𐍂𐌴𐌹𐌺𐌴𐌹𐍃 • (reikeis) (comparative -, superlative 𐍂𐌴𐌹𐌺𐌹𐍃𐍄𐍃)
𐌿𐌽𐌼𐌰𐌷𐍄𐌴𐌹𐌲𐍃	Adjective	𐌿𐌽𐌼𐌰𐌷𐍄𐌴𐌹𐌲𐍃 • (unmahteigs)
𐌰𐌻𐌸𐌴𐌹𐍃	Adjective	𐌰𐌻𐌸𐌴𐌹𐍃 • (alþeis) (comparative 𐌰𐌻𐌸𐌹𐌶𐌰)
𐌼𐌰𐌽𐌰𐌲𐍃	Adjective	𐌼𐌰𐌽𐌰𐌲𐍃 • (manags) (comparative 𐌼𐌰𐌽𐌰𐌲𐌹𐌶𐌰, superlative 𐌼𐌰𐌽𐌰𐌲𐌹𐍃𐍄𐍃)
