bas	Noun	bas m (plural bas)
bas	Noun	bas m (plural bas)
salariat	Noun	salariat m (plural salariats)
nazis	Noun	nazis ?
blond	Noun	blond m (plural blonds, feminine blonde)
mal	Noun	mal m (plural maux)
animation	Noun	animation f (plural animations)
apanage	Noun	apanage m (plural apanages)
empire	Noun	empire m (plural empires)
crampon	Noun	crampon m (plural crampons)
lojban	Noun	lojban m (uncountable)
blues	Noun	blues m (plural blues)
savoir	Noun	savoir m (plural savoirs)
encomium	Noun	encomium m (plural encomiums)
tribunal	Noun	tribunal m (plural tribunaux)
latte	Noun	latte f (plural lattes)
argumentation	Noun	argumentation f (plural argumentations)
neurobiologie	Noun	neurobiologie f (plural neurobiologies)
check	Noun	check m (plural checks)
paraître	Noun	paraître m (plural paraîtres)
organisation	Noun	organisation f (plural organisations)
psy	Noun	psy m, f (plural psys)
car	Noun	car m (plural cars)
islam	Noun	islam m (plural islams)
madrigal	Noun	madrigal m (plural madrigaux)
bible	Noun	bible f (plural bibles)
u	Noun	u m (plural us)
automation	Noun	automation f (plural automations)
savans	Noun	savans m
smiley	Noun	smiley m (plural smileys)
jade	Noun	jade m (plural jades)
kuna	Noun	kuna m, f (plural kunas)
rond	Noun	rond m (plural ronds)
violet	Noun	violet m (countable and uncountable, plural violets)
transistor	Noun	transistor m (plural transistors)
barons	Noun	barons m pl
crème fraîche	Noun	crème fraîche f (plural crèmes fraîches)
nord	Noun	nord m (plural nord)
sonar	Noun	sonar m (plural sonars)
papier	Noun	papier m (plural papiers)
beagle	Noun	beagle m (plural beagles)
hall	Noun	hall m (plural halls)
pies	Noun	pies f
canasta	Noun	canasta f (uncountable)
minimum	Noun	minimum m (plural minima)
col	Noun	col m (plural cols)
bidet	Noun	bidet m (plural bidets)
slang	Noun	slang m (plural slangs)
ataman	Noun	ataman m (plural atamans)
café	Noun	café m (plural cafés)
perso	Noun	perso m (plural persos)
migration	Noun	migration f (plural migrations)
plage	Noun	plage f (plural plages)
autostop	Noun	autostop m (uncountable)
chef	Noun	chef m (plural chefs)
chef	Noun	chef m (plural chefs, feminine cheffe)
lange	Noun	lange m (plural langes)
sanskrit	Noun	sanskrit m (uncountable)
mille	Noun	mille m (plural mille)
plastes	Noun	plastes m
koto	Noun	koto m (plural kotos)
radium	Noun	radium m (uncountable)
cover	Noun	cover m (plural covers)
gnocchi	Noun	gnocchi m (plural gnocchis)
gentil	Noun	gentil m (plural gentils)
idiote	Noun	idiote f (plural idiotes)
caddie	Noun	caddie m (plural caddies)
citation	Noun	citation f (plural citations)
buste	Noun	buste m (plural bustes)
afrikaans	Noun	afrikaans m (uncountable)
brise	Noun	brise f (plural brises)
moment	Noun	moment m (plural moments)
hab	Noun	hab m, f (plural habs)
tan	Noun	tan m (plural tans)
aa	Noun	aa m (plural aas)
script	Noun	script m (plural scripts)
soc	Noun	soc m (plural socs)
breton	Noun	breton m (uncountable)
cassis	Noun	cassis m (plural cassis)
officier	Noun	officier m (plural officiers, feminine officière)
particulier	Noun	particulier m (plural particuliers, feminine particulière)
cars	Noun	cars m
corgi	Noun	corgi m (plural corgis)
brinde	Noun	brinde f (plural brindes)
fantasie	Noun	fantasie f (plural fantasies)
papa	Noun	papa m (plural papas)
ibis	Noun	ibis m (plural ibis)
pile	Noun	pile f (plural piles)
pêcher	Noun	pêcher m (plural pêchers)
agape	Noun	agape f (plural agapes)
able	Noun	able m (plural ables)
latin	Noun	latin m (plural latins)
bacon	Noun	bacon m (uncountable)
lies	Noun	lies f
mise	Noun	mise f (plural mises)
mise	Noun	mise f (plural mises)
protestant	Noun	protestant m (plural protestants, feminine protestante)
snack	Noun	snack m (plural snacks)
onde	Noun	onde f (plural ondes)
pouvoir	Noun	pouvoir m (plural pouvoirs)
démon	Noun	démon m (plural démons, feminine démone)
ataraxie	Noun	ataraxie f (plural ataraxies)
cyberpunk	Noun	cyberpunk m (plural cyberpunks)
ununbium	Noun	ununbium m (plural ununbiums)
hand	Noun	hand m (uncountable)
entomologie	Noun	entomologie f (plural entomologies)
recension	Noun	recension f (plural recensions)
rai	Noun	rai m (plural rais)
vandalisme	Noun	vandalisme m (plural vandalismes)
Mongole	Noun	Mongole f (plural Mongoles)
scorpion	Noun	scorpion m (plural scorpions)
sudoku	Noun	sudoku m (plural sudokus)
mi	Noun	mi m (plural mi)
dire	Noun	dire m (plural dires)
combinat	Noun	combinat m (plural combinats)
reine	Noun	reine f (plural reines)
orange	Noun	orange f (plural oranges)
orange	Noun	orange m (plural oranges)
mare	Noun	mare f (plural mares)
acte	Noun	acte m (plural actes)
box	Noun	box m (plural box or boxes)
box	Noun	box f (plural box)
anglois	Noun	anglois m (uncountable)
martyr	Noun	martyr m (plural martyrs, feminine martyre)
retorte	Noun	retorte f (plural retortes)
i	Noun	i m (plural is)
san	Noun	san m (plural san)
moral	Noun	moral m (plural moraux)
campus	Noun	campus m (plural campus)
tette	Noun	tette f (plural tettes)
francium	Noun	francium m (uncountable)
panda	Noun	panda m (plural pandas)
amiral	Noun	amiral m (plural amiraux, feminine amirale)
lis	Noun	lis m (plural lis)
tests	Noun	tests pl
darmstadtium	Noun	darmstadtium m (plural darmstadtiums)
jamboree	Noun	jamboree m (plural jamborees)
kimchi	Noun	kimchi m (plural kimchis)
protactinium	Noun	protactinium m (uncountable)
label	Noun	label m (plural labels)
bodybuilding	Noun	bodybuilding m (plural bodybuildings)
palmier	Noun	palmier m (plural palmiers)
kannada	Noun	kannada m (uncountable)
bébé	Noun	bébé m (plural bébés)
parens	Noun	parens m
instrument	Noun	instrument m (plural instruments)
alcyon	Noun	alcyon m (plural alcyons)
jeton	Noun	jeton m (plural jetons)
biplan	Noun	biplan m (plural biplans)
fer	Noun	fer m (plural fers)
mets	Noun	mets m (plural mets)
gwerz	Noun	gwerz m (plural gwerz)
gens	Noun	gens m pl (plural only)
file	Noun	file f (plural files)
mandat	Noun	mandat m (plural mandats)
brin	Noun	brin m (plural brins)
principal	Noun	principal m (plural principaux, feminine principale)
epsilon	Noun	epsilon m (plural epsilon)
futur	Noun	futur m (plural futurs)
Egyptien	Noun	Egyptien m (plural Egyptiens, feminine Egyptienne)
président	Noun	président m (plural présidents, feminine présidente)
Tatar	Noun	Tatar m (plural Tatars, feminine Tatare)
vermeil	Noun	vermeil m (plural vermeils)
vase	Noun	vase f (plural vases)
vase	Noun	vase m (plural vases)
silex	Noun	silex m (plural silex)
bordel	Noun	bordel m (plural bordels)
sot	Noun	sot m (plural sots, feminine sotte)
yttrium	Noun	yttrium m (uncountable)
grenadier	Noun	grenadier m (plural grenadiers)
hangar	Noun	hangar m (plural hangars)
accent	Noun	accent m (plural accents)
trumpisme	Noun	trumpisme m (plural trumpismes)
skipper	Noun	skipper m (plural skippers)
stigma	Noun	stigma m (plural stigmas)
totem	Noun	totem m (plural totems)
gond	Noun	gond m (plural gonds)
tradition	Noun	tradition f (plural traditions)
bol	Noun	bol m (plural bols)
taler	Noun	taler m (plural talers)
armurier	Noun	armurier m (plural armuriers, feminine armurière)
poster	Noun	poster m (plural posters)
service	Noun	service m (plural services)
romancier	Noun	romancier m (plural romanciers)
ambassade	Noun	ambassade f (plural ambassades)
major	Noun	major m (plural majors)
subversion	Noun	subversion f (plural subversions)
luxe	Noun	luxe m (plural luxes)
lande	Noun	lande f (plural landes)
banian	Noun	banian m (plural banians)
rez	Noun	rez m (plural rez) (only in rez-de-chaussée and rez-de-jardin)
cas	Noun	cas m (plural cas)
hart	Noun	hart f (plural harts)
sorgo	Noun	sorgo m (plural sorgos)
boson	Noun	boson m (plural bosons)
miel	Noun	miel m (plural miels)
jugerum	Noun	jugerum m (plural jugerums)
pailler	Noun	pailler m (plural paillers)
patates	Noun	patates f
burkini	Noun	burkini m (plural burkinis)
notes	Noun	notes f
garant	Noun	garant m (plural garants)
reporter	Noun	reporter m (plural reporters)
bou	Noun	bou m (plural bous)
entier	Noun	entier m (plural entiers)
anse	Noun	anse f (plural anses)
anse	Noun	anse f (plural anses)
premier	Noun	premier m (plural premiers, feminine première)
slam	Noun	slam m (plural slams)
lambda	Noun	lambda m (plural lambda or lambdas)
popo	Noun	popo m (plural popos)
bandit	Noun	bandit m (plural bandits)
distribution	Noun	distribution f (plural distributions)
cymbalum	Noun	cymbalum m (plural cymbalums)
devenir	Noun	devenir m (plural devenirs)
stimulus	Noun	stimulus m (plural stimulus or stimuli)
zoologie	Noun	zoologie f (uncountable)
dyne	Noun	dyne f (plural dynes)
cop	Noun	cop m (plural cops)
zen	Noun	zen m (plural zen)
cerne	Noun	cerne m (plural cernes)
pair	Noun	pair m (plural pairs)
radula	Noun	radula f (plural radulas)
dromadaire	Noun	dromadaire m (plural dromadaires)
flot	Noun	flot m (plural flots)
geisha	Noun	geisha f (plural geishas)
fjord	Noun	fjord m (plural fjords)
cocher	Noun	cocher m (plural cochers)
lave	Noun	lave f (plural laves)
pogrom	Noun	pogrom m (plural pogroms)
grec	Noun	grec m (uncountable)
bulle	Noun	bulle f (plural bulles)
cobra	Noun	cobra m (plural cobras)
lotus	Noun	lotus m (plural lotuses)
rets	Noun	rets m pl (plural only)
tonus	Noun	tonus m (plural tonus)
hola	Noun	hola f (plural holas)
yacht	Noun	yacht m (plural yachts)
mental	Noun	mental m (uncountable)
altiste	Noun	altiste m, f (plural altistes)
pine	Noun	pine f (plural pines)
antenne	Noun	antenne f (plural antennes)
apparat	Noun	apparat m (plural apparats)
pugilat	Noun	pugilat m (plural pugilats)
verre	Noun	verre m (plural verres)
podium	Noun	podium m (plural podiums or podia)
botox	Noun	botox m (uncountable)
nahuatl	Noun	nahuatl m (uncountable)
junior	Noun	junior m, f (plural juniors)
pika	Noun	pika m (plural pikas)
azimut	Noun	azimut m (plural azimuts)
transmission	Noun	transmission f (plural transmissions)
bar	Noun	bar m (plural bars)
tir	Noun	tir m (plural tirs)
animal	Noun	animal m (plural animaux)
clips	Noun	clips m
vagin	Noun	vagin m (plural vagins)
croupier	Noun	croupier m (plural croupiers, feminine croupière)
barman	Noun	barman m (plural barmans)
pitbull	Noun	pitbull m (plural pitbulls)
ducat	Noun	ducat m (plural ducats)
troglodytes	Noun	troglodytes m f
tango	Noun	tango m (plural tangos)
twist	Noun	twist m (plural twists)
cents	Noun	cents m
bis	Noun	bis ?
bis	Noun	bis m (plural bis)
bis	Noun	bis m (plural bis)
bang	Noun	bang m (plural bangs)
fondant	Noun	fondant f (plural fondants)
abdo	Noun	abdo m (plural abdos)
termes	Noun	termes m
aisné	Noun	aisné m (plural aisnés, feminine aisnée)
proposition	Noun	proposition f (plural propositions)
masculin	Noun	masculin m (plural masculins)
zeugma	Noun	zeugma m (plural zeugmas)
bridge	Noun	bridge m (uncountable)
superorganisme	Noun	superorganisme m (plural superorganismes)
blini	Noun	blini m (plural blinis)
intranet	Noun	intranet m (plural intranets)
hélium	Noun	hélium m (uncountable)
turc	Noun	turc m (uncountable)
nomade	Noun	nomade m, f (plural nomades)
pastel	Noun	pastel m (plural pastels)
hamburger	Noun	hamburger m (plural hamburgers)
pince	Noun	pince f (plural pinces)
fermier	Noun	fermier m (plural fermiers, feminine fermière)
mafia	Noun	mafia f (plural mafias)
aire	Noun	aire f (plural aires)
aire	Noun	aire f (plural aires)
underground	Noun	underground m (uncountable)
piano	Noun	piano m (plural pianos)
lever	Noun	lever m (plural levers)
krach	Noun	krach m (plural krachs)
jota	Noun	jota m (plural jotas)
acacia	Noun	acacia m (plural acacias)
buffet	Noun	buffet m (plural buffets)
nature	Noun	nature f (plural natures)
smoking	Noun	smoking m (plural smokings)
cardinal	Noun	cardinal m (plural cardinaux)
cardinal	Noun	cardinal m (plural cardinal)
grotte	Noun	grotte f (plural grottes)
bandage	Noun	bandage m (plural bandages)
bolet	Noun	bolet m (plural bolets)
guru	Noun	guru m (plural gurus)
mandarin	Noun	mandarin m (uncountable)
unes	Noun	unes f
os	Noun	os m (plural os)
taon	Noun	taon m (plural taons)
nulle	Noun	nulle f (plural nulles)
aluminium	Noun	aluminium m (plural aluminiums)
tweeter	Noun	tweeter m (plural tweeters)
perroqueter	Noun	perroqueter
chanson	Noun	chanson f (plural chansons)
lampas	Noun	lampas m (uncountable)
kvas	Noun	kvas m (uncountable)
fond	Noun	fond m (plural fonds)
lit	Noun	lit m (plural lits)
plan	Noun	plan m (plural plans)
caviar	Noun	caviar m (plural caviars)
curium	Noun	curium m (uncountable)
moments	Noun	moments m
thallium	Noun	thallium m (uncountable)
certain	Noun	certain m (plural certains)
gay	Noun	gay m (plural gays)
mail	Noun	mail m (plural mails)
mail	Noun	mail m (plural mails)
facs	Noun	facs f
osso buco	Noun	osso buco m (uncountable)
pygidium	Noun	pygidium m (plural pygidiums)
dysprosium	Noun	dysprosium m (uncountable)
planche	Noun	planche f (plural planches)
lâcher	Noun	lâcher m (plural lâchers)
carter	Noun	carter m (plural carters)
salon	Noun	salon m (plural salons)
cappuccino	Noun	cappuccino m (plural cappuccinos)
dollar	Noun	dollar m (plural dollars)
solide	Noun	solide m (plural solides)
biceps	Noun	biceps m (plural biceps)
sprinter	Noun	sprinter m (plural sprinters)
ære	Noun	ære f (plural æres)
kapo	Noun	kapo m (plural kapos)
razzia	Noun	razzia f (plural razzias)
aura	Noun	aura f (plural auras)
motivation	Noun	motivation f (plural motivations)
tas	Noun	tas m (plural tas)
pote	Noun	pote m, f (plural potes)
fjeld	Noun	fjeld m (plural fjelds)
variation	Noun	variation f (plural variations)
cherokee	Noun	cherokee m (uncountable)
prestige	Noun	prestige m (plural prestiges)
iridium	Noun	iridium m (uncountable)
fluor	Noun	fluor m (uncountable)
tavernier	Noun	tavernier m (plural taverniers, feminine tavernière)
sono	Noun	sono f (plural sonos)
ruse	Noun	ruse f (plural ruses)
proconsul	Noun	proconsul m (plural proconsuls, feminine proconsule)
tris	Noun	tris m
master	Noun	master m (plural masters)
saga	Noun	saga f (plural sagas)
mule	Noun	mule f (plural mules)
bibliobus	Noun	bibliobus m (plural bibliobus)
dol	Noun	dol m (plural dols)
strontium	Noun	strontium m (uncountable)
plaisir	Noun	plaisir m (plural plaisirs)
sanas	Noun	sanas ?
format	Noun	format m (plural formats)
bac	Noun	bac m (plural bacs)
bac	Noun	bac m (plural bacs)
turbans	Noun	turbans m
starter	Noun	starter m (plural starters)
kas	Noun	kas m
pois	Noun	pois m (plural pois)
index	Noun	index m (plural index)
vit	Noun	vit m (plural vits)
pudding	Noun	pudding m (plural puddings)
fur	Noun	fur m (plural not attested)
parti	Noun	parti m (plural partis)
surimi	Noun	surimi m (plural surimis)
anorak	Noun	anorak m (plural anoraks)
salve	Noun	salve f (plural salves)
patrie	Noun	patrie f (plural patries)
puriste	Noun	puriste m, f (plural puristes)
farad	Noun	farad m (plural farads)
avenir	Noun	avenir m (plural avenirs)
præsident	Noun	præsident m (plural præsidents, feminine præsidente)
méz	Noun	méz m (plural méz)
lasagne	Noun	lasagne f (plural lasagnes)
compendium	Noun	compendium m (plural compendiums)
kiwi	Noun	kiwi m (plural kiwis)
bile	Noun	bile f (uncountable)
vomi	Noun	vomi m (plural vomis)
ordre	Noun	ordre m (plural ordres)
guet	Noun	guet m (plural guets)
bi	Noun	bi m, f (plural bis)
hospital	Noun	hospital m (plural hospitaux)
polonium	Noun	polonium m (uncountable)
bordeaux	Noun	bordeaux m (uncountable)
bordeaux	Noun	bordeaux m
tare	Noun	tare f (plural tares)
aine	Noun	aine f (plural aines)
diamant	Noun	diamant m (plural diamants)
diamant	Noun	diamant m (uncountable)
palu	Noun	palu m (plural palus)
panic	Noun	panic m (plural panics)
proton	Noun	proton m (plural protons)
trio	Noun	trio m (plural trios)
trio	Noun	trio m (uncountable)
repentir	Noun	repentir m (plural repentirs)
lot	Noun	lot m (plural lots)
nana	Noun	nana f (plural nanas)
rote	Noun	rote f (plural rotes)
tricot	Noun	tricot m (plural tricots)
cosinus	Noun	cosinus m (plural cosinus)
rame	Noun	rame f (plural rames)
rame	Noun	rame f (plural rames)
masse	Noun	masse f (plural masses)
masse	Noun	masse f (plural masses)
zloty	Noun	zloty m (plural zlotys)
baraka	Noun	baraka f (uncountable)
vivarium	Noun	vivarium m (plural vivariums)
bail	Noun	bail m (plural baux)
dragoman	Noun	dragoman m (plural dragomans)
un	Noun	un m (plural un)
entrecôte	Noun	entrecôte f (plural entrecôtes)
moto	Noun	moto f (plural motos)
liber	Noun	liber m (plural libers)
lutécium	Noun	lutécium m (uncountable)
seaborgium	Noun	seaborgium m (plural seaborgiums)
senior	Noun	senior m (plural seniors)
bluff	Noun	bluff m (plural bluffs)
sport	Noun	sport m (plural sports)
syli	Noun	syli m (plural sylis)
arboretum	Noun	arboretum m (plural arboretums)
vuvuzela	Noun	vuvuzela f (plural vuvuzelas)
cape	Noun	cape f (plural capes)
est	Noun	est m (plural est)
ramadan	Noun	ramadan m (plural ramadans)
baba	Noun	baba m (plural babas)
pizza	Noun	pizza f (plural pizzas)
profil	Noun	profil m (plural profils)
hyperbole	Noun	hyperbole f (plural hyperboles)
lampe	Noun	lampe f (plural lampes)
solarium	Noun	solarium m (plural solariums)
orgasme	Noun	orgasme m (plural orgasmes)
dan	Noun	dan m (plural dans)
vouloir	Noun	vouloir m (plural vouloirs)
cal	Noun	cal m (plural cals)
guide	Noun	guide m (plural guides)
horde	Noun	horde f (plural hordes)
minaret	Noun	minaret m (plural minarets)
pal	Noun	pal m (plural pals)
liste	Noun	liste f (plural listes)
bourgeois	Noun	bourgeois m (plural bourgeois, feminine bourgeoise)
biscuit	Noun	biscuit m (plural biscuits)
brutal	Noun	brutal m (plural brutaux, feminine brutale)
champagne	Noun	champagne m (plural champagnes)
local	Noun	local m (plural locaux)
benzol	Noun	benzol m (plural benzols)
bombardement	Noun	bombardement m (plural bombardements)
bure	Noun	bure f (plural bures)
déjeûner	Noun	déjeûner m (plural déjeûners)
eldorado	Noun	eldorado m (plural eldorados)
hydromel	Noun	hydromel m (usually uncountable, plural hydromels)
aria	Noun	aria f (plural arias)
doping	Noun	doping m (uncountable)
shah	Noun	shah m (plural shahs)
nain	Noun	nain m (plural nains, feminine naine)
polka	Noun	polka f (plural polkas)
rang	Noun	rang m (plural rangs)
selfie	Noun	selfie m, f (plural selfies)
positron	Noun	positron m (plural positrons)
sphinx	Noun	sphinx m (plural sphinx)
air	Noun	air m (plural airs)
bastion	Noun	bastion m (plural bastions)
kraken	Noun	kraken m (plural krakens)
frigo	Noun	frigo m (plural frigos)
radar	Noun	radar m (plural radars)
amal	Noun	amal m (uncountable)
halva	Noun	halva m (plural halvas)
baht	Noun	baht m (plural bahts)
propolis	Noun	propolis f (uncountable)
porc	Noun	porc m (plural porcs)
volts	Noun	volts m
spis	Noun	spis ?
lant	Noun	lant m (plural lants)
argon	Noun	argon m (uncountable)
melancholie	Noun	melancholie f (plural melancholies)
agar	Noun	agar m (uncountable)
ballade	Noun	ballade f (plural ballades)
ultimatum	Noun	ultimatum m (plural ultimatums)
dos	Noun	dos m (plural dos)
antistrophe	Noun	antistrophe f (plural antistrophes)
fans	Noun	fans m, f
fon	Noun	fon m (uncountable)
salut	Noun	salut m (plural saluts)
manne	Noun	manne f (plural mannes)
manne	Noun	manne f (plural mannes)
caprin	Noun	caprin m (plural caprins)
latex	Noun	latex m (uncountable)
water	Noun	water m (plural waters)
brand	Noun	brand m (plural brands)
cricket	Noun	cricket m (uncountable)
faux	Noun	faux f (plural faux)
fonio	Noun	fonio m (plural fonios)
mythos	Noun	mythos m
hyæne	Noun	hyæne f (plural hyænes)
fucus	Noun	fucus m (plural fucus)
dé	Noun	dé m (plural dés)
dé	Noun	dé m (plural dés)
plexus	Noun	plexus m (uncountable)
pi	Noun	pi m (plural pi)
wrap	Noun	wrap m (plural wraps)
tutti	Noun	tutti m (plural tutti)
balsas	Noun	balsas m
baie	Noun	baie f (plural baies)
baie	Noun	baie f (plural baies)
baie	Noun	baie f (plural baies)
ders	Noun	ders
varan	Noun	varan m (plural varans)
balle	Noun	balle f (plural balles)
balle	Noun	balle f (plural balles)
balle	Noun	balle f (uncountable)
devin	Noun	devin m (plural devins, feminine devineresse)
vomer	Noun	vomer m (plural vomers)
trots	Noun	trots m
sentence	Noun	sentence f (plural sentences)
droit	Noun	droit m (plural droits)
lie	Noun	lie f (plural lies)
vortex	Noun	vortex m (uncountable)
gascon	Noun	gascon m (uncountable)
gland	Noun	gland m (plural glands)
persienne	Noun	persienne f (plural persiennes)
lichen	Noun	lichen m (plural lichens)
trader	Noun	trader m (plural traders)
lame	Noun	lame f (plural lames)
jungle	Noun	jungle f (plural jungles)
cicatrice	Noun	cicatrice f (plural cicatrices)
blastula	Noun	blastula f (plural blastulas)
alligator	Noun	alligator m (plural alligators)
zone	Noun	zone f (plural zones)
paparazzi	Noun	paparazzi m (plural paparazzis)
piercing	Noun	piercing m (plural piercings)
cession	Noun	cession f (plural cessions)
tuile	Noun	tuile f (plural tuiles)
intro	Noun	intro f (plural intros)
andante	Noun	andante m (plural andantes)
kaon	Noun	kaon m (plural kaons)
café au lait	Noun	café au lait m (plural cafés au lait)
sexologie	Noun	sexologie f (uncountable)
Big Mac	Noun	Big Mac m (plural Big Macs)
cois	Noun	cois m pl
judoka	Noun	judoka m, f (plural judokas)
oblat	Noun	oblat m (plural oblats, feminine oblate)
saule	Noun	saule m (plural saules)
avenue	Noun	avenue f (plural avenues)
háček	Noun	háček m (plural háčeks)
system	Noun	system m (plural systems)
roc	Noun	roc m (plural rocs)
fange	Noun	fange f (plural fanges)
info	Noun	info f (plural infos)
yakuza	Noun	yakuza m (plural yakuzas)
calcaire	Noun	calcaire m (plural calcaires)
centriste	Noun	centriste m, f (plural centristes)
sçavoir	Noun	sçavoir m (plural sçavoirs)
apens	Noun	apens m (plural apens)
vif	Noun	vif m (plural vifs)
ride	Noun	ride f (plural rides)
los	Noun	los m (plural los)
calcium	Noun	calcium m (uncountable)
paprika	Noun	paprika m (plural paprikas)
carne	Noun	carne f (plural carnes)
carne	Noun	carne f (plural carnes)
uranium	Noun	uranium m (uncountable)
kebab	Noun	kebab m (plural kebabs)
aras	Noun	aras ?
hamac	Noun	hamac m (plural hamacs)
terrier	Noun	terrier m (plural terriers)
mixer	Noun	mixer m (plural mixers)
base	Noun	base f (plural bases)
barre	Noun	barre f (plural barres)
sana	Noun	sana m (plural sanas)
coach	Noun	coach m (plural coachs)
magnolia	Noun	magnolia m (plural magnolias)
cors	Noun	cors m (plural cors)
cors	Noun	cors m
supernova	Noun	supernova f (plural supernovae)
barn	Noun	barn m (plural barns)
tag	Noun	tag m (plural tags)
autorisation	Noun	autorisation f (plural autorisations)
serin	Noun	serin m (plural serins)
mission	Noun	mission f (plural missions)
ministre	Noun	ministre m, f (plural ministres)
corp	Noun	corp m (plural corps)
pan	Noun	pan m (plural pans)
oromo	Noun	oromo m (uncountable)
charme	Noun	charme m (plural charmes)
charme	Noun	charme m (plural charmes)
colonel	Noun	colonel m (plural colonels)
niqab	Noun	niqab f (plural niqabs)
bec	Noun	bec m (plural becs)
copyright	Noun	copyright m (plural copyrights)
curling	Noun	curling m (uncountable)
jurat	Noun	jurat m (plural jurats)
indien	Noun	indien m (plural indiens, feminine indienne)
florentin	Noun	florentin m (plural florentins)
pas	Noun	pas m (plural pas)
mons	Noun	mons m
caille	Noun	caille f (plural cailles)
limon	Noun	limon m (plural limons)
limon	Noun	limon m (plural limons)
limon	Noun	limon m (plural limons)
baobab	Noun	baobab m (plural baobabs)
nihilisme	Noun	nihilisme m (plural nihilismes)
interlingua	Noun	interlingua f (uncountable)
clown	Noun	clown m (plural clowns)
cé	Noun	cé m (plural cés)
cancan	Noun	cancan m (plural cancans)
psi	Noun	psi m (plural psi)
lithium	Noun	lithium m (uncountable)
panca	Noun	panca m (plural pancas)
holmium	Noun	holmium m (uncountable)
ire	Noun	ire f (plural ires)
zirconium	Noun	zirconium m (uncountable)
match	Noun	match m (plural matches or matchs)
business	Noun	business m (plural business)
impala	Noun	impala m (plural impalas)
examen	Noun	examen m (plural examens)
mucus	Noun	mucus m (uncountable)
processus	Noun	processus m (plural processus)
house	Noun	house f (uncountable)
boom	Noun	boom m (plural booms)
origine	Noun	origine f (plural origines)
cortex	Noun	cortex m (uncountable)
banjo	Noun	banjo m (plural banjos)
circuit	Noun	circuit m (plural circuits)
parc	Noun	parc m (plural parcs)
but	Noun	but m (plural buts)
sumo	Noun	sumo m (plural sumos)
partiel	Noun	partiel m (plural partiels)
lente	Noun	lente f (plural lentes)
bras	Noun	bras m (plural bras)
banne	Noun	banne f (plural bannes)
dynastes	Noun	dynastes m
braise	Noun	braise f (plural braises)
eau de Cologne	Noun	eau de Cologne f (plural eaux de Cologne)
design	Noun	design m (plural designs)
swahili	Noun	swahili m (uncountable)
gadolinium	Noun	gadolinium m (uncountable)
butanol	Noun	butanol m (plural butanols)
slip	Noun	slip m (plural slips)
pacha	Noun	pacha m (plural pachas)
abandon	Noun	abandon m (plural abandons)
mole	Noun	mole f (plural moles)
gangster	Noun	gangster m (plural gangsters)
striptease	Noun	striptease m (plural stripteases)
klingon	Noun	klingon m (uncountable)
pendant	Noun	pendant m (plural pendants)
amas	Noun	amas m (plural amas)
ressource	Noun	ressource f (plural ressources)
establishment	Noun	establishment m (plural establishments)
glamour	Noun	glamour m (uncountable)
loisir	Noun	loisir m (plural loisirs)
full	Noun	full m (plural fulls)
hortensia	Noun	hortensia m (plural hortensias)
toast	Noun	toast m (plural toasts)
veste	Noun	veste f (plural vestes)
tampon	Noun	tampon m (plural tampons)
pus	Noun	pus m (plural pus)
bavarois	Noun	bavarois m (plural bavarois)
oscillation	Noun	oscillation f (plural oscillations)
diaspora	Noun	diaspora f (plural diasporas)
avion	Noun	avion m (plural avions)
parking	Noun	parking m (plural parkings)
flets	Noun	flets m
sofa	Noun	sofa m (plural sofas)
brisant	Noun	brisant m (plural brisants)
DVD	Noun	DVD m (plural DVD)
bock	Noun	bock m (plural bocks)
rubidium	Noun	rubidium m (uncountable)
almanach	Noun	almanach m (plural almanachs)
pale	Noun	pale f (plural pales)
tapirs	Noun	tapirs ?
phi	Noun	phi m (plural phi)
second	Noun	second m (plural seconds)
capital	Noun	capital m (plural capitaux)
embargo	Noun	embargo m (plural embargos)
soda	Noun	soda m (plural sodas)
beatnik	Noun	beatnik m, f (plural beatniks)
bus	Noun	bus m, f (plural bus)
baby	Noun	baby m (plural babys)
panel	Noun	panel m (plural panels)
vanadium	Noun	vanadium m (uncountable)
osmium	Noun	osmium m (uncountable)
ratio	Noun	ratio m (plural ratios)
laite	Noun	laite f (plural laites)
ensemble	Noun	ensemble m (plural ensembles)
microbiologie	Noun	microbiologie f (uncountable)
diesel	Noun	diesel m (plural diesels)
fille	Noun	fille f (plural filles)
front	Noun	front m (plural fronts)
spam	Noun	spam m (plural spams)
bull	Noun	bull m (plural bulls)
saint	Noun	saint m (plural saints, feminine sainte)
baseball	Noun	baseball m (uncountable)
thorax	Noun	thorax m (plural thorax)
anion	Noun	anion m (plural anions)
zob	Noun	zob m (plural zobs)
miles	Noun	miles ?
fix	Noun	fix m (plural fix)
crawl	Noun	crawl m (plural crawls)
transport	Noun	transport m (plural transports)
radian	Noun	radian m (plural radians)
gamma	Noun	gamma m (plural gamma)
monuments	Noun	monuments m
email	Noun	email m (plural emails)
appel	Noun	appel m (plural appels)
pollen	Noun	pollen m (plural pollens)
veto	Noun	veto m (plural vetos)
veto	Noun	veto m (plural vetos)
goûter	Noun	goûter m (plural goûters)
tettes	Noun	tettes f
face	Noun	face f (plural faces)
ménager	Noun	ménager m (plural ménagers, feminine ménagère)
cu	Noun	cu m (plural cus)
aga	Noun	aga m (plural agas)
talon	Noun	talon m (plural talons)
ultra	Noun	ultra m, f (plural ultras)
templier	Noun	templier m (plural templiers)
duetto	Noun	duetto m (plural duettos)
lés	Noun	lés m
coma	Noun	coma m (plural comas)
fondue	Noun	fondue f (plural fondues)
party	Noun	party m, f (plural parties or partys)
pensum	Noun	pensum m (plural pensums)
matador	Noun	matador m (plural matadors)
alibi	Noun	alibi m (plural alibis)
tabac	Noun	tabac m (plural tabacs)
tabac	Noun	tabac m (plural tabacs)
flet	Noun	flet m (plural flets)
indium	Noun	indium m (uncountable)
envis	Noun	envis ?
erg	Noun	erg m (plural ergs)
erg	Noun	erg m (plural ergs)
vits	Noun	vits m
sodas	Noun	sodas pl
hip-hop	Noun	hip-hop m (uncountable)
schéma	Noun	schéma m (plural schémas)
agent	Noun	agent m (plural agents)
plante	Noun	plante f (plural plantes)
chum	Noun	chum m (plural chums)
pizzeria	Noun	pizzeria f (plural pizzerias)
fart	Noun	fart m (plural farts)
modem	Noun	modem m (plural modems)
anglican	Noun	anglican m (plural anglicans, feminine anglicane)
scout	Noun	scout m (plural scouts)
synapse	Noun	synapse f (plural synapses)
mayonnaise	Noun	mayonnaise f (plural mayonnaises)
bingo	Noun	bingo m (plural bingos)
univers	Noun	univers m (plural univers)
tutu	Noun	tutu m (plural tutus)
pin	Noun	pin m (plural pins)
rap	Noun	rap m (uncountable)
distance	Noun	distance f (plural distances)
oral	Noun	oral m (plural oraux)
cale	Noun	cale f (plural cales)
cale	Noun	cale f (plural cales)
tiers	Noun	tiers m (plural tiers)
happening	Noun	happening m (plural happenings)
revers	Noun	revers m (plural revers)
cédé	Noun	cédé m (plural cédés)
gras	Noun	gras m (plural gras)
alysson	Noun	alysson m (plural alyssons)
magenta	Noun	magenta m (uncountable)
mambo	Noun	mambo m (plural mambos)
score	Noun	score m (plural scores)
vair	Noun	vair m (plural vairs)
Latin	Noun	Latin m (plural Latins)
taenia	Noun	taenia f (plural taenias)
mentor	Noun	mentor m (plural mentors)
bermuda	Noun	bermuda m (plural bermudas)
journal	Noun	journal m (plural journaux)
ras	Noun	ras m (plural ras)
mars	Noun	mars m (plural mars)
rhodium	Noun	rhodium m (uncountable)
plancher	Noun	plancher m (plural planchers)
pont	Noun	pont m (plural ponts)
thorium	Noun	thorium m (uncountable)
summum	Noun	summum m (plural summums)
o	Noun	o m (plural os)
das	Noun	das m (uncountable)
aile	Noun	aile f (plural ailes)
post	Noun	post m (plural posts)
braire	Noun	braire m (plural braires)
rune	Noun	rune f (plural runes)
antilope	Noun	antilope m (plural antilopes)
aréna	Noun	aréna m (plural arénas)
bob	Noun	bob m (plural bobs)
pittoresque	Noun	pittoresque m, f (plural pittoresques)
squash	Noun	squash m (plural squashs)
tempe	Noun	tempe f (plural tempes)
bars	Noun	bars m
substrat	Noun	substrat m (plural substrats)
set	Noun	set m (plural sets)
bonde	Noun	bonde f (plural bondes)
camping	Noun	camping m (plural campings)
mongol	Noun	mongol m (uncountable)
citron	Noun	citron m (plural citrons)
fine	Noun	fine f (plural fines)
symposium	Noun	symposium m (plural symposiums)
centime	Noun	centime m (plural centimes)
kamikaze	Noun	kamikaze m, f (plural kamikazes)
balanites	Noun	balanites f
balanites	Noun	balanites m
fort	Noun	fort m (plural forts)
clé	Noun	clé f (plural clés)
té	Noun	té m (plural tés)
zemstvo	Noun	zemstvo m (plural zemstvos)
trot	Noun	trot m (plural trots)
multimédia	Noun	multimédia m (plural multimédias)
bomber	Noun	bomber m (plural bombers)
anatomie	Noun	anatomie f (plural anatomies)
kir	Noun	kir m (plural kirs)
porno	Noun	porno m (plural pornos)
fiche	Noun	fiche f (plural fiches)
hafnium	Noun	hafnium m (uncountable)
praesidium	Noun	praesidium m (plural praesidiums)
vin	Noun	vin m (plural vins)
une	Noun	une f (plural unes)
guigner	Noun	guigner m (plural guigners)
lawrencium	Noun	lawrencium m (plural lawrenciums)
sage	Noun	sage m, f (plural sages)
brochure	Noun	brochure f (plural brochures)
myriade	Noun	myriade f (plural myriades)
segment	Noun	segment m (plural segments)
triton	Noun	triton m (plural tritons)
terminus	Noun	terminus m (uncountable)
dealer	Noun	dealer m (plural dealers, feminine dealeuse)
lampion	Noun	lampion m (plural lampions)
conseiller	Noun	conseiller m (plural conseillers, feminine conseillère)
macaron	Noun	macaron m (plural macarons)
anusvara	Noun	anusvara m (plural anusvaras)
apiol	Noun	apiol m (plural apiols)
menuet	Noun	menuet m (plural menuets)
esti	Noun	esti f (plural estis)
rayon	Noun	rayon m (plural rayons)
rayon	Noun	rayon m (plural rayons)
internet	Noun	internet m (plural internets)
cérium	Noun	cérium m (uncountable)
si	Noun	si m (plural si)
getter	Noun	getter m (plural getters)
gant	Noun	gant m (plural gants)
institut	Noun	institut m (plural instituts)
taxi	Noun	taxi m (plural taxis)
kaolin	Noun	kaolin m (plural kaolins)
dom	Noun	dom m (plural doms)
guirlande	Noun	guirlande f (plural guirlandes)
cocktail	Noun	cocktail m (plural cocktails)
angora	Noun	angora m (plural angora)
pub	Noun	pub f (plural pubs)
pub	Noun	pub m (plural pubs)
amaryllis	Noun	amaryllis m (plural amaryllis)
cap	Noun	cap m (plural caps)
milan	Noun	milan m (plural milans)
trappe	Noun	trappe f (plural trappes)
brigadier	Noun	brigadier m (plural brigadiers, feminine brigadière)
bistro	Noun	bistro m (plural bistros)
boum	Noun	boum f (plural boums)
coroner	Noun	coroner m (plural coroners)
vinaigrette	Noun	vinaigrette f (plural vinaigrettes)
madame	Noun	madame f (plural mesdames)
protes	Noun	protes m
relief	Noun	relief m (plural reliefs)
dot	Noun	dot f (plural dots)
visio	Noun	visio f (plural visios)
stop	Noun	stop m (uncountable)
station	Noun	station f (plural stations)
roller	Noun	roller m (plural rollers)
globe	Noun	globe m (plural globes)
ile	Noun	ile f (plural iles)
gaur	Noun	gaur m (plural gaurs)
flans	Noun	flans m
van	Noun	van m (plural vans)
taro	Noun	taro m (plural taros)
fade	Noun	fade m (plural fades)
tif	Noun	tif m (plural tifs)
tennis	Noun	tennis m (plural tennis)
jersey	Noun	jersey m (plural jerseys)
western	Noun	western m (plural westerns)
magasin	Noun	magasin m (plural magasins)
incident	Noun	incident m (plural incidents)
cantinier	Noun	cantinier m (plural cantiniers, feminine cantinière)
avocat	Noun	avocat m (plural avocats)
avocat	Noun	avocat m (plural avocats)
scandium	Noun	scandium m (uncountable)
alto	Noun	alto m (plural altos)
genre	Noun	genre m (plural genres)
baby-sitter	Noun	baby-sitter f (plural baby-sitters)
maestro	Noun	maestro m (plural maestros)
gouda	Noun	gouda m (plural goudas)
part	Noun	part f (plural parts)
part	Noun	part m (plural parts)
lin	Noun	lin m (plural lins)
misandrie	Noun	misandrie f (plural misandries)
lamantin	Noun	lamantin m (plural lamantins)
aster	Noun	aster m (plural asters)
bon	Noun	bon m (plural bons)
tweed	Noun	tweed m (uncountable)
duplex	Noun	duplex m (plural duplex)
chorus	Noun	chorus m (uncountable)
nymphe	Noun	nymphe f (plural nymphes)
pige	Noun	pige f (plural piges)
pourparler	Noun	pourparler m (plural pourparlers)
condominium	Noun	condominium m (plural condominiums)
retsina	Noun	retsina m (plural retsinas)
einsteinium	Noun	einsteinium m (uncountable)
franchise	Noun	franchise f (plural franchises)
chips	Noun	chips f, m, m pl (plural only)
bloc	Noun	bloc m (plural blocs)
coupé	Noun	coupé m (plural coupés)
porter	Noun	porter m (plural porters)
quiz	Noun	quiz m (uncountable)
gruyère	Noun	gruyère m (usually uncountable, plural gruyères)
driver	Noun	driver m (plural drivers)
analogie	Noun	analogie f (plural analogies)
bard	Noun	bard m (plural bards)
rire	Noun	rire m (plural rires)
sortir	Noun	sortir m (plural sortirs)
pandeiro	Noun	pandeiro m (plural pandeiros)
moles	Noun	moles f
immigrant	Noun	immigrant m (plural immigrants)
pilier	Noun	pilier m (plural piliers)
portion	Noun	portion f (plural portions)
koppa	Noun	koppa m (plural koppa or koppas)
frisbee	Noun	frisbee m (plural frisbees)
internat	Noun	internat m (plural internats)
zobs	Noun	zobs m
præstation	Noun	præstation f (plural præstations)
opuntia	Noun	opuntia m (plural opuntias)
raclette	Noun	raclette f (plural raclettes)
raclette	Noun	raclette m (plural raclettes)
divan	Noun	divan m (plural divans)
kidnapping	Noun	kidnapping m (plural kidnappings)
zombi	Noun	zombi m (plural zombis, feminine zombie)
pistolet	Noun	pistolet m (plural pistolets)
tesla	Noun	tesla m (plural teslas)
parfait	Noun	parfait m (plural parfaits)
reggae	Noun	reggae m (plural reggaes)
us	Noun	us m pl (plural only)
albinos	Noun	albinos m, f (plural albinos)
baryon	Noun	baryon m (plural baryons)
viol	Noun	viol m (plural viols)
lut	Noun	lut m (plural luts)
tapir	Noun	tapir m (plural tapirs)
intervention	Noun	intervention f (plural interventions)
vers	Noun	vers m (plural vers)
vers	Noun	vers m
licence	Noun	licence f (plural licences)
purée	Noun	purée f (plural purées)
bogey	Noun	bogey m (plural bogeys)
standing	Noun	standing m (plural standings)
Franc	Noun	Franc m (plural Francs, feminine Franque)
toxico	Noun	toxico m, f (plural toxicos)
aidant	Noun	aidant m (plural aidants, feminine aidante)
talisman	Noun	talisman m (plural talismans)
cime	Noun	cime f (plural cimes)
cabriolet	Noun	cabriolet m (plural cabriolets)
apartheid	Noun	apartheid m (plural apartheid)
nem	Noun	nem m (plural nems)
weekend	Noun	weekend m (plural weekends)
CD	Noun	CD m (plural CD)
vaccin	Noun	vaccin m (plural vaccins)
cormoran	Noun	cormoran m (plural cormorans)
tagalog	Noun	tagalog m (uncountable)
mont	Noun	mont m (plural monts)
chihuahua	Noun	chihuahua m (plural chihuahuas)
massage	Noun	massage m (plural massages)
sorcier	Noun	sorcier m (plural sorciers, feminine sorcière)
alcohol	Noun	alcohol m (plural alcohols)
art	Noun	art m (plural arts)
sultan	Noun	sultan m (plural sultans)
lama	Noun	lama m (plural lamas)
lama	Noun	lama m (plural lamas)
port	Noun	port m (plural ports)
port	Noun	port m (plural ports)
persan	Noun	persan m (countable and uncountable, plural persans)
radius	Noun	radius m (plural radius)
nobélium	Noun	nobélium m (plural nobéliums)
mie	Noun	mie f (plural mies)
mie	Noun	mie f (plural mies)
trauma	Noun	trauma m (plural traumas)
denier	Noun	denier m (plural deniers)
nasse	Noun	nasse f (plural nasses)
mur	Noun	mur m (plural murs)
angor	Noun	angor m (uncountable)
baissier	Noun	baissier m (plural baissiers, feminine baissière)
abonnement	Noun	abonnement m (plural abonnements)
fragon	Noun	fragon m (plural fragons)
villa	Noun	villa f (plural villas)
galon	Noun	galon m (plural galons)
pipi	Noun	pipi m (uncountable)
nul	Noun	nul m (plural nuls)
parler	Noun	parler m (plural parlers)
anis	Noun	anis m (plural anis)
noyer	Noun	noyer m (plural noyers)
brunch	Noun	brunch m (plural brunches)
lien	Noun	lien m (plural liens)
matrone	Noun	matrone f (plural matrones)
supporter	Noun	supporter m (plural supporters)
union	Noun	union f (plural unions)
import	Noun	import m (plural imports)
boa	Noun	boa m (plural boas)
pelle	Noun	pelle f (plural pelles)
iPhone	Noun	iPhone m (plural iPhones)
newton	Noun	newton m (plural newtons)
golf	Noun	golf m (plural golf)
manifestation	Noun	manifestation f (plural manifestations)
finale	Noun	finale f (plural finales)
bucher	Noun	bucher m (plural buchers)
domino	Noun	domino m (plural dominos)
candela	Noun	candela f (plural candelas)
couscous	Noun	couscous m (plural couscous)
mannequin	Noun	mannequin m (plural mannequins)
remake	Noun	remake m (plural remakes)
brune	Noun	brune f (plural brunes)
calva	Noun	calva m (plural calvas)
monument	Noun	monument m (plural monuments)
do	Noun	do m (plural do)
selve	Noun	selve f (plural selves)
benne	Noun	benne f (plural bennes)
lolo	Noun	lolo m (plural lolos)
Afghane	Noun	Afghane f (plural Afghanes)
macho	Noun	macho m (plural machos)
codex	Noun	codex m (plural codex)
patriarches	Noun	patriarches m
carte	Noun	carte f (plural cartes)
hacker	Noun	hacker m (plural hackers)
rein	Noun	rein m (plural reins)
race	Noun	race f (plural races)
social	Noun	social m (plural sociaux)
tante	Noun	tante f (plural tantes)
samarium	Noun	samarium m (uncountable)
pion	Noun	pion m (plural pions)
pion	Noun	pion m (plural pions, feminine pionne)
radio	Noun	radio f (plural radios)
translation	Noun	translation f (plural translations)
albatros	Noun	albatros m (plural albatros)
whisky	Noun	whisky m (plural whiskies or whiskys)
basket	Noun	basket m (plural basket)
basket	Noun	basket f (plural baskets)
bain	Noun	bain m (plural bains)
magot	Noun	magot m (plural magots)
chaos	Noun	chaos m (uncountable)
tigre	Noun	tigre m (plural tigres, feminine tigresse)
puma	Noun	puma m (plural pumas)
hie	Noun	hie f (plural hies)
hiatus	Noun	hiatus m (plural hiatus)
wagon	Noun	wagon m (plural wagons)
sampi	Noun	sampi m (plural sampi)
laps	Noun	laps m (plural laps)
zest	Noun	zest m (plural zests)
auto-stop	Noun	auto-stop m (uncountable)
abbé	Noun	abbé m (plural abbés, feminine abbesse)
banc	Noun	banc m (plural bancs)
bombe	Noun	bombe f (plural bombes)
alien	Noun	alien m (plural aliens)
hic	Noun	hic m (uncountable)
picolo	Noun	picolo m (plural picolos)
chateaubriand	Noun	chateaubriand m (plural chateaubriands)
potentat	Noun	potentat m (plural potentats)
avatar	Noun	avatar m (plural avatars)
milliard	Noun	milliard m (plural milliards)
vé	Noun	vé m (plural vés)
vé	Noun	vé m (plural vés)
poli	Noun	poli m (plural polis)
nylon	Noun	nylon m (plural nylons)
fellatio	Noun	fellatio f (uncountable)
kappa	Noun	kappa m (plural kappa)
bowling	Noun	bowling m (plural bowlings)
lai	Noun	lai m (plural lais)
ji	Noun	ji m (plural jis)
terbium	Noun	terbium m (uncountable)
mangrove	Noun	mangrove f (plural mangroves)
broc	Noun	broc m (plural brocs)
rente	Noun	rente f (plural rentes)
ban	Noun	ban m (plural bans)
ban	Noun	ban m (plural bans)
esplanade	Noun	esplanade f (plural esplanades)
open	Noun	open m (plural opens)
bey	Noun	bey m (plural beys)
note	Noun	note f (plural notes)
ambigu	Noun	ambigu m (plural ambigus)
champignon	Noun	champignon m (plural champignons)
abdomen	Noun	abdomen m (plural abdomens)
leu	Noun	leu m (plural lei)
continent	Noun	continent m (plural continents)
bog	Noun	bog m (plural bogs)
boxer	Noun	boxer m (plural boxers)
casting	Noun	casting m (plural castings)
nova	Noun	nova f (plural novas or novae or novæ)
toucher	Noun	toucher m (plural touchers)
pantalon	Noun	pantalon m (plural pantalons)
mas	Noun	mas m (plural mas)
gamer	Noun	gamer m (plural gamers)
ocelot	Noun	ocelot m (plural ocelots)
malle	Noun	malle f (plural malles)
more	Noun	more f (plural mores)
brumaire	Noun	brumaire m (plural brumaires)
stud	Noun	stud m (plural studs)
virus	Noun	virus m (plural virus)
cheddar	Noun	cheddar m (plural cheddars)
loch	Noun	loch m (plural lochs)
loch	Noun	loch m (plural lochs)
navajo	Noun	navajo m (uncountable)
kelvins	Noun	kelvins m
delta	Noun	delta m (plural delta or deltas)
delta	Noun	delta m (plural deltas)
brancardier	Noun	brancardier m (plural brancardiers, feminine brancardière)
drop	Noun	drop m (plural drops)
fin	Noun	fin f (plural fins)
magnat	Noun	magnat m (plural magnats)
val	Noun	val m (plural vaux)
damma	Noun	damma m, f (plural dammas)
trames	Noun	trames f
hockey	Noun	hockey m (uncountable)
pull	Noun	pull m (plural pulls)
niobium	Noun	niobium m (uncountable)
pet	Noun	pet m (plural pets)
rotation	Noun	rotation f (plural rotations)
tanga	Noun	tanga m (plural tangas)
sauvage	Noun	sauvage m (plural sauvages, feminine sauvagesse)
blatte	Noun	blatte f (plural blattes)
suc	Noun	suc m (plural sucs)
arme	Noun	arme f (plural armes)
althaea	Noun	althaea m (plural althaeas)
hassium	Noun	hassium m (plural hassiums)
doge	Noun	doge m (plural doges)
kawa	Noun	kawa m (uncountable)
ångström	Noun	ångström m (plural ångströms)
pot	Noun	pot m (plural pots)
dîner	Noun	dîner m (plural dîners)
caris	Noun	caris ?
sexisme	Noun	sexisme m (plural sexismes)
flan	Noun	flan m (plural flans)
pis	Noun	pis m (plural pis)
béal	Noun	béal m (plural béals)
parapet	Noun	parapet m (plural parapets)
seta	Noun	seta f (plural setæ)
cham	Noun	cham m (plural chams)
matcha	Noun	matcha m (uncountable)
pollens	Noun	pollens ?
devoir	Noun	devoir m (plural devoirs)
alderman	Noun	alderman m (plural aldermans)
parfum	Noun	parfum m (plural parfums)
point	Noun	point m (plural points)
sodomie	Noun	sodomie f (plural sodomies)
dans	Noun	dans m
rus	Noun	rus m
stock	Noun	stock m (plural stocks)
ytterbium	Noun	ytterbium m (uncountable)
iPod	Noun	iPod m (plural iPods)
fulani	Noun	fulani m (uncountable)
samba	Noun	samba m (plural sambas)
ko	Noun	ko m (plural ko)
gemme	Noun	gemme f (plural gemmes)
hile	Noun	hile m (plural hiles)
Arabes	Noun	Arabes m, f
colon	Noun	colon m (plural colons)
colon	Noun	colon
pornos	Noun	pornos ?
soft	Noun	soft m (plural softs)
sens	Noun	sens m (plural sens)
croche	Noun	croche f (plural croches)
panorama	Noun	panorama m (plural panoramas)
gosse	Noun	gosse m, f (plural gosses)
gosse	Noun	gosse f (plural gosses)
radier	Noun	radier m (plural radiers)
scrotum	Noun	scrotum m (plural scrotums)
immigrans	Noun	immigrans m
europium	Noun	europium m (uncountable)
torero	Noun	torero m (plural toreros)
skate	Noun	skate m (plural skates)
show	Noun	show m (plural shows)
magnum	Noun	magnum m (plural magnums)
forestier	Noun	forestier m (plural forestiers, feminine forestière)
coccyx	Noun	coccyx m (plural coccyx)
temps	Noun	temps m (plural temps)
ombudsman	Noun	ombudsman m, f (plural ombudsmans)
pompier	Noun	pompier m (plural pompiers)
magie	Noun	magie f (plural magies)
tandem	Noun	tandem m (plural tandems)
sinciput	Noun	sinciput m (plural sinciputs)
mer	Noun	mer f (plural mers)
rapport	Noun	rapport m (plural rapports)
elle	Noun	elle m (plural elles)
soldat	Noun	soldat m (plural soldats)
beignet	Noun	beignet m (plural beignets)
volapük	Noun	volapük m (uncountable)
motion	Noun	motion f (plural motions)
hymne	Noun	hymne m (plural hymnes)
boombox	Noun	boombox m (plural boomboxes)
radians	Noun	radians m
hypnose	Noun	hypnose f (plural hypnoses)
adoption	Noun	adoption f (plural adoptions)
dogme	Noun	dogme m (plural dogmes)
pack	Noun	pack m (plural packs)
petit	Noun	petit m (plural petits, feminine petite)
immigration	Noun	immigration f (plural immigrations)
signal	Noun	signal m (plural signaux)
foc	Noun	foc m (plural focs)
lé	Noun	lé m (plural lés)
glus	Noun	glus f
vanne	Noun	vanne f (plural vannes)
mameluk	Noun	mameluk m (plural mameluks)
Kurde	Noun	Kurde m, f (plural Kurdes)
pharynx	Noun	pharynx m (uncountable)
lagune	Noun	lagune f (plural lagunes)
majorat	Noun	majorat m (plural majorats)
mire	Noun	mire f (plural mires)
laine	Noun	laine f (plural laines)
estragon	Noun	estragon m (plural estragons)
quadra	Noun	quadra m, f (plural quadras)
joker	Noun	joker m (plural jokers)
manoir	Noun	manoir m (plural manoirs)
ambulance	Noun	ambulance f (plural ambulances)
gouter	Noun	gouter m (plural gouters)
coca	Noun	coca m (plural cocas)
coca	Noun	coca m (plural cocas)
adresse	Noun	adresse f (plural adresses)
histologie	Noun	histologie f (plural histologies)
jeep	Noun	jeep f (plural jeeps)
toit	Noun	toit m (plural toits)
effigies	Noun	effigies f
dico	Noun	dico m (plural dicos)
volt	Noun	volt m (plural volts)
patron	Noun	patron m (plural patrons)
boo	Noun	boo m (uncountable)
jan	Noun	jan m (plural jans)
dupe	Noun	dupe f (plural dupes)
auto	Noun	auto f (plural autos)
aspi	Noun	aspi m (plural aspis)
aspi	Noun	aspi m (plural aspis)
melon	Noun	melon m (plural melons)
jackpot	Noun	jackpot m (plural jackpots)
cam	Noun	cam f (plural cams)
simili	Noun	simili m (uncountable)
magistrat	Noun	magistrat m (plural magistrats, feminine magistrate)
slips	Noun	slips m
fumana	Noun	fumana m (plural fumanas)
reportage	Noun	reportage m (plural reportages)
rime	Noun	rime f (plural rimes)
bikini	Noun	bikini m (plural bikinis)
ping-pong	Noun	ping-pong m (uncountable)
pointer	Noun	pointer m (plural pointers)
sang	Noun	sang m (plural sangs)
ironie	Noun	ironie f (plural ironies)
nickel	Noun	nickel m (countable and uncountable, plural nickels)
bit	Noun	bit m (plural bits)
spot	Noun	spot m (plural spots)
bengali	Noun	bengali m (uncountable)
baklava	Noun	baklava m (plural baklavas)
kaki	Noun	kaki m (plural kakis)
kaki	Noun	kaki m, f (plural kakis)
sonde	Noun	sonde f (plural sondes)
sein	Noun	sein m (plural seins)
sourire	Noun	sourire m (plural sourires)
satire	Noun	satire f (plural satires)
mat	Noun	mat m (plural mats)
stapes	Noun	stapes m (plural stapes)
auditorium	Noun	auditorium m (plural auditoriums)
hashtag	Noun	hashtag m (plural hashtags)
tribus	Noun	tribus f
frac	Noun	frac m (plural fracs)
paranoïde	Noun	paranoïde m, f (plural paranoïdes)
an	Noun	an m (plural ans)
franc	Noun	franc m (plural francs)
prose	Noun	prose f (plural proses)
rotin	Noun	rotin m (plural rotins)
lidar	Noun	lidar m (plural lidars)
breaker	Noun	breaker m (plural breakers)
modal	Noun	modal m (plural modaux)
alun	Noun	alun m (plural aluns)
ver	Noun	ver m (plural vers)
berkélium	Noun	berkélium m (uncountable)
consensus	Noun	consensus m (plural consensus)
eider	Noun	eider m (plural eiders)
dubnium	Noun	dubnium m (plural dubniums)
image	Noun	image f (plural images)
portfolio	Noun	portfolio m (plural portfolios)
total	Noun	total m (plural totaux)
tribun	Noun	tribun m (plural tribuns)
bayram	Noun	bayram m (plural bayrams)
æon	Noun	æon m (plural æons)
limes	Noun	limes f
mai	Noun	mai m (plural mais)
TV	Noun	TV f (plural TV)
fut	Noun	fut f (plural futs)
oranger	Noun	oranger m (plural orangers)
filet	Noun	filet m (plural filets)
filet	Noun	filet m (plural filets)
graf	Noun	graf m (plural grafs)
visa	Noun	visa m (plural visas)
biochimie	Noun	biochimie f (plural biochimies)
rose	Noun	rose f (plural roses)
rose	Noun	rose m (plural roses)
crooner	Noun	crooner m (plural crooners)
tuner	Noun	tuner m (plural tuners)
Anglois	Noun	Anglois m (plural Anglois, feminine Angloise)
alfa	Noun	alfa m (plural alfas)
thulium	Noun	thulium m (uncountable)
par	Noun	par m (plural pars)
logo	Noun	logo m (plural logos)
bille	Noun	bille f (plural billes)
bille	Noun	bille f (plural billes)
armada	Noun	armada f (plural armadas)
verso	Noun	verso m (plural versos)
exon	Noun	exon m (plural exons)
tenon	Noun	tenon m (plural tenons)
maximum	Noun	maximum m (plural maxima or maximums)
becquerel	Noun	becquerel m (plural becquerels)
handicap	Noun	handicap m (plural handicaps)
la	Noun	la m (plural la)
emmental	Noun	emmental m (plural emmentaux)
rudiment	Noun	rudiment m (plural rudiments)
mode	Noun	mode f (plural modes)
mode	Noun	mode m (plural modes)
nougat	Noun	nougat m (plural nougats)
cancer	Noun	cancer m (plural cancers)
bord	Noun	bord m (plural bords)
podcast	Noun	podcast m (plural podcasts)
condo	Noun	condo m (plural condos)
angelus	Noun	angelus m (plural angelus)
dessert	Noun	dessert m (plural desserts)
lins	Noun	lins ?
skunks	Noun	skunks m (plural skunks)
shorts	Noun	shorts m
extrapolation	Noun	extrapolation f (plural extrapolations)
sultanat	Noun	sultanat m (plural sultanats)
wiki	Noun	wiki m (plural wikis)
aller	Noun	aller m (plural allers)
beach	Noun	beach m (plural beachs)
camion	Noun	camion m (plural camions)
commando	Noun	commando m (plural commandos)
forum	Noun	forum m (plural forums)
jargon	Noun	jargon m (plural jargons)
jargon	Noun	jargon m (plural jargons)
sigma	Noun	sigma m (plural sigma)
age	Noun	age m (plural ages)
vomito	Noun	vomito m (plural vomitos)
rami	Noun	rami m (plural ramis)
citrons	Noun	citrons m
fa	Noun	fa m (plural fa)
synopsis	Noun	synopsis m, f (plural synopsis)
rat	Noun	rat m (plural rats)
arabica	Noun	arabica m (plural arabicas)
instant	Noun	instant m (plural instants)
californium	Noun	californium m (uncountable)
plastic	Noun	plastic m (plural plastics)
berle	Noun	berle f (plural berles)
break	Noun	break m (plural breaks)
break	Noun	break m, f (plural breaks)
jasmin	Noun	jasmin m (plural jasmins)
slave	Noun	slave m (uncountable)
pop	Noun	pop m (plural pop)
extra	Noun	extra m, f (plural extras)
brun	Noun	brun m (plural bruns, feminine brune)
balsa	Noun	balsa m (plural balsas)
gin	Noun	gin m (plural gins)
roman	Noun	roman m (plural romans)
rutherfordium	Noun	rutherfordium m (plural rutherfordiums)
avent	Noun	avent m (plural avents)
patio	Noun	patio m (plural patios)
ambition	Noun	ambition f (plural ambitions)
arsenal	Noun	arsenal m (plural arsenaux)
mage	Noun	mage m (plural mages)
agenda	Noun	agenda m (plural agendas)
vodka	Noun	vodka f (plural vodkas)
mec	Noun	mec m (plural mecs)
basin	Noun	basin m (plural basins)
erre	Noun	erre m (plural erres)
raton	Noun	raton m (plural ratons)
raton	Noun	raton m (plural ratons, feminine ratonne)
guarani	Noun	guarani m (plural guaranis)
bits	Noun	bits m
souvenir	Noun	souvenir m (plural souvenirs)
graff	Noun	graff m (plural graffs)
geindre	Noun	geindre m (plural geindres)
peloton	Noun	peloton m (plural pelotons)
triathlon	Noun	triathlon m (plural triathlons)
rot	Noun	rot m (plural rots)
jis	Noun	jis m
souper	Noun	souper m (plural soupers)
pif	Noun	pif m (plural pifs)
jus	Noun	jus m (plural jus)
rade	Noun	rade f (plural rades)
rade	Noun	rade m (plural rades)
rade	Noun	rade m (plural rades)
rade	Noun	rade m (uncountable)
aubergine	Noun	aubergine f (plural aubergines)
cowboy	Noun	cowboy m (plural cowboys)
situation	Noun	situation f (plural situations)
parole	Noun	parole f (plural paroles)
roentgenium	Noun	roentgenium m (plural roentgeniums)
mari	Noun	mari m (plural maris)
mari	Noun	mari f (plural maris)
astronome	Noun	astronome m, f (plural astronomes)
plumbago	Noun	plumbago m (plural plumbagos)
plate	Noun	plate f (plural plates)
lavabo	Noun	lavabo m (plural lavabos)
zucchini	Noun	zucchini m (plural zucchinis)
or	Noun	or m (plural ors)
rock	Noun	rock m (uncountable)
database	Noun	database f (plural databases)
passager	Noun	passager m (plural passagers, feminine passagère)
profit	Noun	profit m (plural profits)
sol	Noun	sol m (plural sols)
sol	Noun	sol m (plural sol)
sol	Noun	sol m (plural sols)
sol	Noun	sol m (plural sols)
logos	Noun	logos ?
civil	Noun	civil m (plural civils)
tank	Noun	tank m (plural tanks)
crocus	Noun	crocus m (plural crocus)
déjeuner	Noun	déjeuner m (plural déjeuners)
gallium	Noun	gallium m (uncountable)
rumen	Noun	rumen m (plural rumens)
vision	Noun	vision f (plural visions)
ganga	Noun	ganga m (plural gangas)
cuir	Noun	cuir m (plural cuirs)
truck	Noun	truck m (plural trucks)
bonus	Noun	bonus m (uncountable)
pagode	Noun	pagode f (plural pagodes)
baiser	Noun	baiser m (plural baisers)
syzygie	Noun	syzygie f (plural syzygies)
store	Noun	store m (plural stores)
absent	Noun	absent m (plural absents)
titan	Noun	titan m (plural titans)
plat	Noun	plat m (plural plats)
piton	Noun	piton m (plural pitons)
tata	Noun	tata f (plural tatas)
tata	Noun	tata m (plural tatas)
fitness	Noun	fitness m (uncountable)
maharadja	Noun	maharadja m (plural maharadjas)
python	Noun	python m (plural pythons)
far	Noun	far m (plural fars)
navigation	Noun	navigation f (plural navigations)
tau	Noun	tau m (plural tau)
pari	Noun	pari m (plural paris)
hindi	Noun	hindi m (uncountable)
imam	Noun	imam m, f (plural imams)
mu	Noun	mu m (plural mu)
lupanar	Noun	lupanar m (plural lupanars)
duel	Noun	duel m (plural duels)
monotonie	Noun	monotonie f (plural monotonies)
instruments	Noun	instruments m
atoll	Noun	atoll m (plural atolls)
biberon	Noun	biberon m (plural biberons)
dressing	Noun	dressing m (plural dressings)
jaguar	Noun	jaguar m, f (plural jaguars)
sel	Noun	sel m (plural sels)
morale	Noun	morale f (plural morales)
film	Noun	film m (plural films)
bled	Noun	bled m (plural bleds)
monoplan	Noun	monoplan m (plural monoplans)
jazz	Noun	jazz m (uncountable)
ris	Noun	ris m (plural ris)
ris	Noun	ris m (plural ris)
ris	Noun	ris m (plural ris)
tatar	Noun	tatar m (uncountable)
puzzle	Noun	puzzle m (plural puzzles)
favus	Noun	favus m (uncountable)
atrium	Noun	atrium m (plural atriums)
babyboom	Noun	babyboom m (plural babybooms)
nazir	Noun	nazir m (plural nazirs)
podia	Noun	podia m
abats	Noun	abats m pl (plural only)
bravo	Noun	bravo m (plural bravos)
habit	Noun	habit m (plural habits)
respect	Noun	respect m (plural respects)
dur	Noun	dur m (plural durs)
samovar	Noun	samovar m (plural samovars)
lire	Noun	lire f (plural lires)
hobby	Noun	hobby m (plural hobbies or hobbys)
don	Noun	don m (plural dons)
amens	Noun	amens m
tin	Noun	tin m (plural tins)
castor	Noun	castor m (plural castors)
lime	Noun	lime f (plural limes)
lime	Noun	lime f (plural limes)
vol	Noun	vol m (plural vols)
bigot	Noun	bigot m (plural bigots, feminine bigote)
pats	Noun	pats m
libido	Noun	libido f (usually uncountable, plural libidos)
superficies	Noun	superficies f
aventure	Noun	aventure f (plural aventures)
actinium	Noun	actinium m (uncountable)
ange	Noun	ange m (plural anges)
hard	Noun	hard m (plural hards)
turban	Noun	turban m (plural turbans)
quick	Noun	quick m (plural quicks)
courant	Noun	courant m (plural courants)
attentat	Noun	attentat m (plural attentats)
More	Noun	More m (plural Mores)
bungalow	Noun	bungalow m (plural bungalows)
ton	Noun	ton m (plural tons)
vis	Noun	vis f (plural vis)
destroyer	Noun	destroyer m (plural destroyers)
libertarianisme	Noun	libertarianisme m (uncountable)
gray	Noun	gray m (plural grays)
doigter	Noun	doigter m (plural doigters)
polenta	Noun	polenta f (plural polentas)
tore	Noun	tore m (plural tores)
bal	Noun	bal m (plural bals)
expert	Noun	expert m (plural experts, feminine experte)
glas	Noun	glas m (plural glas)
lapsus	Noun	lapsus m (plural lapsus)
boy	Noun	boy m (plural boys)
boss	Noun	boss m, f (plural boss or bosses)
gang	Noun	gang m (plural gangs)
lest	Noun	lest m (plural lests)
afar	Noun	afar m (uncountable)
turbine	Noun	turbine f (plural turbines)
homo	Noun	homo m, f (plural homos)
média	Noun	média m (plural médias)
neutrino	Noun	neutrino m (plural neutrinos)
manger	Noun	manger m (plural mangers)
orle	Noun	orle m (plural orles)
alisma	Noun	alisma f (plural alismas)
nauruan	Noun	nauruan m (uncountable)
brasserie	Noun	brasserie f (plural brasseries)
jet	Noun	jet m (plural jets)
Serbe	Noun	Serbe m, f (plural Serbes)
silicium	Noun	silicium m (plural siliciums)
lundi	Noun	lundi m (plural lundis)
terrasse	Noun	terrasse f (plural terrasses)
fil	Noun	fil m (plural fils)
marin	Noun	marin m (plural marins)
marin	Noun	marin f (plural marins)
gurus	Noun	gurus m
uzbek	Noun	uzbek m (uncountable)
za	Noun	za 
poker	Noun	poker m (plural pokers)
avens	Noun	avens
uni	Noun	uni f (plural unis)
curry	Noun	curry m (plural currys)
amis	Noun	amis m
tins	Noun	tins m
bocs	Noun	bocs ?
palus	Noun	palus ?
madeleine	Noun	madeleine f (plural madeleines)
kippa	Noun	kippa f (plural kippas)
radis	Noun	radis m (plural radis)
Mongol	Noun	Mongol m (plural Mongols, feminine Mongole)
galant	Noun	galant m (plural galants)
guignier	Noun	guignier m (plural guigniers)
pat	Noun	pat m (plural pats)
hamster	Noun	hamster m (plural hamsters)
billet	Noun	billet m (plural billets)
pyjamas	Noun	pyjamas m
site	Noun	site m (plural sites)
sponsor	Noun	sponsor m (plural sponsors)
kayak	Noun	kayak m (plural kayaks)
canon	Noun	canon m (plural canons)
canon	Noun	canon m (plural canons)
canon	Noun	canon m (plural canons)
pé	Noun	pé m (plural pés)
ut	Noun	ut m (plural ut)
pore	Noun	pore m (plural pores)
halo	Noun	halo m (plural halos)
civilisation	Noun	civilisation f (plural civilisations)
muffin	Noun	muffin m (plural muffins)
sérum	Noun	sérum m (plural sérums)
tweet	Noun	tweet m (plural tweets)
pascal	Noun	pascal m (plural pascaux)
paradis	Noun	paradis m (plural paradis)
emballage	Noun	emballage m (plural emballages)
ku	Noun	ku m (plural kus)
bambara	Noun	bambara m (uncountable)
idiot	Noun	idiot m (plural idiots, feminine idiote)
tain	Noun	tain m (plural tains)
rumba	Noun	rumba f (plural rumbas)
derby	Noun	derby m (plural derbys)
mile	Noun	mile m (plural miles)
coronis	Noun	coronis m (plural coronis)
coronis	Noun	coronis f (plural coronis)
secret	Noun	secret m (plural secrets)
hybris	Noun	hybris f (usually uncountable, plural hybris)
nectar	Noun	nectar m (plural nectars)
robots	Noun	robots m
Russe	Noun	Russe m, f (plural Russes)
cardiologie	Noun	cardiologie f (uncountable)
Orange	Noun	Orange
caca	Noun	caca m (plural cacas)
slalom	Noun	slalom m (plural slaloms)
minium	Noun	minium m (uncountable)
papi	Noun	papi m (plural papis)
ré	Noun	ré m (plural ré)
dhamma	Noun	dhamma m (usually uncountable, plural dhammas)
plus	Noun	plus m (plural plus)
balcon	Noun	balcon m (plural balcons)
azur	Noun	azur m (plural azurs)
fuchsia	Noun	fuchsia m (plural fuchsias)
pose	Noun	pose f (plural poses)
pose	Noun	pose m (plural poses)
kus	Noun	kus m
hase	Noun	hase f (plural hases)
lume	Noun	lume f (plural lumes)
ballon	Noun	ballon m (plural ballons)
mug	Noun	mug m (plural mugs)
rumex	Noun	rumex m (plural rumex)
dodo	Noun	dodo m (plural dodos)
dodo	Noun	dodo m (plural dodos)
Maure	Noun	Maure m, f (plural Maures)
autoradio	Noun	autoradio m (plural autoradios)
espalier	Noun	espalier m (plural espaliers)
VHS	Noun	VHS f (invariable)
patte	Noun	patte f (plural pattes)
sporange	Noun	sporange m (plural sporanges)
armagnac	Noun	armagnac m (plural armagnacs)
panne	Noun	panne f (plural pannes)
palladium	Noun	palladium m (uncountable)
zircon	Noun	zircon m (plural zircons)
caries	Noun	caries f
ring	Noun	ring m (plural rings)
galbanum	Noun	galbanum m (plural galbanums)
maori	Noun	maori m (plural maori, feminine maorie)
sports	Noun	sports m
aber	Noun	aber m (plural abers)
institution	Noun	institution f (plural institutions)
habitans	Noun	habitans m
ballet	Noun	ballet m (plural ballets)
mine	Noun	mine f (plural mines)
mine	Noun	mine f (plural mines)
telugu	Noun	telugu m (uncountable)
tarif	Noun	tarif m (plural tarifs)
alcool	Noun	alcool m (plural alcools)
marginal	Noun	marginal m (plural marginaux)
badminton	Noun	badminton m (uncountable)
mats	Noun	mats m
blanc	Noun	blanc m (plural blancs)
addition	Noun	addition f (plural additions)
opium	Noun	opium m (plural opiums)
vie	Noun	vie f (plural vies)
soul	Noun	soul f (uncountable)
hamburgers	Noun	hamburgers ?
neptunium	Noun	neptunium m (uncountable)
bohrium	Noun	bohrium m (plural bohriums)
afro	Noun	afro m (plural afros)
test	Noun	test m (plural tests)
test	Noun	test m (plural tests)
bide	Noun	bide m (plural bides)
lice	Noun	lice f (plural lices)
lice	Noun	lice f (plural lices)
flux	Noun	flux m (plural flux)
smegma	Noun	smegma m (plural smegmas)
bel	Noun	bel m (plural bels)
mousse	Noun	mousse f (plural mousses)
mousse	Noun	mousse m (plural mousses)
revolver	Noun	revolver m (plural revolvers)
snob	Noun	snob m, f (plural snobs)
ciel	Noun	ciel m (plural cieux)
ciel	Noun	ciel m (plural ciels)
foutre	Noun	foutre m (plural foutres)
granit	Noun	granit m (plural granits)
ais	Noun	ais m (plural ais)
cameraman	Noun	cameraman m (plural cameramen)
grille	Noun	grille f (plural grilles)
star	Noun	star f (plural stars)
go	Noun	go m (plural go)
go	Noun	go m (plural gos)
pelote	Noun	pelote f (plural pelotes)
mort	Noun	mort f (plural morts)
mort	Noun	mort m (plural morts, feminine morte)
look	Noun	look m (plural looks)
talus	Noun	talus m (plural talus)
sinus	Noun	sinus m (plural sinus)
timonier	Noun	timonier m (plural timoniers)
stars	Noun	stars f
marmelade	Noun	marmelade f (plural marmelades)
giron	Noun	giron m (plural girons)
galop	Noun	galop m (plural galops)
jökulhlaup	Noun	jökulhlaup m (plural jökulhlaups)
lard	Noun	lard m (plural lards)
baron	Noun	baron m (plural barons)
avoir	Noun	avoir m (plural avoirs)
porto	Noun	porto m (plural portos)
erbium	Noun	erbium m (uncountable)
bug	Noun	bug m (plural bugs)
judo	Noun	judo m (uncountable)
teste	Noun	teste f (plural testes)
sac	Noun	sac m (plural sacs)
sac	Noun	sac m (plural sacs)
steward	Noun	steward m (plural stewards)
puce	Noun	puce f (plural puces)
intuition	Noun	intuition f (plural intuitions)
laiton	Noun	laiton m (uncountable)
cannabis	Noun	cannabis m (uncountable)
kelvin	Noun	kelvin m (plural kelvins)
euro	Noun	euro m (plural euros)
talent	Noun	talent m (plural talents)
parasol	Noun	parasol m (plural parasols)
religion	Noun	religion f (plural religions)
wolfram	Noun	wolfram m (uncountable)
position	Noun	position f (plural positions)
mufti	Noun	mufti m (plural muftis)
lepton	Noun	lepton m (plural leptons)
ester	Noun	ester m (plural esters)
buse	Noun	buse f (plural buses)
buse	Noun	buse f (plural buses)
menu	Noun	menu m (plural menus)
yen	Noun	yen m (plural yens)
ada	Noun	ada m (plural adas)
administration	Noun	administration f (plural administrations)
maso	Noun	maso m, f (plural masos)
croissant	Noun	croissant m (plural croissants)
sonate	Noun	sonate f (plural sonates)
transparent	Noun	transparent m (plural transparents)
mil	Noun	mil m (plural mils)
uns	Noun	uns ?
vaccination	Noun	vaccination f (plural vaccinations)
boc	Noun	boc m (plural bocs)
jockey	Noun	jockey m (plural jockeys)
rand	Noun	rand m (plural rands)
WC	Noun	WC m pl (plural only)
sols	Noun	sols ?
festival	Noun	festival m (plural festivals)
naine	Noun	naine
gris	Noun	gris m (plural gris)
brie	Noun	brie m (plural bries)
mon	Noun	mon m (plural mons)
kot	Noun	kot m (plural kots)
henry	Noun	henry m (plural henrys)
ami	Noun	ami m (plural amis, feminine amie)
harpe	Noun	harpe f (plural harpes)
tombola	Noun	tombola f (plural tombolas)
spiral	Noun	spiral m (plural spiraux)
nation	Noun	nation f (plural nations)
instrumental	Noun	instrumental m (plural instrumentaux)
pigment	Noun	pigment m (plural pigments)
sida	Noun	sida m (plural sida)
moppe	Noun	moppe f (plural moppes)
radon	Noun	radon m (uncountable)
abc	Noun	abc m (plural abc)
ale	Noun	ale f (plural ales)
mies	Noun	mies f
marimba	Noun	marimba m (plural marimbas)
stand	Noun	stand m (plural stands)
gujarati	Noun	gujarati m (uncountable)
pension	Noun	pension f (plural pensions)
graffiti	Noun	graffiti m (uncountable)
dots	Noun	dots f
mors	Noun	mors m (plural mors)
zamia	Noun	zamia m (plural zamias)
plug	Noun	plug m (plural plugs)
snooker	Noun	snooker m (plural snookers)
gangan	Noun	gangan m (plural gangans)
dam	Noun	dam m (plural dams)
labo	Noun	labo m (plural labos)
yoga	Noun	yoga m (uncountable)
pyramide	Noun	pyramide f (plural pyramides)
diktat	Noun	diktat m (plural diktats)
slogan	Noun	slogan m (plural slogans)
heure	Noun	heure f (plural heures)
ischion	Noun	ischion m (plural ischions)
boucher	Noun	boucher m (plural bouchers, feminine bouchère)
gabardine	Noun	gabardine f (plural gabardines)
testament	Noun	testament m (plural testaments)
statut	Noun	statut m (plural statuts)
avance	Noun	avance f (plural avances)
danse	Noun	danse f (plural danses)
abstinent	Noun	abstinent m (plural abstinents)
anus	Noun	anus m (plural anus)
coda	Noun	coda f (plural codas)
ordi	Noun	ordi m (plural ordis)
illusion	Noun	illusion f (plural illusions)
comeback	Noun	comeback m (plural comebacks)
ber	Noun	ber m (plural bers)
ost	Noun	ost m (plural osts)
emoji	Noun	emoji m (plural emojis)
sons	Noun	sons m
catalan	Noun	catalan m (uncountable)
pied	Noun	pied m (plural pieds)
ria	Noun	ria f (plural rias)
sommelier	Noun	sommelier m (plural sommeliers, feminine sommelière)
drink	Noun	drink m (plural drinks)
as	Noun	as m (plural as)
sablon	Noun	sablon m (plural sablons)
humanisme	Noun	humanisme m (plural humanismes)
tuba	Noun	tuba m (plural tubas)
balai	Noun	balai m (plural balais)
marketing	Noun	marketing m (plural marketings)
tomate	Noun	tomate f (plural tomates)
biologie	Noun	biologie f (plural biologies)
division	Noun	division f (plural divisions)
lait	Noun	lait m (plural laits)
rucher	Noun	rucher m (plural ruchers)
fini	Noun	fini m (plural finis)
baston	Noun	baston f (plural bastons)
feedback	Noun	feedback m (plural feedbacks)
crack	Noun	crack f (plural cracks)
e	Noun	e m (plural e)
lots	Noun	lots m
organisme	Noun	organisme m (plural organismes)
Eucharistie	Noun	Eucharistie f (plural Eucharisties)
stimuli	Noun	stimuli m
rapper	Noun	rapper m (plural rappers)
germanium	Noun	germanium m (uncountable)
tac	Noun	tac m (uncountable)
philosophe	Noun	philosophe m, f (plural philosophes)
fisc	Noun	fisc f (plural fiscs)
drac	Noun	drac m (plural dracs)
Romain	Noun	Romain m (plural Romains, feminine Romaine)
gluten	Noun	gluten m (plural glutens)
statue	Noun	statue f (plural statues)
safari	Noun	safari m (plural safaris)
page	Noun	page f (plural pages)
page	Noun	page m (plural pages)
dæmon	Noun	dæmon m (plural dæmons)
paf	Noun	paf m (plural pafs)
aines	Noun	aines f
filipino	Noun	filipino m (uncountable)
galaxie	Noun	galaxie f (plural galaxies)
duramen	Noun	duramen m (plural duramens)
loge	Noun	loge f (plural loges)
salto	Noun	salto m (plural saltos)
jonc	Noun	jonc m (plural joncs)
manga	Noun	manga m (plural mangas)
trance	Noun	trance f (uncountable)
vies	Noun	vies f
colibri	Noun	colibri m (plural colibris)
ohm	Noun	ohm m (plural ohms)
gaz	Noun	gaz m (plural gaz)
fragment	Noun	fragment m (plural fragments)
sabotage	Noun	sabotage m (plural sabotages)
messe	Noun	messe f (plural messes)
abies	Noun	abies m (plural abies)
orgie	Noun	orgie f (plural orgies)
perle	Noun	perle f (plural perles)
dame	Noun	dame f (plural dames)
container	Noun	container f (plural containers)
der	Noun	der m, f (plural ders)
rabat	Noun	rabat m (plural rabats)
zona	Noun	zona m (plural zonas)
pointe	Noun	pointe f (plural pointes)
biogaz	Noun	biogaz m (plural biogaz)
nonne	Noun	nonne f (plural nonnes)
duumvir	Noun	duumvir m (plural duumvirs)
ani	Noun	ani m (plural anis)
Wikipédia	Noun	Wikipédia f (plural Wikipédias)
prestation	Noun	prestation f (plural prestations)
adagio	Noun	adagio m (plural adagios)
sud	Noun	sud m (plural sud)
astronomie	Noun	astronomie f (plural astronomies)
mark	Noun	mark m (plural marks)
gars	Noun	gars m (plural gars)
protestans	Noun	protestans m
wombat	Noun	wombat m (plural wombats)
flipper	Noun	flipper m (plural flippers)
marathi	Noun	marathi m (uncountable)
tsar	Noun	tsar m (plural tsars)
exos	Noun	exos m
fagot	Noun	fagot m (plural fagots)
tequila	Noun	tequila f (plural tequilas)
blog	Noun	blog m (plural blogs)
gospel	Noun	gospel m (plural gospels)
territorial	Noun	territorial m (plural territoriaux)
joint	Noun	joint m (plural joints)
smala	Noun	smala f (plural smalas)
nominal	Noun	nominal m (plural nominaux)
exposé	Noun	exposé m (plural exposés)
actus	Noun	actus f
aspis	Noun	aspis m
incus	Noun	incus m (plural incus)
fan	Noun	fan m, f (plural fans)
fan	Noun	fan f (plural fans)
ventilo	Noun	ventilo m (plural ventilos)
dada	Noun	dada m (plural dadas)
polar	Noun	polar m (plural polars)
cella	Noun	cella f (plural cellas)
patient	Noun	patient m (plural patients, feminine patiente)
jean	Noun	jean m (plural jeans)
duo	Noun	duo m (plural duos)
bale	Noun	bale f (uncountable)
soja	Noun	soja m (plural sojas)
textile	Noun	textile m (plural textiles)
postulat	Noun	postulat m (plural postulats)
khmer	Noun	khmer m (uncountable)
optimiste	Noun	optimiste m, f (plural optimistes)
militant	Noun	militant m (plural militants)
calamar	Noun	calamar m (plural calamars)
narval	Noun	narval m (plural narvals)
studio	Noun	studio m (plural studios)
consul	Noun	consul m (plural consuls, feminine consule)
ananas	Noun	ananas m (plural ananas)
karsts	Noun	karsts ?
tarmac	Noun	tarmac m (plural tarmacs)
koala	Noun	koala m (plural koalas)
malaria	Noun	malaria f (plural malarias)
rats	Noun	rats m
camembert	Noun	camembert m (plural camemberts)
karst	Noun	karst m (plural karsts)
cursus	Noun	cursus m (plural cursus)
ignominie	Noun	ignominie f (plural ignominies)
moron	Noun	moron m (plural morons, feminine moronne)
linge	Noun	linge m (plural linges)
rit	Noun	rit m (plural rits)
martes	Noun	martes m pl
humoriste	Noun	humoriste m, f (plural humoristes)
bleu	Noun	bleu m (plural bleux)
prof	Noun	prof m (plural profs)
Sofi	Noun	Sofi m (plural Sofis)
galoche	Noun	galoche f (plural galoches)
corner	Noun	corner m (plural corners)
gogo	Noun	gogo m (plural gogos)
pixel	Noun	pixel m (plural pixels)
modulation	Noun	modulation f (plural modulations)
cordon	Noun	cordon m (plural cordons)
standard	Noun	standard m (plural standards)
ghetto	Noun	ghetto m (plural ghetti)
bé	Noun	bé m (plural bés)
intelligentsia	Noun	intelligentsia f (plural intelligentsias)
gé	Noun	gé m (plural gés)
arc	Noun	arc m (plural arcs)
venin	Noun	venin m (plural venins)
bunker	Noun	bunker m (plural bunkers)
lubrifiant	Noun	lubrifiant m (plural lubrifiants)
cil	Noun	cil m (plural cils)
playboy	Noun	playboy m (plural playboys)
tunnel	Noun	tunnel m (plural tunnels)
laudanum	Noun	laudanum m (usually uncountable, plural laudanums)
plombe	Noun	plombe f (plural plombes)
robot	Noun	robot m (plural robots)
elles	Noun	elles f
alpaga	Noun	alpaga m (plural alpagas)
tanks	Noun	tanks ?
neutron	Noun	neutron m (plural neutrons)
tilde	Noun	tilde m (plural tildes)
ballote	Noun	ballote f (plural ballotes)
gent	Noun	gent f (plural gents or gens)
gorgonzola	Noun	gorgonzola m (plural gorgonzolas)
ara	Noun	ara m (plural aras)
li	Noun	li m (plural lis)
romans	Noun	romans m
coi	Noun	coi m (plural cois)
brayer	Noun	brayer m (plural brayers)
gel	Noun	gel m (plural gels)
barda	Noun	barda m (plural bardas)
antes	Noun	antes f
bégum	Noun	bégum f (plural bégums)
cactus	Noun	cactus m (plural cactus)
plagiat	Noun	plagiat m (plural plagiats)
fakir	Noun	fakir m (plural fakirs)
osmose	Noun	osmose m (uncountable)
exil	Noun	exil m (plural exils)
risotto	Noun	risotto m (plural risottos)
infirmier	Noun	infirmier m (plural infirmiers, feminine infirmière)
murex	Noun	murex m (plural murex)
chic	Noun	chic m (plural chic)
cep	Noun	cep m (plural ceps)
parvis	Noun	parvis m (plural parvis)
ail	Noun	ail m (plural ails or aulx)
czar	Noun	czar m (plural czars)
lynx	Noun	lynx m (plural lynx)
hydrolyse	Noun	hydrolyse f (plural hydrolyses)
inuktitut	Noun	inuktitut m (uncountable)
coucher	Noun	coucher m (plural couchers)
baste	Noun	baste m (plural bastes)
baste	Noun	baste f (plural bastes)
paella	Noun	paella f (plural paellas)
socio	Noun	socio m (plural socios)
adjutant	Noun	adjutant m (plural adjutants)
bronze	Noun	bronze m (plural bronzes)
lunch	Noun	lunch m (plural lunchs)
jihad	Noun	jihad m (plural jihads)
iris	Noun	iris m (plural iris)
vert	Noun	vert m (plural verts)
bagad	Noun	bagad m (plural bagadoù or bagadou)
Issa	Noun	Issa m (plural Issas)
compos	Noun	compos ?
ranger	Noun	ranger m (plural rangers)
niveau	Noun	niveau m (plural niveaux)
mot	Noun	mot m (plural mots)
tsunami	Noun	tsunami m (plural tsunamis)
gode	Noun	gode m (plural godes)
havre	Noun	havre m (plural havres)
a	Noun	a m, f (plural as)
case	Noun	case f (plural cases)
arts	Noun	arts m
follower	Noun	follower m (plural followers)
album	Noun	album m (plural albums)
calmar	Noun	calmar m (plural calmars)
gluon	Noun	gluon m (plural gluons)
être	Noun	être m (plural êtres)
bûcher	Noun	bûcher m (plural bûchers)
police	Noun	police f (plural polices)
cent	Noun	cent m (plural cents)
bazar	Noun	bazar m (plural bazars)
coco	Noun	coco m (plural cocos)
coco	Noun	coco m, f (plural cocos)
coco	Noun	coco m (plural cocos)
coco	Noun	coco m, f (plural cocos)
pistole	Noun	pistole f (plural pistoles)
esse	Noun	esse m (plural esses)
peseta	Noun	peseta f (plural pesetas)
crin	Noun	crin m (plural crins)
favori	Noun	favori m (plural favoris)
lancer	Noun	lancer m (plural lancers)
original	Noun	original m (plural originaux)
weber	Noun	weber m (plural webers)
flirt	Noun	flirt m (plural flirts)
shogun	Noun	shogun m (plural shoguns)
garde	Noun	garde m, f (plural gardes)
garde	Noun	garde f (plural gardes)
plutonium	Noun	plutonium m (uncountable)
krypton	Noun	krypton m (uncountable)
piste	Noun	piste f (plural pistes)
designer	Noun	designer m (plural designers)
rottweiler	Noun	rottweiler m (plural rottweilers)
hazard	Noun	hazard m (plural hazards)
avis	Noun	avis m (plural avis)
fondeur	Noun	fondeur m (plural fondeurs)
abacas	Noun	abacas m
kilo	Noun	kilo m (plural kilos)
lys	Noun	lys m (plural lys)
enne	Noun	enne m (plural ennes)
tibia	Noun	tibia m (plural tibias)
marijuana	Noun	marijuana f (plural marijuanas)
emme	Noun	emme m (plural emmes)
flamme	Noun	flamme f (plural flammes)
vés	Noun	vés m
nef	Noun	nef f (plural nefs)
sioux	Noun	sioux m (uncountable)
tons	Noun	tons m
export	Noun	export m (plural exports)
becs	Noun	becs m
svastika	Noun	svastika m (plural svastikas)
quarterback	Noun	quarterback m (plural quarterbacks)
beurs	Noun	beurs m
information	Noun	information f (plural informations)
meule	Noun	meule f (plural meules)
centurion	Noun	centurion m (plural centurions)
admonition	Noun	admonition f (plural admonitions)
ed	Noun	ed m (plural eds)
sanie	Noun	sanie f (plural sanies)
attribut	Noun	attribut m (plural attributs)
prise	Noun	prise f (plural prises)
concept	Noun	concept m (plural concepts)
ager	Noun	ager m (plural agers)
country	Noun	country m (uncountable)
khat	Noun	khat m (plural khats)
rival	Noun	rival m (plural rivaux, feminine rivale)
doyen	Noun	doyen m (plural doyens, feminine doyenne)
bassin	Noun	bassin m (plural bassins)
stress	Noun	stress m (uncountable)
version	Noun	version f (plural versions)
version	Noun	version f (plural versions)
moiré	Noun	moiré m (plural moirés)
anglais	Noun	anglais m (uncountable)
naevus	Noun	naevus m (plural naevi)
donation	Noun	donation f (plural donations)
bip	Noun	bip m (plural bips)
gabar	Noun	gabar m (plural gabars)
réal	Noun	réal m (plural réaux)
lac	Noun	lac m (plural lacs)
sabbat	Noun	sabbat m (plural sabbats)
paroli	Noun	paroli m (plural parolis)
madras	Noun	madras m (plural madras)
rive	Noun	rive f (plural rives)
bien	Noun	bien m (plural biens)
palans	Noun	palans m
compact	Noun	compact m (plural compacts)
fermion	Noun	fermion m (plural fermions)
toise	Noun	toise f (plural toises)
resto	Noun	resto m (plural restos)
fermium	Noun	fermium m (uncountable)
cor	Noun	cor m (plural cors)
ua	Noun	ua m (plural ua)
marxisme	Noun	marxisme m (plural marxismes)
chirurgie	Noun	chirurgie f (plural chirurgies)
son	Noun	son m (plural sons)
son	Noun	son m (plural sons)
permanent	Noun	permanent m (plural permanents)
galactites	Noun	galactites f
Sardes	Noun	Sardes m, f
joke	Noun	joke f (plural jokes)
sas	Noun	sas m (plural sas)
lahmacun	Noun	lahmacun f (plural lahmacuns)
absence	Noun	absence f (plural absences)
autobus	Noun	autobus m (plural autobus)
valve	Noun	valve f (plural valves)
lune	Noun	lune f (plural lunes)
siemens	Noun	siemens m (plural siemens)
sec	Noun	sec m (plural secs)
ragoût	Noun	ragoût m (plural ragoûts)
vivant	Noun	vivant m (plural vivants, feminine vivante)
agami	Noun	agami m (plural agamis)
syllogisme	Noun	syllogisme m (plural syllogismes)
raz	Noun	raz m (plural raz)
tiramisu	Noun	tiramisu m (plural tiramisus)
spammer	Noun	spammer m (plural spammers)
podcasting	Noun	podcasting m (uncountable)
signalement	Noun	signalement m (plural signalements)
parentes	Noun	parentes f pl
relation	Noun	relation f (plural relations)
gravitation	Noun	gravitation f (plural gravitations)
sort	Noun	sort m (plural sorts)
Bulgare	Noun	Bulgare m, f (plural Bulgares)
ketchup	Noun	ketchup m (plural ketchups)
are	Noun	are m (plural ares)
dragon	Noun	dragon m (plural dragons, feminine dragonne)
laser	Noun	laser m (plural lasers)
laser	Noun	laser m (plural lasers)
kung-fu	Noun	kung-fu m (uncountable)
putter	Noun	putter m (plural putters)
justicier	Noun	justicier m (plural justiciers, feminine justicière)
boulanger	Noun	boulanger m (plural boulangers, feminine boulangère)
fatwa	Noun	fatwa f (plural fatwas)
chair	Noun	chair f (plural chairs)
piston	Noun	piston m (plural pistons)
budget	Noun	budget m (plural budgets)
semis	Noun	semis m (plural semis)
passé	Noun	passé m (plural passés)
cadmium	Noun	cadmium m (uncountable)
taff	Noun	taff m (plural taffs)
safran	Noun	safran m (plural safrans)
monogamie	Noun	monogamie f (usually uncountable, plural monogamies)
troubadour	Noun	troubadour m (plural troubadours)
verres	Noun	verres m
agora	Noun	agora f (plural agoras)
salami	Noun	salami m (plural salamis)
calcul	Noun	calcul m (plural calculs)
idiots	Noun	idiots m
permutation	Noun	permutation f (plural permutations)
argument	Noun	argument m (plural arguments)
clou	Noun	clou m (plural clous)
palmes	Noun	palmes f
voisin	Noun	voisin m (plural voisins, feminine voisine)
garage	Noun	garage m (plural garages)
horizon	Noun	horizon m (plural horizons)
coefficiens	Noun	coefficiens m
koan	Noun	koan m (plural koan)
clades	Noun	clades m
terminal	Noun	terminal m (plural terminaux)
bite	Noun	bite f (plural bites)
Etat	Noun	Etat m (plural Etats)
gus	Noun	gus m (plural gus)
montage	Noun	montage m (plural montages)
gyro	Noun	gyro m (plural gyros)
tort	Noun	tort m (plural torts)
devis	Noun	devis m (plural devis)
troll	Noun	troll m (plural trolls)
troll	Noun	troll m (plural trolls)
rosé	Noun	rosé m (plural rosés)
armon	Noun	armon m (plural armons)
