bas	Adjective	bas (feminine singular basse, masculine plural bas, feminine plural basses)
blond	Adjective	blond (feminine singular blonde, masculine plural blonds, feminine plural blondes)
mal	Adjective	mal (feminine singular male, masculine plural maux, feminine plural males)
cervical	Adjective	cervical (feminine singular cervicale, masculine plural cervicaux, feminine plural cervicales)
psy	Adjective	psy (invariable)
hautain	Adjective	hautain (feminine singular hautaine, masculine plural hautains, feminine plural hautaines)
mutant	Adjective	mutant (feminine singular mutante, masculine plural mutants, feminine plural mutantes)
rond	Adjective	rond (feminine singular ronde, masculine plural ronds, feminine plural rondes)
violet	Adjective	violet (feminine singular violette, masculine plural violets, feminine plural violettes)
omniscient	Adjective	omniscient (feminine singular omnisciente, masculine plural omniscients, feminine plural omniscientes)
café	Adjective	café (plural cafés)
perso	Adjective	perso (plural persos)
lette	Adjective	lette (plural lettes)
intrigant	Adjective	intrigant (feminine singular intrigante, masculine plural intrigants, feminine plural intrigantes)
sanskrit	Adjective	sanskrit (feminine singular sanskrite, masculine plural sanskrits, feminine plural sanskrites)
sis	Adjective	sis (feminine singular sise, masculine plural sis, feminine plural sises)
gentil	Adjective	gentil (feminine singular gentille, masculine plural gentils, feminine plural gentilles)
idiote	Adjective	idiote
breton	Adjective	breton (feminine singular bretonne, masculine plural bretons, feminine plural bretonnes)
particulier	Adjective	particulier (feminine singular particulière, masculine plural particuliers, feminine plural particulières)
latin	Adjective	latin (feminine singular latine, masculine plural latins, feminine plural latines)
verbal	Adjective	verbal (feminine singular verbale, masculine plural verbaux, feminine plural verbales)
protestant	Adjective	protestant (feminine singular protestante, masculine plural protestants, feminine plural protestantes)
fluvial	Adjective	fluvial (feminine singular fluviale, masculine plural fluviaux, feminine plural fluviales)
infernal	Adjective	infernal (feminine singular infernale, masculine plural infernaux, feminine plural infernales)
békés	Adjective	békés
taliban	Adjective	taliban (feminine singular talibane, masculine plural talibans, feminine plural talibanes)
orange	Adjective	orange (invariable)
mince	Adjective	mince (plural minces)
anglois	Adjective	anglois (feminine singular angloise, masculine plural anglois, feminine plural angloises)
moral	Adjective	moral (feminine singular morale, masculine plural moraux, feminine plural morales)
amiral	Adjective	amiral (feminine singular amirale, masculine plural amiraux, feminine plural amirales)
volatil	Adjective	volatil (feminine singular volatile, masculine plural volatils, feminine plural volatiles)
discret	Adjective	discret (feminine singular discrète, masculine plural discrets, feminine plural discrètes)
contente	Adjective	contente
principal	Adjective	principal (feminine singular principale, masculine plural principaux, feminine plural principales)
futur	Adjective	futur (feminine singular future, masculine plural futurs, feminine plural futures)
vermeil	Adjective	vermeil (feminine singular vermeille, masculine plural vermeils, feminine plural vermeilles)
sot	Adjective	sot (feminine singular sotte, masculine plural sots, feminine plural sottes)
divergent	Adjective	divergent (feminine singular divergente, masculine plural divergents, feminine plural divergentes)
binaural	Adjective	binaural (feminine singular binaurale, masculine plural binauraux, feminine plural binaurales)
affin	Adjective	affin (feminine singular affine, masculine plural affins, feminine plural affines)
complet	Adjective	complet (feminine singular complète, masculine plural complets, feminine plural complètes)
violent	Adjective	violent (feminine singular violente, masculine plural violents, feminine plural violentes)
chenu	Adjective	chenu (feminine singular chenue, masculine plural chenus, feminine plural chenues)
guttural	Adjective	guttural (feminine singular gutturale, masculine plural gutturaux, feminine plural gutturales)
entier	Adjective	entier (feminine singular entière, masculine plural entiers, feminine plural entières)
distal	Adjective	distal (feminine singular distale, masculine plural distaux, feminine plural distales)
premier	Adjective	premier (feminine singular première, masculine plural premiers, feminine plural premières)
privé	Adjective	privé (feminine singular privée, masculine plural privés, feminine plural privées)
flamboyant	Adjective	flamboyant (feminine singular flamboyante, masculine plural flamboyants, feminine plural flamboyantes)
lambda	Adjective	lambda (plural lambdas)
zen	Adjective	zen (invariable)
vil	Adjective	vil (feminine singular vile, masculine plural vils, feminine plural viles)
vaine	Adjective	vaine
rural	Adjective	rural (feminine singular rurale, masculine plural ruraux, feminine plural rurales)
pair	Adjective	pair (feminine singular paire, masculine plural pairs, feminine plural paires)
dromadaire	Adjective	dromadaire (plural dromadaires)
grec	Adjective	grec (feminine singular grecque, masculine plural grecs, feminine plural grecques)
immanent	Adjective	immanent (feminine singular immanente, masculine plural immanents, feminine plural immanentes)
mental	Adjective	mental (feminine singular mentale, masculine plural mentaux, feminine plural mentales)
minis	Adjective	minis
nahuatl	Adjective	nahuatl (feminine singular nahuatle, masculine plural nahuatls, feminine plural nahuatles)
junior	Adjective	junior (plural juniors)
animal	Adjective	animal (feminine singular animale, masculine plural animaux, feminine plural animales)
dorsal	Adjective	dorsal (feminine singular dorsale, masculine plural dorsaux, feminine plural dorsales)
paysager	Adjective	paysager (feminine singular paysagère, masculine plural paysagers, feminine plural paysagères)
luisant	Adjective	luisant (feminine singular luisante, masculine plural luisants, feminine plural luisantes)
trivial	Adjective	trivial (feminine singular triviale, masculine plural triviaux, feminine plural triviales)
bis	Adjective	bis (feminine singular bise, masculine plural bis, feminine plural bises)
bis	Adjective	bis (invariable)
fondant	Adjective	fondant (feminine singular fondante, masculine plural fondants, feminine plural fondantes)
aisné	Adjective	aisné (feminine singular aisnée, masculine plural aisnés, feminine plural aisnées)
masculin	Adjective	masculin (feminine singular masculine, masculine plural masculins, feminine plural masculines)
nonchalant	Adjective	nonchalant (feminine singular nonchalante, masculine plural nonchalants, feminine plural nonchalantes)
flou	Adjective	flou (feminine singular floue, masculine plural flous, feminine plural floues)
turc	Adjective	turc (feminine singular turque, masculine plural turcs, feminine plural turques)
nomade	Adjective	nomade (plural nomades)
monumental	Adjective	monumental (feminine singular monumentale, masculine plural monumentaux, feminine plural monumentales)
maximal	Adjective	maximal (feminine singular maximale, masculine plural maximaux, feminine plural maximales)
fermier	Adjective	fermier (feminine singular fermière, masculine plural fermiers, feminine plural fermières)
underground	Adjective	underground (invariable)
primitif	Adjective	primitif (feminine singular primitive, masculine plural primitifs, feminine plural primitives)
nature	Adjective	nature (plural natures)
ravis	Adjective	ravis
cardinal	Adjective	cardinal (feminine singular cardinale, masculine plural cardinaux, feminine plural cardinales)
variants	Adjective	variants
mandarin	Adjective	mandarin (feminine singular mandarine, masculine plural mandarins, feminine plural mandarines)
nulle	Adjective	nulle
perfide	Adjective	perfide (plural perfides)
liguriens	Adjective	liguriens
civile	Adjective	civile f
plan	Adjective	plan (feminine singular plane, masculine plural plans, feminine plural planes)
lippu	Adjective	lippu (feminine singular lippue, masculine plural lippus, feminine plural lippues)
certain	Adjective	certain (feminine singular certaine, masculine plural certains, feminine plural certaines)
hexagonal	Adjective	hexagonal (feminine singular hexagonale, masculine plural hexagonaux, feminine plural hexagonales)
solide	Adjective	solide (plural solides)
sien	Adjective	sien (feminine singular sienne, masculine plural siens, feminine plural siennes)
gelé	Adjective	gelé (feminine singular gelée, masculine plural gelés, feminine plural gelées)
intestinal	Adjective	intestinal (feminine singular intestinale, masculine plural intestinaux, feminine plural intestinales)
cherokee	Adjective	cherokee (plural cherokees)
filial	Adjective	filial (feminine singular filiale, masculine plural filiaux, feminine plural filiales)
impertinent	Adjective	impertinent (feminine singular impertinente, masculine plural impertinents, feminine plural impertinentes)
a priori	Adjective	a priori (invariable)
ardent	Adjective	ardent (feminine singular ardente, masculine plural ardents, feminine plural ardentes)
paradoxal	Adjective	paradoxal (feminine singular paradoxale, masculine plural paradoxaux, feminine plural paradoxales)
parti	Adjective	parti (feminine singular partie, masculine plural partis, feminine plural parties)
central	Adjective	central (feminine singular centrale, masculine plural centraux, feminine plural centrales)
chiral	Adjective	chiral (feminine singular chirale, masculine plural chiraux, feminine plural chirales)
turbulent	Adjective	turbulent (feminine singular turbulente, masculine plural turbulents, feminine plural turbulentes)
serpentin	Adjective	serpentin (feminine singular serpentine, masculine plural serpentins, feminine plural serpentines)
bi	Adjective	bi (invariable)
amical	Adjective	amical (feminine singular amicale, masculine plural amicaux, feminine plural amicales)
sure	Adjective	sure
bordeaux	Adjective	bordeaux (invariable)
dominant	Adjective	dominant (feminine singular dominante, masculine plural dominants, feminine plural dominantes)
uzbeks	Adjective	uzbeks m pl
horizontal	Adjective	horizontal (feminine singular horizontale, masculine plural horizontaux, feminine plural horizontales)
vaste	Adjective	vaste (plural vastes)
de luxe	Adjective	de luxe (invariable)
est	Adjective	est (invariable)
belge	Adjective	belge (plural belges)
potable	Adjective	potable (plural potables)
atroce	Adjective	atroce (plural atroces)
long	Adjective	long (feminine singular longue, masculine plural longs, feminine plural longues)
scrotal	Adjective	scrotal (feminine singular scrotale, masculine plural scrotaux, feminine plural scrotales)
andorran	Adjective	andorran (feminine singular andorrane, masculine plural andorrans, feminine plural andorranes)
bourgeois	Adjective	bourgeois (feminine singular bourgeoise, masculine plural bourgeois, feminine plural bourgeoises)
brutal	Adjective	brutal (feminine singular brutale, masculine plural brutaux, feminine plural brutales)
local	Adjective	local (feminine singular locale, masculine plural locaux, feminine plural locales)
maint	Adjective	maint (feminine singular mainte, masculine plural maints, feminine plural maintes)
pur	Adjective	pur (feminine singular pure, masculine plural purs, feminine plural pures)
anormal	Adjective	anormal (feminine singular anormale, masculine plural anormaux, feminine plural anormales)
siens	Adjective	siens
plats	Adjective	plats
virtuel	Adjective	virtuel (feminine singular virtuelle, masculine plural virtuels, feminine plural virtuelles)
magistral	Adjective	magistral (feminine singular magistrale, masculine plural magistraux, feminine plural magistrales)
divin	Adjective	divin (feminine singular divine, masculine plural divins, feminine plural divines)
riant	Adjective	riant (feminine singular riante, masculine plural riants, feminine plural riantes)
caprin	Adjective	caprin (feminine singular caprine, masculine plural caprins, feminine plural caprines)
faux	Adjective	faux (feminine singular fausse, masculine plural faux, feminine plural fausses)
baie	Adjective	baie
cuit	Adjective	cuit (feminine singular cuite, masculine plural cuits, feminine plural cuites)
primordial	Adjective	primordial (feminine singular primordiale, masculine plural primordiaux, feminine plural primordiales)
droit	Adjective	droit (feminine singular droite, masculine plural droits, feminine plural droites)
gascon	Adjective	gascon (feminine singular gasconne, masculine plural gascons, feminine plural gasconnes)
sexy	Adjective	sexy (invariable)
formel	Adjective	formel (feminine singular formelle, masculine plural formels, feminine plural formelles)
serviens	Adjective	serviens
café au lait	Adjective	café au lait (invariable)
fatal	Adjective	fatal (feminine singular fatale, masculine plural fatals, feminine plural fatales)
avenue	Adjective	avenue
calcaire	Adjective	calcaire (plural calcaires)
papal	Adjective	papal (feminine singular papale, masculine plural papaux, feminine plural papales)
fourrager	Adjective	fourrager (feminine singular fourragère, masculine plural fourragers, feminine plural fourragères)
centriste	Adjective	centriste (plural centristes)
vif	Adjective	vif (feminine singular vive, masculine plural vifs, feminine plural vives)
molle	Adjective	molle
visuel	Adjective	visuel (feminine singular visuelle, masculine plural visuels, feminine plural visuelles)
terrier	Adjective	terrier (feminine singular terrière, masculine plural terriers, feminine plural terrières)
tangent	Adjective	tangent (feminine singular tangente, masculine plural tangents, feminine plural tangentes)
paranormal	Adjective	paranormal (feminine singular paranormale, masculine plural paranormaux, feminine plural paranormales)
indien	Adjective	indien (feminine singular indienne, masculine plural indiens, feminine plural indiennes)
florentin	Adjective	florentin (feminine singular florentine, masculine plural florentins, feminine plural florentines)
zombie	Adjective	zombie
caille	Adjective	caille (plural cailles)
maya	Adjective	maya (plural mayas)
frappant	Adjective	frappant (feminine singular frappante, masculine plural frappants, feminine plural frappantes)
morbide	Adjective	morbide (plural morbides)
partiel	Adjective	partiel (feminine singular partielle, masculine plural partiels, feminine plural partielles)
lente	Adjective	lente
alluvial	Adjective	alluvial (feminine singular alluviale, masculine plural alluviaux, feminine plural alluviales)
swahili	Adjective	swahili (feminine singular swahilie, masculine plural swahilis, feminine plural swahilies)
forte	Adjective	forte
klingon	Adjective	klingon (feminine singular klingonne, masculine plural klingons, feminine plural klingonnes)
pendant	Adjective	pendant (feminine singular pendante, masculine plural pendants, feminine plural pendantes)
glamour	Adjective	glamour (invariable)
polis	Adjective	polis
full	Adjective	full (plural fulls)
direct	Adjective	direct (feminine singular directe, masculine plural directs, feminine plural directes)
bavarois	Adjective	bavarois (feminine singular bavaroise, masculine plural bavarois, feminine plural bavaroises)
second	Adjective	second (feminine singular seconde, masculine plural seconds, feminine plural secondes)
capital	Adjective	capital (feminine singular capitale, masculine plural capitaux, feminine plural capitales)
extravagant	Adjective	extravagant (feminine singular extravagante, masculine plural extravagants, feminine plural extravagantes)
vaginal	Adjective	vaginal (feminine singular vaginale, masculine plural vaginaux, feminine plural vaginales)
saint	Adjective	saint (feminine singular sainte, masculine plural saints, feminine plural saintes)
astral	Adjective	astral (feminine singular astrale, masculine plural astraux, feminine plural astrales)
las	Adjective	las (feminine singular lasse, masculine plural las, feminine plural lasses)
frontal	Adjective	frontal (feminine singular frontale, masculine plural frontaux, feminine plural frontales)
crus	Adjective	crus
ménager	Adjective	ménager (feminine singular ménagère, masculine plural ménagers, feminine plural ménagères)
abrupt	Adjective	abrupt (feminine singular abrupte, masculine plural abrupts, feminine plural abruptes)
ultra	Adjective	ultra (plural ultras)
templier	Adjective	templier (feminine singular templière, masculine plural templiers, feminine plural templières)
fondue	Adjective	fondue
tabac	Adjective	tabac (invariable)
aldin	Adjective	aldin (feminine singular aldine, masculine plural aldins, feminine plural aldines)
musical	Adjective	musical (feminine singular musicale, masculine plural musicaux, feminine plural musicales)
global	Adjective	global (feminine singular globale, masculine plural globaux, feminine plural globales)
radin	Adjective	radin (feminine singular radine, masculine plural radins, feminine plural radines)
anglican	Adjective	anglican (feminine singular anglicane, masculine plural anglicans, feminine plural anglicanes)
tendre	Adjective	tendre (plural tendres)
oral	Adjective	oral (feminine singular orale, masculine plural oraux, feminine plural orales)
tiers	Adjective	tiers (feminine singular tierce, masculine plural tiers, feminine plural tierces)
gras	Adjective	gras (feminine singular grasse, masculine plural gras, feminine plural grasses)
este	Adjective	este
rampant	Adjective	rampant (feminine singular rampante, masculine plural rampants, feminine plural rampantes)
labial	Adjective	labial (feminine singular labiale, masculine plural labiaux, feminine plural labiales)
journal	Adjective	journal (feminine singular journale, masculine plural journaux, feminine plural journales)
ras	Adjective	ras (feminine singular rase, masculine plural ras, feminine plural rases)
dental	Adjective	dental (feminine singular dentale, masculine plural dentaux, feminine plural dentales)
dolent	Adjective	dolent (feminine singular dolente, masculine plural dolents, feminine plural dolentes)
succulent	Adjective	succulent (feminine singular succulente, masculine plural succulents, feminine plural succulentes)
pittoresque	Adjective	pittoresque (plural pittoresques)
axial	Adjective	axial (feminine singular axiale, masculine plural axiaux, feminine plural axiales)
humble	Adjective	humble (plural humbles)
prudent	Adjective	prudent (feminine singular prudente, masculine plural prudents, feminine plural prudentes)
mongol	Adjective	mongol (feminine singular mongole, masculine plural mongols, feminine plural mongoles)
fine	Adjective	fine
fort	Adjective	fort (feminine singular forte, masculine plural forts, feminine plural fortes)
rasant	Adjective	rasant (feminine singular rasante, masculine plural rasants, feminine plural rasantes)
pastoral	Adjective	pastoral (feminine singular pastorale, masculine plural pastoraux, feminine plural pastorales)
sage	Adjective	sage (plural sages)
ambivalent	Adjective	ambivalent (feminine singular ambivalente, masculine plural ambivalents, feminine plural ambivalentes)
diffus	Adjective	diffus (feminine singular diffuse, masculine plural diffus, feminine plural diffuses)
rigide	Adjective	rigide (plural rigides)
charmant	Adjective	charmant (feminine singular charmante, masculine plural charmants, feminine plural charmantes)
rom	Adjective	rom (plural roms)
grande	Adjective	grande
fade	Adjective	fade (plural fades)
excellent	Adjective	excellent (feminine singular excellente, masculine plural excellents, feminine plural excellentes)
incident	Adjective	incident (feminine singular incidente, masculine plural incidents, feminine plural incidentes)
opportun	Adjective	opportun (feminine singular opportune, masculine plural opportuns, feminine plural opportunes)
maligne	Adjective	maligne
puissant	Adjective	puissant (feminine singular puissante, masculine plural puissants, feminine plural puissantes)
bon	Adjective	bon (feminine singular bonne, masculine plural bons, feminine plural bonnes, comparative meilleur, superlative le meilleur)
lippue	Adjective	lippue
coupé	Adjective	coupé (feminine singular coupée, masculine plural coupés, feminine plural coupées)
immigrant	Adjective	immigrant (feminine singular immigrante, masculine plural immigrants, feminine plural immigrantes)
imposant	Adjective	imposant (feminine singular imposante, masculine plural imposants, feminine plural imposantes)
zombi	Adjective	zombi (feminine singular zombie, masculine plural zombis, feminine plural zombies)
parfait	Adjective	parfait (feminine singular parfaite, masculine plural parfaits, feminine plural parfaites)
albinos	Adjective	albinos (invariable)
valide	Adjective	valide (plural valides)
mini	Adjective	mini (feminine singular minie, masculine plural minis, feminine plural minies)
aidant	Adjective	aidant (feminine singular aidante, masculine plural aidants, feminine plural aidantes)
exorbitant	Adjective	exorbitant (feminine singular exorbitante, masculine plural exorbitants, feminine plural exorbitantes)
laid	Adjective	laid (feminine singular laide, masculine plural laids, feminine plural laides)
persan	Adjective	persan (feminine singular persane, masculine plural persans, feminine plural persanes)
intact	Adjective	intact (feminine singular intacte, masculine plural intacts, feminine plural intactes)
beau	Adjective	beau (masculine singular before vowel bel, feminine singular belle, masculine plural beaux, feminine plural belles)
baissier	Adjective	baissier (feminine singular baissière, masculine plural baissiers, feminine plural baissières)
nul	Adjective	nul (feminine singular nulle, masculine plural nuls, feminine plural nulles)
finale	Adjective	finale
initial	Adjective	initial (feminine singular initiale, masculine plural initiaux, feminine plural initiales)
tien	Adjective	tien (feminine singular tienne, masculine plural tiens, feminine plural tiennes)
assis	Adjective	assis (feminine singular assise, masculine plural assis, feminine plural assises)
brune	Adjective	brune
moite	Adjective	moite (plural moites)
social	Adjective	social (feminine singular sociale, masculine plural sociaux, feminine plural sociales)
loyal	Adjective	loyal (feminine singular loyale, masculine plural loyaux, feminine plural loyales)
laps	Adjective	laps (invariable)
anomal	Adjective	anomal (feminine singular anomale, masculine plural anomaux, feminine plural anomales)
paro	Adjective	paro (invariable)
idéal	Adjective	idéal (feminine singular idéale, masculine plural idéaux, feminine plural idéales)
poli	Adjective	poli (feminine singular polie, masculine plural polis, feminine plural polies)
super	Adjective	super (invariable)
lai	Adjective	lai (feminine singular laie, masculine plural lais, feminine plural laies)
transversal	Adjective	transversal (feminine singular transversale, masculine plural transversaux, feminine plural transversales)
ambigu	Adjective	ambigu (feminine singular ambiguë or ambigüe, masculine plural ambigus, feminine plural ambiguës or ambigües)
camus	Adjective	camus (feminine singular camuse, masculine plural camus, feminine plural camuses)
cornus	Adjective	cornus
variant	Adjective	variant (feminine singular variante, masculine plural variants, feminine plural variantes)
acceptant	Adjective	acceptant (feminine singular acceptante, masculine plural acceptants, feminine plural acceptantes)
more	Adjective	more (plural mores)
fin	Adjective	fin (feminine singular fine, masculine plural fins, feminine plural fines)
final	Adjective	final (feminine singular finale, masculine plural finaux, feminine plural finales)
armé	Adjective	armé (feminine singular armée, masculine plural armés, feminine plural armées)
sauvage	Adjective	sauvage (plural sauvages)
sauvage	Adjective	sauvage (feminine singular sauvagesse, masculine plural sauvages, feminine plural sauvagesses)
amer	Adjective	amer (feminine singular amère, masculine plural amers, feminine plural amères)
bruni	Adjective	bruni (feminine singular brunie, masculine plural brunis, feminine plural brunies)
cham	Adjective	cham (feminine singular chame, masculine plural chams, feminine plural chames)
transparents	Adjective	transparents
digital	Adjective	digital (feminine singular digitale, masculine plural digitaux, feminine plural digitales)
abdominal	Adjective	abdominal (feminine singular abdominale, masculine plural abdominaux, feminine plural abdominales)
arrogante	Adjective	arrogante
incomplet	Adjective	incomplet (feminine singular incomplète, masculine plural incomplets, feminine plural incomplètes)
soft	Adjective	soft (plural softs)
croche	Adjective	croche (plural croches)
fier	Adjective	fier (feminine singular fière, masculine plural fiers, feminine plural fières)
afrikaner	Adjective	afrikaner (plural afrikaners)
forestier	Adjective	forestier (feminine singular forestière, masculine plural forestiers, feminine plural forestières)
obscur	Adjective	obscur (feminine singular obscure, masculine plural obscurs, feminine plural obscures)
orthogonal	Adjective	orthogonal (feminine singular orthogonale, masculine plural orthogonaux, feminine plural orthogonales)
orbital	Adjective	orbital (feminine singular orbitale, masculine plural orbitaux, feminine plural orbitales)
cher	Adjective	cher (feminine singular chère, masculine plural chers, feminine plural chères)
petit	Adjective	petit (feminine singular petite, masculine plural petits, feminine plural petites)
mameluk	Adjective	mameluk (feminine singular mameluke, masculine plural mameluks, feminine plural mamelukes)
raide	Adjective	raide (plural raides)
anar	Adjective	anar (plural anars)
magyar	Adjective	magyar (feminine singular magyare, masculine plural magyars, feminine plural magyares)
anal	Adjective	anal (feminine singular anale, masculine plural anaux, feminine plural anales)
somali	Adjective	somali (feminine singular somalie, masculine plural somalis, feminine plural somalies)
nickel	Adjective	nickel (invariable)
bengali	Adjective	bengali (feminine singular bengalie, masculine plural bengalis, feminine plural bengalies)
jojo	Adjective	jojo (plural jojos)
kaki	Adjective	kaki (plural kakis)
mat	Adjective	mat (feminine singular mate, masculine plural mats, feminine plural mates)
mat	Adjective	mat (feminine singular mate, masculine plural mats, feminine plural mates)
paranoïde	Adjective	paranoïde (plural paranoïdes)
franc	Adjective	franc (feminine singular franche, masculine plural francs, feminine plural franches)
franc	Adjective	franc (feminine singular franque, masculine plural francs, feminine plural franques)
modal	Adjective	modal (feminine singular modale, masculine plural modaux, feminine plural modales)
total	Adjective	total (feminine singular totale, masculine plural totaux, feminine plural totales)
pentue	Adjective	pentue
ravi	Adjective	ravi (feminine singular ravie, masculine plural ravis, feminine plural ravies)
gratis	Adjective	gratis (invariable)
rose	Adjective	rose (plural roses)
viril	Adjective	viril (feminine singular virile, masculine plural virils, feminine plural viriles)
sur	Adjective	sur (feminine singular sure, masculine plural surs, feminine plural sures)
gaga	Adjective	gaga (plural gagas)
drue	Adjective	drue
international	Adjective	international (feminine singular internationale, masculine plural internationaux, feminine plural internationales)
suboptimal	Adjective	suboptimal (feminine singular suboptimale, masculine plural suboptimaux, feminine plural suboptimales)
senestre	Adjective	senestre (plural senestres)
instant	Adjective	instant (feminine singular instante, masculine plural instants, feminine plural instantes)
slave	Adjective	slave (plural slaves)
intelligent	Adjective	intelligent (feminine singular intelligente, masculine plural intelligents, feminine plural intelligentes)
pop	Adjective	pop (feminine singular pope, masculine plural pops, feminine plural popes)
extra	Adjective	extra (plural extras)
brun	Adjective	brun (feminine singular brune, masculine plural bruns, feminine plural brunes)
beige	Adjective	beige (plural beiges)
continu	Adjective	continu (feminine singular continue, masculine plural continus, feminine plural continues)
roman	Adjective	roman (feminine singular romane, masculine plural romans, feminine plural romanes)
pervers	Adjective	pervers (feminine singular perverse, masculine plural pervers, feminine plural perverses)
dialectal	Adjective	dialectal (feminine singular dialectale, masculine plural dialectaux, feminine plural dialectales)
guarani	Adjective	guarani (feminine singular guaranie, masculine plural guaranis, feminine plural guaranies) (often invariable)
lige	Adjective	lige (plural liges)
nival	Adjective	nival (feminine singular nivale, masculine plural nivaux, feminine plural nivales)
afghan	Adjective	afghan (feminine singular afghane, masculine plural afghans, feminine plural afghanes)
bestial	Adjective	bestial (feminine singular bestiale, masculine plural bestiaux, feminine plural bestiales)
plate	Adjective	plate
plate	Adjective	plate (plural plates)
funky	Adjective	funky (plural funkys)
passager	Adjective	passager (feminine singular passagère, masculine plural passagers, feminine plural passagères)
arrogant	Adjective	arrogant (feminine singular arrogante, masculine plural arrogants, feminine plural arrogantes)
minimal	Adjective	minimal (feminine singular minimale, masculine plural minimaux, feminine plural minimales)
civil	Adjective	civil (feminine singular civile, masculine plural civils, feminine plural civiles)
absent	Adjective	absent (feminine singular absente, masculine plural absents, feminine plural absentes)
atonal	Adjective	atonal (feminine singular atonale, masculine plural atonals or atonaux, feminine plural atonales)
ardus	Adjective	ardus
plat	Adjective	plat (feminine singular plate, masculine plural plats, feminine plural plates)
conjugal	Adjective	conjugal (feminine singular conjugale, masculine plural conjugaux, feminine plural conjugales)
aigu	Adjective	aigu (feminine singular aiguë or aigüe, masculine plural aigus, feminine plural aiguës or aigües)
duel	Adjective	duel (feminine singular duelle, masculine plural duels, feminine plural duelles)
morale	Adjective	morale
imbus	Adjective	imbus m pl
larmoyant	Adjective	larmoyant (feminine singular larmoyante, masculine plural larmoyants, feminine plural larmoyantes)
cornu	Adjective	cornu (feminine singular cornue, masculine plural cornus, feminine plural cornues)
orchestral	Adjective	orchestral (feminine singular orchestrale, masculine plural orchestraux, feminine plural orchestrales)
dur	Adjective	dur (feminine singular dure, masculine plural durs, feminine plural dures)
abstrus	Adjective	abstrus (feminine singular abstruse, masculine plural abstrus, feminine plural abstruses)
grand	Adjective	grand (feminine singular grande, masculine plural grands, feminine plural grandes)
bigot	Adjective	bigot (feminine singular bigote, masculine plural bigots, feminine plural bigotes)
hard	Adjective	hard (plural hards)
courant	Adjective	courant (feminine singular courante, masculine plural courants, feminine plural courantes)
divers	Adjective	divers (feminine singular diverse, masculine plural divers, feminine plural diverses)
abject	Adjective	abject (feminine singular abjecte, masculine plural abjects, feminine plural abjectes)
fat	Adjective	fat (feminine singular fate, masculine plural fats, feminine plural fates)
expert	Adjective	expert (feminine singular experte, masculine plural experts, feminine plural expertes)
lippus	Adjective	lippus
afar	Adjective	afar (feminine singular afare, masculine plural afars, feminine plural afares)
ventral	Adjective	ventral (feminine singular ventrale, masculine plural ventraux, feminine plural ventrales)
homo	Adjective	homo (plural homos)
nauruan	Adjective	nauruan (feminine singular nauruane, masculine plural nauruans, feminine plural nauruanes)
marin	Adjective	marin (feminine singular marine, masculine plural marins, feminine plural marines)
uzbek	Adjective	uzbek (feminine singular uzbèke, masculine plural uzbeks, feminine plural uzbèkes)
uni	Adjective	uni (feminine singular unie, masculine plural unis, feminine plural unies)
ambulant	Adjective	ambulant (feminine singular ambulante, masculine plural ambulants, feminine plural ambulantes)
aberrant	Adjective	aberrant (feminine singular aberrante, masculine plural aberrants, feminine plural aberrantes)
galant	Adjective	galant (feminine singular galante, masculine plural galants, feminine plural galantes)
coquet	Adjective	coquet (feminine singular coquette, masculine plural coquets, feminine plural coquettes)
dure	Adjective	dure
pascal	Adjective	pascal (feminine singular pascale, masculine plural pascaux, feminine plural pascales)
tel	Adjective	tel (feminine singular telle, masculine plural tels, feminine plural telles)
idiot	Adjective	idiot (feminine singular idiote, masculine plural idiots, feminine plural idiotes)
spectral	Adjective	spectral (feminine singular spectrale, masculine plural spectraux, feminine plural spectrales)
alaine	Adjective	alaine
secret	Adjective	secret (feminine singular secrète, masculine plural secrets, feminine plural secrètes)
indiscret	Adjective	indiscret (feminine singular indiscrète, masculine plural indiscrets, feminine plural indiscrètes)
structural	Adjective	structural (feminine singular structurale, masculine plural structuraux, feminine plural structurales)
hutu	Adjective	hutu (plural hutus)
fuchsia	Adjective	fuchsia (invariable)
violets	Adjective	violets
prudente	Adjective	prudente
exact	Adjective	exact (feminine singular exacte, masculine plural exacts, feminine plural exactes)
eskimo	Adjective	eskimo (invariable)
viral	Adjective	viral (feminine singular virale, masculine plural viraux, feminine plural virales)
maori	Adjective	maori (feminine singular maorie, masculine plural maoris, feminine plural maories)
telugu	Adjective	telugu (plural telugus)
marginal	Adjective	marginal (feminine singular marginale, masculine plural marginaux, feminine plural marginales)
vile	Adjective	vile
tutsi	Adjective	tutsi (feminine singular tutsie, masculine plural tutsis, feminine plural tutsies)
blanc	Adjective	blanc (feminine singular blanche, masculine plural blancs, feminine plural blanches)
soul	Adjective	soul (feminine singular soule, masculine plural souls, feminine plural soules)
cacher	Adjective	cacher (invariable)
triste	Adjective	triste (plural tristes)
gros	Adjective	gros (feminine singular grosse, masculine plural gros, feminine plural grosses)
bel	Adjective	bel
mousse	Adjective	mousse (plural mousses)
latent	Adjective	latent (feminine singular latente, masculine plural latents, feminine plural latentes)
snob	Adjective	snob (plural snobs)
mort	Adjective	mort (feminine singular morte, masculine plural morts, feminine plural mortes)
indus	Adjective	indus
pentu	Adjective	pentu (feminine singular pentue, masculine plural pentus, feminine plural pentues)
diverse	Adjective	diverse
chantant	Adjective	chantant (feminine singular chantante, masculine plural chantants, feminine plural chantantes)
optimal	Adjective	optimal (feminine singular optimale, masculine plural optimaux, feminine plural optimales)
avaricieux	Adjective	avaricieux (feminine singular avaricieuse, masculine plural avaricieux, feminine plural avaricieuses)
omnipotent	Adjective	omnipotent (feminine singular omnipotente, masculine plural omnipotents, feminine plural omnipotentes)
charnel	Adjective	charnel (feminine singular charnelle, masculine plural charnels, feminine plural charnelles)
menu	Adjective	menu (feminine singular menue, masculine plural menus, feminine plural menues)
maso	Adjective	maso (plural masos)
croissant	Adjective	croissant (feminine singular croissante, masculine plural croissants, feminine plural croissantes)
transparent	Adjective	transparent (feminine singular transparente, masculine plural transparents, feminine plural transparentes)
finis	Adjective	finis
gris	Adjective	gris (feminine singular grise, masculine plural gris, feminine plural grises)
vite	Adjective	vite (plural vites)
hardi	Adjective	hardi (feminine singular hardie, masculine plural hardis, feminine plural hardies)
spiral	Adjective	spiral (feminine singular spirale, masculine plural spiraux, feminine plural spirales)
instrumental	Adjective	instrumental (feminine singular instrumentale, masculine plural instrumentaux, feminine plural instrumentales)
normal	Adjective	normal (feminine singular normale, masculine plural normaux, feminine plural normales)
flamand	Adjective	flamand (feminine singular flamande, masculine plural flamands, feminine plural flamandes)
bilabial	Adjective	bilabial (feminine singular bilabiale, masculine plural bilabiaux, feminine plural bilabiales)
grise	Adjective	grise
important	Adjective	important (feminine singular importante, masculine plural importants, feminine plural importantes)
adverbial	Adjective	adverbial (feminine singular adverbiale, masculine plural adverbiaux, feminine plural adverbiales)
abstinent	Adjective	abstinent (feminine singular abstinente, masculine plural abstinents, feminine plural abstinentes)
ignorant	Adjective	ignorant (feminine singular ignorante, masculine plural ignorants, feminine plural ignorantes)
catalan	Adjective	catalan (feminine singular catalane, masculine plural catalans, feminine plural catalanes)
pris	Adjective	pris (feminine singular prise, masculine plural pris, feminine plural prises)
fini	Adjective	fini (feminine singular finie, masculine plural finis, feminine plural finies)
bavaroise	Adjective	bavaroise
fessus	Adjective	fessus
rude	Adjective	rude (plural rudes)
barbus	Adjective	barbus
bivalent	Adjective	bivalent (feminine singular bivalente, masculine plural bivalents, feminine plural bivalentes)
paf	Adjective	paf (invariable)
jointif	Adjective	jointif (feminine singular jointive, masculine plural jointifs, feminine plural jointives)
ultramarin	Adjective	ultramarin (feminine singular ultramarine, masculine plural ultramarins, feminine plural ultramarines)
basal	Adjective	basal (feminine singular basale, masculine plural basaux, feminine plural basales)
territorial	Adjective	territorial (feminine singular territoriale, masculine plural territoriaux, feminine plural territoriales)
nominal	Adjective	nominal (feminine singular nominale, masculine plural nominaux, feminine plural nominales)
exposé	Adjective	exposé (feminine singular exposée, masculine plural exposés, feminine plural exposées)
quel	Adjective	quel (feminine singular quelle, masculine plural quels, feminine plural quelles)
patient	Adjective	patient (feminine singular patiente, masculine plural patients, feminine plural patientes)
vaillant	Adjective	vaillant (feminine singular vaillante, masculine plural vaillants, feminine plural vaillantes)
textile	Adjective	textile (plural textiles)
khmer	Adjective	khmer (feminine singular khmère, masculine plural khmers, feminine plural khmères)
optimiste	Adjective	optimiste (plural optimistes)
militant	Adjective	militant (feminine singular militante, masculine plural militants, feminine plural militantes)
floral	Adjective	floral (feminine singular florale, masculine plural floraux, feminine plural florales)
moron	Adjective	moron (feminine singular moronne, masculine plural morons, feminine plural moronnes)
bleu	Adjective	bleu (feminine singular bleue, masculine plural bleus, feminine plural bleues)
net	Adjective	net (feminine singular nette, masculine plural nets, feminine plural nettes)
saur	Adjective	saur (feminine singular saure, masculine plural saurs, feminine plural saures)
mono	Adjective	mono (plural monos)
standard	Adjective	standard (feminine singular standarde, masculine plural standards, feminine plural standardes)
humoral	Adjective	humoral (feminine singular humorale, masculine plural humoraux, feminine plural humorales)
lubrifiant	Adjective	lubrifiant (feminine singular lubrifiante, masculine plural lubrifiants, feminine plural lubrifiantes)
gratuit	Adjective	gratuit (feminine singular gratuite, masculine plural gratuits, feminine plural gratuites)
dissonant	Adjective	dissonant (feminine singular dissonante, masculine plural dissonants, feminine plural dissonantes)
plural	Adjective	plural (feminine singular plurale, masculine plural pluraux, feminine plural plurales)
brachial	Adjective	brachial (feminine singular brachiale, masculine plural brachiaux, feminine plural brachiales)
gent	Adjective	gent (feminine singular gente, masculine plural gents, feminine plural gentes)
romans	Adjective	romans
coi	Adjective	coi (feminine singular coite, masculine plural cois, feminine plural coites)
sentimental	Adjective	sentimental (feminine singular sentimentale, masculine plural sentimentaux, feminine plural sentimentales)
infirmier	Adjective	infirmier (feminine singular infirmière, masculine plural infirmiers, feminine plural infirmières)
chic	Adjective	chic (plural chic or chics)
purs	Adjective	purs
impunis	Adjective	impunis
vert	Adjective	vert (feminine singular verte, masculine plural verts, feminine plural vertes)
subtil	Adjective	subtil (feminine singular subtile, masculine plural subtils, feminine plural subtiles)
navale	Adjective	navale
celle	Adjective	celle
national	Adjective	national (feminine singular nationale, masculine plural nationaux, feminine plural nationales)
favori	Adjective	favori (feminine singular favorite, masculine plural favoris, feminine plural favorites)
original	Adjective	original (feminine singular originale, masculine plural originaux, feminine plural originales)
vital	Adjective	vital (feminine singular vitale, masculine plural vitaux, feminine plural vitales)
focal	Adjective	focal (feminine singular focale, masculine plural focaux, feminine plural focales)
brillant	Adjective	brillant (feminine singular brillante, masculine plural brillants, feminine plural brillantes)
porcin	Adjective	porcin (feminine singular porcine, masculine plural porcins, feminine plural porcines)
correct	Adjective	correct (feminine singular correcte, masculine plural corrects, feminine plural correctes)
sioux	Adjective	sioux (invariable)
pure	Adjective	pure
rival	Adjective	rival (feminine singular rivale, masculine plural rivaux, feminine plural rivales)
banal	Adjective	banal (feminine singular banale, masculine plural banals, feminine plural banales)
banal	Adjective	banal (feminine singular banale, masculine plural banaux, feminine plural banales)
moiré	Adjective	moiré (feminine singular moirée, masculine plural moirés, feminine plural moirées)
anglais	Adjective	anglais (feminine singular anglaise, masculine plural anglais, feminine plural anglaises)
præsent	Adjective	præsent (feminine singular præsente, masculine plural præsents, feminine plural præsentes)
tentant	Adjective	tentant (feminine singular tentante, masculine plural tentants, feminine plural tentantes)
bien	Adjective	bien (comparative meilleur, superlative le meilleur)
compact	Adjective	compact (feminine singular compacte, masculine plural compacts, feminine plural compactes)
permanent	Adjective	permanent (feminine singular permanente, masculine plural permanents, feminine plural permanentes)
sec	Adjective	sec (feminine singular sèche, masculine plural secs, feminine plural sèches)
cool	Adjective	cool (feminine singular coole, masculine plural cools, feminine plural cooles)
vivant	Adjective	vivant (feminine singular vivante, masculine plural vivants, feminine plural vivantes)
mol	Adjective	mol m sg
parentes	Adjective	parentes pl
cossus	Adjective	cossus
palatal	Adjective	palatal (feminine singular palatale, masculine plural palataux, feminine plural palatales)
grave	Adjective	grave (plural graves)
continental	Adjective	continental (feminine singular continentale, masculine plural continentaux, feminine plural continentales)
laborant	Adjective	laborant (feminine singular laborante, masculine plural laborants, feminine plural laborantes)
idiots	Adjective	idiots
voisin	Adjective	voisin (feminine singular voisine, masculine plural voisins, feminine plural voisines)
terminal	Adjective	terminal (feminine singular terminale, masculine plural terminaux, feminine plural terminales)
cocus	Adjective	cocus
mormon	Adjective	mormon (feminine singular mormone, masculine plural mormons, feminine plural mormones)
rosé	Adjective	rosé (feminine singular rosée, masculine plural rosés, feminine plural rosées)
