morfema	Noun	morfema m (plural morfemes)
cambrer	Noun	cambrer m (plural cambrers, feminine cambrera)
paremiologia	Noun	paremiologia f (plural paremiologies)
gerra	Noun	gerra f (plural gerres)
reis	Noun	reis
cors	Noun	cors m (plural corsos, feminine corsa)
pera	Noun	pera f (plural peres)
sufix	Noun	sufix m (plural sufixos)
fama	Noun	fama f (plural fames)
militar	Noun	militar m, f (plural militars)
base	Noun	base f (plural bases)
bec	Noun	bec m (plural becs)
capella	Noun	capella f (plural capelles)
patent	Noun	patent m (plural patents)
buba	Noun	buba f (plural bubes)
oromo	Noun	oromo m (uncountable)
favor	Noun	favor m, f (plural favors)
jurat	Noun	jurat m (plural jurats)
fill	Noun	fill m (plural fills)
premi	Noun	premi m (plural premis)
pederasta	Noun	pederasta m (plural pederastes)
ministre	Noun	ministre m (plural ministres, feminine ministra)
hematologia	Noun	hematologia f (uncountable)
psi	Noun	psi f (plural psis)
pas	Noun	pas m (plural passos)
natura	Noun	natura f (plural natures)
patrona	Noun	patrona f (plural patrones)
error	Noun	error m (plural errors)
ornitologia	Noun	ornitologia f (uncountable)
pa	Noun	pa m (plural pans)
bandera	Noun	bandera f (plural banderes)
circuit	Noun	circuit m (plural circuits)
cangur	Noun	cangur m (plural cangurs)
trava	Noun	trava f (plural traves)
es	Noun	es
parc	Noun	parc m (plural parcs)
Marlena	Noun	Marlena f
banquer	Noun	banquer m (plural banquers, feminine banquera)
examen	Noun	examen m (plural exàmens)
saxofon	Noun	saxofon m (plural saxofons)
pi	Noun	pi m (plural pins)
pi	Noun	pi f (plural pis)
web	Noun	web m (plural webs)
web	Noun	web f (plural webs)
pilot	Noun	pilot m (plural pilots)
palma	Noun	palma f (plural palmes)
calma	Noun	calma f (plural calmes)
ortografia	Noun	ortografia f (plural ortografies)
arca	Noun	arca f (plural arques)
gos	Noun	gos m (plural gossos, feminine gossa)
fans	Noun	fans
vall	Noun	vall f (plural valls)
general	Noun	general m (plural generals, feminine generala)
veterans	Noun	veterans
tercer	Noun	tercer m (plural tercers, feminine tercera)
hiena	Noun	hiena f (plural hienes)
dos	Noun	dos m (plural dosos)
dos	Noun	dos
dos	Noun	dos m (plural dossos)
grup	Noun	grup m (plural grups)
quadriga	Noun	quadriga f (plural quadrigues)
salut	Noun	salut f (plural saluts)
sonata	Noun	sonata m (plural sonates)
rictus	Noun	rictus m (plural rictus)
embrió	Noun	embrió m (plural embrions)
edat	Noun	edat f (plural edats)
meteor	Noun	meteor m (plural meteors)
paus	Noun	paus
reg	Noun	reg m (plural regs)
pit	Noun	pit m (plural pits)
dany	Noun	dany m (plural danys)
recepció	Noun	recepció f (plural recepcions)
farina	Noun	farina f (plural farines)
era	Noun	era f (plural eres)
corn	Noun	corn m (plural corns)
roc	Noun	roc m (plural rocs)
autobiografia	Noun	autobiografia f (plural autobiografies)
homosexual	Noun	homosexual m, f (plural homosexuals)
judoka	Noun	judoka m, f (plural judokes)
organista	Noun	organista m, f (plural organistes)
single	Noun	single m (plural singles)
efa	Noun	efa f (plural efes)
sopa	Noun	sopa f (plural sopes)
kurds	Noun	kurds
venda	Noun	venda f (plural vendes)
deutor	Noun	deutor m (plural deutors)
fum	Noun	fum m (uncountable)
corb	Noun	corb m (plural corbs)
fluor	Noun	fluor m (uncountable)
plutoni	Noun	plutoni m (uncountable)
placenta	Noun	placenta f (plural placentes)
nebulosa	Noun	nebulosa f (plural nebuloses)
soler	Noun	soler m (plural solers)
drama	Noun	drama m (plural drames)
drama	Noun	drama f (plural drames)
moto	Noun	moto f (plural motos)
filosofia	Noun	filosofia f (plural filosofies)
mos	Noun	mos m (plural mossos)
coma	Noun	coma m (plural comes)
coma	Noun	coma f (plural comes)
sopar	Noun	sopar m (plural sopars)
opció	Noun	opció f (plural opcions)
entomologia	Noun	entomologia f (uncountable)
cu	Noun	cu f (plural cus)
rumor	Noun	rumor m (plural rumors)
odi	Noun	odi m (plural odis)
cel	Noun	cel m (plural cels)
element	Noun	element m (plural elements)
agent	Noun	agent m (plural agents)
milla	Noun	milla f (plural milles)
carota	Noun	carota f (plural carotes)
nefrologia	Noun	nefrologia f (uncountable)
hotel	Noun	hotel m (plural hotels)
orgasme	Noun	orgasme m (plural orgasmes)
mamut	Noun	mamut m (plural mamuts)
amfibi	Noun	amfibi m (plural amfibis)
antena	Noun	antena f (plural antenes)
pruna	Noun	pruna f (plural prunes)
foto	Noun	foto f (plural fotos)
pin	Noun	pin m (plural pins)
univers	Noun	univers m (plural universos)
futbol	Noun	futbol m (plural futbols)
pizzeria	Noun	pizzeria f (plural pizzeries)
prova	Noun	prova f (plural proves)
mall	Noun	mall m (plural malls)
ús	Noun	ús m (plural usos)
portugués	Noun	portugués m (plural portuguesos, feminine portuguesa)
fita	Noun	fita f (plural fites)
heli	Noun	heli m (uncountable)
tia	Noun	tia f (plural ties)
regna	Noun	regna f (plural regnes)
magenta	Noun	magenta f (uncountable)
trams	Noun	trams
correus	Noun	correus
radar	Noun	radar m (plural radars)
gabinet	Noun	gabinet m (plural gabinets)
bari	Noun	bari m (uncountable)
olor	Noun	olor f (plural olors)
nit	Noun	nit f (plural nits)
plats	Noun	plats
pinsans	Noun	pinsans
comes	Noun	comes
pus	Noun	pus m (uncountable)
ase	Noun	ase m (plural ases or àsens)
flam	Noun	flam m (plural flams)
DVD	Noun	DVD m (plural DVD)
pressa	Noun	pressa f (plural presses)
banana	Noun	banana f (plural bananes)
morfologia	Noun	morfologia f (plural morfologies)
senda	Noun	senda f (plural sendes)
full	Noun	full m (plural fulls)
sodomita	Noun	sodomita m (plural sodomites)
sistema	Noun	sistema m (plural sistemes)
nou	Noun	nou m (plural nous)
nou	Noun	nou f (plural nous)
tumor	Noun	tumor m (plural tumors)
bus	Noun	bus m, f (plural bussos)
bus	Noun	bus m (plural bussos)
bus	Noun	bus m (plural busos)
bus	Noun	bus m (plural busos)
bus	Noun	bus m (plural busos)
clima	Noun	clima m (plural climes)
beure	Noun	beure m (plural beures)
pal	Noun	pal m (plural pals)
exterior	Noun	exterior m (plural exteriors)
tela	Noun	tela f (plural teles)
gals	Noun	gals
vapor	Noun	vapor m (plural vapors)
capital	Noun	capital f (plural capitals)
capital	Noun	capital m (plural capitals)
illa	Noun	illa f (plural illes)
utopia	Noun	utopia f (plural utopies)
turista	Noun	turista m (plural turistes)
dama	Noun	dama f (plural dames)
frontal	Noun	frontal m (plural frontals)
las	Noun	las
gamma	Noun	gamma f (plural gammes)
monuments	Noun	monuments
geni	Noun	geni m (plural genis)
front	Noun	front m (plural fronts)
orangutan	Noun	orangutan m (plural orangutans)
homozigot	Noun	homozigot m (plural homozigots)
ortus	Noun	ortus m (plural ortus)
futbols	Noun	futbols
preludi	Noun	preludi m (plural preludis)
gingivitis	Noun	gingivitis f (uncountable)
fosa	Noun	fosa f (plural foses)
bull	Noun	bull m (plural bulls)
bull	Noun	bull m (plural bulls)
batuta	Noun	batuta f (plural batutes)
palau	Noun	palau m (plural palaus)
piscina	Noun	piscina f (plural piscines)
rom	Noun	rom m (plural roms)
cap	Noun	cap m (plural caps)
causa	Noun	causa f (plural causes)
sargs	Noun	sargs
si	Noun	si m (plural sis)
si	Noun	si m (plural sins)
internet	Noun	internet m (plural internets)
cara	Noun	cara f (plural cares)
taxi	Noun	taxi m (plural taxis)
taxi	Noun	taxi f (plural taxis)
bengali	Noun	bengali m, f (plural bengalis)
tennis	Noun	tennis m (uncountable)
sis	Noun	sis m (plural sisos)
sis	Noun	sis
balear	Noun	balear m, f (plural balears)
incident	Noun	incident m (plural incidents)
dia	Noun	dia m (plural dies)
dot	Noun	dot m (plural dots)
energia	Noun	energia f (plural energies)
is	Noun	is
dea	Noun	dea f (plural dees)
serp	Noun	serp m (plural serps)
altruista	Noun	altruista m, f (plural altruistes)
part	Noun	part m (plural parts)
part	Noun	part f (plural parts)
part	Noun	part m (plural parts, feminine parta)
tenor	Noun	tenor m (plural tenors)
metro	Noun	metro m (plural metros)
rector	Noun	rector m (plural rectors)
motor	Noun	motor m (plural motors)
oponent	Noun	oponent m, f (plural oponents)
bena	Noun	bena f (plural benes)
camper	Noun	camper m (plural campers)
immigrant	Noun	immigrant m (plural immigrants)
enter	Noun	enter m (plural enters)
rés	Noun	rés m (plural resos)
aventurer	Noun	aventurer m (plural aventurers, feminine aventurera)
agressor	Noun	agressor m (plural agressors, feminine agressora)
koppa	Noun	koppa f (plural koppes)
porter	Noun	porter m (plural porters)
líder	Noun	líder m, f (plural líders)
forma	Noun	forma f (plural formes)
fra	Noun	fra m (plural fres)
medicina	Noun	medicina f (plural medicines)
o	Noun	o f (plural os)
nap	Noun	nap m (plural naps)
font	Noun	font m (plural fonts)
autista	Noun	autista m, f (plural autistes)
conca	Noun	conca f (plural conques)
mars	Noun	mars
rombe	Noun	rombe m (plural rombes)
hora	Noun	hora f (plural hores)
tori	Noun	tori m (uncountable)
bilis	Noun	bilis f (plural bilis)
ser	Noun	ser m (plural sers)
fort	Noun	fort m (plural forts, feminine forta)
kamikaze	Noun	kamikaze m (plural kamikazes)
nota	Noun	nota f (plural notes)
sers	Noun	sers
anapest	Noun	anapest m (plural anapests or anapestos)
ideal	Noun	ideal m (plural ideals)
golfista	Noun	golfista m, f (plural golfistes)
textura	Noun	textura f (plural textures)
substrat	Noun	substrat m (plural substrats)
bars	Noun	bars
fermi	Noun	fermi m (uncountable)
tinter	Noun	tinter m (plural tinters)
problema	Noun	problema m (plural problemes)
set	Noun	set m (plural sets)
torres	Noun	torres
zeros	Noun	zeros
quintar	Noun	quintar m (plural quintars)
bruc	Noun	bruc m (plural brucs)
bomber	Noun	bomber m (plural bombers, feminine bombera)
vores	Noun	vores
mineral	Noun	mineral m (plural minerals)
preu	Noun	preu m (plural preus)
jardiner	Noun	jardiner m (plural jardiners, feminine jardinera)
bua	Noun	bua f (plural bues)
bua	Noun	bua f (plural bues)
arbust	Noun	arbust m (plural arbusts or arbustos)
zoologia	Noun	zoologia f (plural zoologies)
danés	Noun	danés m (plural danesos, feminine danesa)
ibis	Noun	ibis m (plural ibis)
esca	Noun	esca f (plural esques)
fons	Noun	fons m (plural fons)
fas	Noun	fas
monument	Noun	monument m (plural monuments)
inca	Noun	inca m, f (plural inques)
vida	Noun	vida f (plural vides)
eina	Noun	eina f (plural eines)
toll	Noun	toll m (plural tolls)
sonatina	Noun	sonatina f (plural sonatines)
aleta	Noun	aleta f (plural aletes)
solista	Noun	solista m, f (plural solistes)
fatxada	Noun	fatxada f (plural fatxades)
golf	Noun	golf m (plural golfs)
golf	Noun	golf m (uncountable)
mart	Noun	mart m (plural marts)
api	Noun	api m (plural apis)
herba	Noun	herba f (plural herbes)
candela	Noun	candela f (plural candeles)
coc	Noun	coc m (plural cocs)
coc	Noun	coc m (plural cocs)
fira	Noun	fira f (plural fires)
nacionalista	Noun	nacionalista m (plural nacionalistes)
farsa	Noun	farsa f (plural farses)
sector	Noun	sector m (plural sectors)
alba	Noun	alba f (plural albes)
whisky	Noun	whisky m (plural whiskys or whiskies)
daus	Noun	daus
mans	Noun	mans
peres	Noun	peres
banc	Noun	banc m (plural bancs)
adverbi	Noun	adverbi m (plural adverbis)
ball	Noun	ball m (plural balls)
flora	Noun	flora f (uncountable)
orca	Noun	orca f (plural orques)
enigma	Noun	enigma m (plural enigmes)
homofonia	Noun	homofonia f (plural homofonies)
grua	Noun	grua f (plural grues)
sampi	Noun	sampi f (plural sampis)
tinta	Noun	tinta f (plural tintes)
kappa	Noun	kappa f (plural kappes)
motors	Noun	motors
basar	Noun	basar m (plural basars)
haver	Noun	haver m (plural havers)
mandat	Noun	mandat m (plural mandats)
norma	Noun	norma f (plural normes)
onze	Noun	onze m (plural onzes)
tesla	Noun	tesla m (plural tesles)
finlandés	Noun	finlandés m (plural finlandesos, feminine finlandesa)
axioma	Noun	axioma m (plural axiomes)
elefant	Noun	elefant m (plural elefants)
torn	Noun	torn m (plural torns)
zombi	Noun	zombi m, f (plural zombis)
nas	Noun	nas m (plural nassos)
fada	Noun	fada f (plural fades)
prior	Noun	prior m (plural priors)
regent	Noun	regent m (plural regents)
nahua	Noun	nahua m, f (plural nahues)
dosis	Noun	dosis
CD	Noun	CD m (plural CDs)
ema	Noun	ema f (plural emes)
festa	Noun	festa f (plural festes)
manual	Noun	manual m (plural manuals)
debut	Noun	debut m (plural debuts)
moc	Noun	moc m (plural mocs)
oferta	Noun	oferta f (plural ofertes)
port	Noun	port m (plural ports)
port	Noun	port m (plural ports)
emirat	Noun	emirat m (plural emirats)
amic	Noun	amic m (plural amics, feminine amiga)
mar	Noun	mar m, f (plural mars)
salt	Noun	salt m (plural salts)
favorit	Noun	favorit m (plural favorits)
acta	Noun	acta f (plural actes)
bestia	Noun	bestia f (plural besties)
albanés	Noun	albanés m (plural albanesos, feminine albanesa)
art	Noun	art m, f (plural arts)
alcohol	Noun	alcohol m (plural alcohols)
present	Noun	present m (plural presents)
emblema	Noun	emblema m (plural emblemes)
ronda	Noun	ronda f (plural rondes)
sabor	Noun	sabor m, f (plural sabors)
grec	Noun	grec m (plural grecs, feminine grega)
tarifa	Noun	tarifa f (plural tarifes)
bulevard	Noun	bulevard m (plural bulevards)
ferm	Noun	ferm m (plural ferms)
mapa	Noun	mapa m (plural mapes)
codi	Noun	codi m (plural codis)
utensilis	Noun	utensilis
tisana	Noun	tisana f (plural tisanes)
mur	Noun	mur m (plural murs)
complex	Noun	complex m (plural complexos)
papa	Noun	papa m (plural papes)
cars	Noun	cars
puta	Noun	puta f (plural putes)
moment	Noun	moment m (plural moments)
hab	Noun	hab
mania	Noun	mania f (plural manies)
antecessor	Noun	antecessor m (plural antecessors, feminine antecessora)
ulna	Noun	ulna f (plural ulnes)
resistent	Noun	resistent m, f (plural resistents)
colla	Noun	colla f (plural colles)
mill	Noun	mill m (plural mills)
politeista	Noun	politeista m, f (plural politeistes)
parca	Noun	parca f (plural parques)
iac	Noun	iac m (plural iacs)
segment	Noun	segment m (plural segments)
indi	Noun	indi m (plural indis, feminine índia)
indi	Noun	indi m (uncountable)
tutor	Noun	tutor m (plural tutors, feminine tutora)
cura	Noun	cura f (plural cures)
manta	Noun	manta f (plural mantes)
assessor	Noun	assessor m (plural assessors, feminine assessora)
mi	Noun	mi m (plural mis)
mi	Noun	mi f (plural mis)
arginina	Noun	arginina f (uncountable)
cine	Noun	cine m (plural cines)
neu	Noun	neu f (plural neus)
decret	Noun	decret m (plural decrets)
pont	Noun	pont m (plural ponts)
atac	Noun	atac m (plural atacs)
rai	Noun	rai m (plural rais)
vandalisme	Noun	vandalisme m (plural vandalismes)
lis	Noun	lis m (plural lisos)
grau	Noun	grau m (plural graus)
mongol	Noun	mongol m (plural mongols, feminine mongola)
boli	Noun	boli m (plural bolis)
moral	Noun	moral f (plural morals)
campus	Noun	campus m (plural campus)
panda	Noun	panda m (plural pandes)
dinar	Noun	dinar m (plural dinars)
dinar	Noun	dinar m (plural dinars)
vesper	Noun	vesper m (plural vespers)
molla	Noun	molla f (plural molles)
mare	Noun	mare f (plural mares)
acte	Noun	acte m (plural actes)
san	Noun	san f (plural sans)
i	Noun	i f (plural is)
biologia	Noun	biologia f (uncountable)
radiologia	Noun	radiologia f (uncountable)
tribunal	Noun	tribunal m (plural tribunals)
agricultura	Noun	agricultura f (plural agricultures)
belga	Noun	belga m, f (plural belgues)
censor	Noun	censor m (plural censors, feminine censora)
blues	Noun	blues m (uncountable)
berenar	Noun	berenar m (plural berenars)
apis	Noun	apis
mal	Noun	mal m (plural mals)
protector	Noun	protector m (plural protectors)
handbols	Noun	handbols
to	Noun	to m (plural tons)
pornografia	Noun	pornografia f (plural pornografies)
ment	Noun	ment f (plural ments)
salsa	Noun	salsa f (plural salses)
islam	Noun	islam m (plural islams)
bloc	Noun	bloc m (plural blocs)
passat	Noun	passat m (plural passats)
u	Noun	u f (plural us)
u	Noun	u m (plural uns)
sal	Noun	sal f (plural sals)
merda	Noun	merda f (plural merdes)
vila	Noun	vila f (plural viles)
col	Noun	col f (plural cols)
nord	Noun	nord m (uncountable)
geriatria	Noun	geriatria f (uncountable)
barons	Noun	barons
institut	Noun	institut m (plural instituts)
tall	Noun	tall m (plural talls)
dermatologia	Noun	dermatologia f (plural dermatologies)
farga	Noun	farga f (plural fargues)
sonar	Noun	sonar m (uncountable)
himen	Noun	himen m (plural hímens)
figa	Noun	figa f (plural figues)
pantera	Noun	pantera f (plural panteres)
au	Noun	au f (plural aus)
tabú	Noun	tabú m (plural tabús)
sulfur	Noun	sulfur m (plural sulfurs)
harmonia	Noun	harmonia f (plural harmonies)
taverna	Noun	taverna f (plural tavernes)
fel	Noun	fel m (plural fels)
forn	Noun	forn m (plural forns)
pres	Noun	pres m (plural presos, feminine presa)
color	Noun	color m (plural colors)
vista	Noun	vista f (plural vistes)
mena	Noun	mena f (plural menes)
rel	Noun	rel f (plural rels)
cop	Noun	cop m (plural cops)
satrapia	Noun	satrapia f (plural satrapies)
nata	Noun	nata f (plural nates)
mont	Noun	mont m (plural monts)
lambda	Noun	lambda f (plural lambdes)
família	Noun	família f (plural famílies)
carta	Noun	carta f (plural cartes)
analfabet	Noun	analfabet m (plural analfabets, feminine analfabeta)
titular	Noun	titular m (plural titulars)
sura	Noun	sura f (plural sures)
parlament	Noun	parlament m (plural parlaments)
galena	Noun	galena f (plural galenes)
medis	Noun	medis
all	Noun	all m (plural alls)
valor	Noun	valor m (plural valors)
filologia	Noun	filologia f (uncountable)
zel	Noun	zel m (plural zels)
alga	Noun	alga f (plural algues)
boles	Noun	boles
odis	Noun	odis
cosmologia	Noun	cosmologia f (plural cosmologies)
ambient	Noun	ambient m (plural ambients)
exorcista	Noun	exorcista m, f (plural exorcistes)
lupus	Noun	lupus m (uncountable)
prat	Noun	prat m (plural prats)
ducat	Noun	ducat m (plural ducats)
forta	Noun	forta f (plural fortes)
termes	Noun	termes
cents	Noun	cents
fe	Noun	fe f (plural fes)
tir	Noun	tir m (plural tirs)
animal	Noun	animal m (plural animals)
vers	Noun	vers m (plural versos)
bar	Noun	bar m (plural bars)
fem	Noun	fem m (plural fems)
bor	Noun	bor m (uncountable)
diagonal	Noun	diagonal f (plural diagonals)
pijama	Noun	pijama m (plural pijames)
ro	Noun	ro f (plural ros)
instrument	Noun	instrument m (plural instruments)
tigre	Noun	tigre m (plural tigres)
anagrama	Noun	anagrama m (plural anagrames)
actor	Noun	actor m (plural actors)
bomba	Noun	bomba f (plural bombes)
persona	Noun	persona f (plural persones)
sot	Noun	sot m (plural sots)
asteroide	Noun	asteroide m (plural asteroides)
cost	Noun	cost m (plural costs or costos)
broc	Noun	broc m (plural brocs)
accent	Noun	accent m (plural accents)
vara	Noun	vara f (plural vares)
futur	Noun	futur m (plural futurs)
rima	Noun	rima f (plural rimes)
mortal	Noun	mortal m, f (plural mortals)
geologia	Noun	geologia f (plural geologies)
infix	Noun	infix m (plural infixos)
intenció	Noun	intenció f (plural intencions)
hegemonia	Noun	hegemonia f (plural hegemonies)
do	Noun	do m (plural dons)
do	Noun	do m (plural dos)
cas	Noun	cas m (plural casos)
luxe	Noun	luxe m (plural luxes)
zulu	Noun	zulu m (plural zulus)
riba	Noun	riba f (plural ribes)
major	Noun	major m (plural majors)
major	Noun	major m, f (plural majors)
pedagogia	Noun	pedagogia f (uncountable)
dirigent	Noun	dirigent m (plural dirigents)
linx	Noun	linx m (plural linxs)
pila	Noun	pila f (plural piles)
bol	Noun	bol m (plural bols)
fantasia	Noun	fantasia f (plural fantasies)
notes	Noun	notes
meteorologia	Noun	meteorologia f (plural meteorologies)
bou	Noun	bou m (plural bous)
apertura	Noun	apertura f (plural apertures)
cos	Noun	cos m (plural cossos)
somriure	Noun	somriure m (plural somriures)
patates	Noun	patates
pasta	Noun	pasta f (plural pastes)
bola	Noun	bola f (plural boles)
artista	Noun	artista m, f (plural artistes)
ideologia	Noun	ideologia f (plural ideologies)
francés	Noun	francés m (plural francesos, feminine francesa)
mata	Noun	mata f (plural mates)
vigor	Noun	vigor m (plural vigors)
doctrina	Noun	doctrina f (plural doctrines)
seca	Noun	seca f (plural seques)
dit	Noun	dit m (plural dits)
nin	Noun	nin m (plural nins, feminine nina)
rost	Noun	rost m (plural rosts or rostos)
senat	Noun	senat m (plural senats)
piga	Noun	piga f (plural pigues)
cultura	Noun	cultura f (plural cultures)
ampere	Noun	ampere m (plural amperes)
amplitud	Noun	amplitud f (plural amplituds)
aura	Noun	aura f (plural aures)
suahili	Noun	suahili m, f (plural suahilis)
ornament	Noun	ornament m (plural ornaments)
cort	Noun	cort f (plural corts)
vet	Noun	vet m (plural vets)
lateral	Noun	lateral m, f (plural laterals)
dol	Noun	dol m (plural dols)
taxa	Noun	taxa f (plural taxes)
cranc	Noun	cranc m (plural crancs)
bac	Noun	bac m (plural bacs)
format	Noun	format m (plural formats)
saga	Noun	saga f (plural sagues)
saga	Noun	saga f (plural sagues)
fenomen	Noun	fenomen m (plural fenòmens)
lupa	Noun	lupa f (plural lupes)
feta	Noun	feta f (plural fetes)
eremita	Noun	eremita m, f (plural eremites)
experiment	Noun	experiment m (plural experiments)
central	Noun	central f (plural centrals)
nora	Noun	nora f (plural nores)
res	Noun	res
fotografia	Noun	fotografia f (plural fotografies)
fur	Noun	fur m (plural furs)
desert	Noun	desert m (plural deserts)
bes	Noun	bes
bes	Noun	bes m (plural besos)
bes	Noun	bes m (plural bessos)
atmosfera	Noun	atmosfera f (plural atmosferes)
astronomia	Noun	astronomia f (plural astronomies)
virga	Noun	virga f (plural virgues)
taca	Noun	taca f (plural taques)
poder	Noun	poder m (plural poders)
superorganisme	Noun	superorganisme m (plural superorganismes)
zeugma	Noun	zeugma m (plural zeugmes)
geometria	Noun	geometria f (plural geometries)
fi	Noun	fi f (plural fins)
fi	Noun	fi f (plural fis)
gra	Noun	gra m (plural grans)
turc	Noun	turc m (plural turcs, feminine turca)
aus	Noun	aus
jota	Noun	jota f (plural jotes)
jota	Noun	jota f (plural jotes)
femella	Noun	femella f (plural femelles)
pati	Noun	pati m (plural patis)
piano	Noun	piano m (plural pianos)
pretor	Noun	pretor m (plural pretors)
aire	Noun	aire m (plural aires)
cigar	Noun	cigar m (plural cigars)
debat	Noun	debat m (plural debats)
sender	Noun	sender m (plural senders)
pena	Noun	pena f (plural penes)
pleroma	Noun	pleroma m (uncountable)
ontologia	Noun	ontologia f (plural ontologies)
moments	Noun	moments
caviar	Noun	caviar m (plural caviars)
humor	Noun	humor m (plural humors)
taula	Noun	taula f (plural taules)
bolet	Noun	bolet m (plural bolets)
regiment	Noun	regiment m (plural regiments)
for	Noun	for m (plural fors)
ala	Noun	ala f (plural ales)
punt	Noun	punt m (plural punts)
neurologia	Noun	neurologia f (uncountable)
os	Noun	os m (plural ossos)
antilop	Noun	antilop m (plural antilops)
neboder	Noun	neboder m (plural neboders)
urna	Noun	urna f (plural urnes)
propis	Noun	propis
regal	Noun	regal m (plural regals)
aimara	Noun	aimara m, f (plural aimares)
fes	Noun	fes
data	Noun	data f (plural dates)
aliat	Noun	aliat m (plural aliats)
rosa	Noun	rosa f (plural roses)
mis	Noun	mis
mis	Noun	mis
taps	Noun	taps
lila	Noun	lila f (plural liles)
lila	Noun	lila m (plural liles)
erbi	Noun	erbi m (uncountable)
destructor	Noun	destructor m (plural destructors)
ham	Noun	ham m (plural hams)
swahili	Noun	swahili m, f (plural swahilis)
regla	Noun	regla f (plural regles)
rang	Noun	rang m (plural rangs)
naps	Noun	naps
metabolisme	Noun	metabolisme m (plural metabolismes)
Viena	Noun	Viena f
tast	Noun	tast m (plural tasts or tastos)
hassi	Noun	hassi m (uncountable)
ela	Noun	ela f (plural eles)
porc	Noun	porc m (plural porcs)
volts	Noun	volts
sauna	Noun	sauna f (plural saunes)
extern	Noun	extern m (plural externs, feminine externa)
baula	Noun	baula f (plural baules)
noi	Noun	noi m (plural nois, feminine noia)
fis	Noun	fis f
missa	Noun	missa f (plural misses)
salina	Noun	salina f (plural salines)
diamant	Noun	diamant m (plural diamants)
granat	Noun	granat m (plural granats)
temporal	Noun	temporal m (plural temporals)
ruta	Noun	ruta f (plural rutes)
oliva	Noun	oliva f (plural olives)
viola	Noun	viola f (plural violes)
viola	Noun	viola m, f (plural violes)
viola	Noun	viola f (plural violes)
hospital	Noun	hospital m (plural hospitals)
verbs	Noun	verbs
ordre	Noun	ordre m (plural ordres)
ordre	Noun	ordre f (plural ordres)
bombarder	Noun	bombarder m (plural bombarders)
paranoia	Noun	paranoia f (plural paranoies)
metal	Noun	metal m (plural metals)
caire	Noun	caire m (plural caires)
etapa	Noun	etapa f (plural etapes)
serbi	Noun	serbi m (plural serbis, feminine sèrbia)
gat	Noun	gat m (plural gats, feminine gata)
fang	Noun	fang m (plural fangs)
porta	Noun	porta f (plural portes)
fortuna	Noun	fortuna f (plural fortunes)
ble	Noun	ble m (plural blens)
arpa	Noun	arpa f (plural arpes)
pizza	Noun	pizza f (plural pizzes)
patata	Noun	patata f (plural patates)
brom	Noun	brom m (uncountable)
mina	Noun	mina f (plural mines)
episodi	Noun	episodi m (plural episodis)
dies	Noun	dies
trilogia	Noun	trilogia f (plural trilogies)
tabac	Noun	tabac m (plural tabacs)
vena	Noun	vena f (plural venes)
est	Noun	est m (uncountable)
musical	Noun	musical m (plural musicals)
immunologia	Noun	immunologia f (uncountable)
sirena	Noun	sirena f (plural sirenes)
dutxa	Noun	dutxa f (plural dutxes)
tren	Noun	tren m (plural trens)
anella	Noun	anella f (plural anelles)
grafit	Noun	grafit m (plural grafits)
agrimensor	Noun	agrimensor m, f (plural agrimensors)
mil	Noun	mil m (plural mils)
resina	Noun	resina f (plural resines)
gola	Noun	gola f (plural goles)
glans	Noun	glans
ros	Noun	ros m (plural rosos)
delegat	Noun	delegat m (plural delegats, feminine delegada)
gris	Noun	gris m (uncountable)
sigla	Noun	sigla f (plural sigles)
simi	Noun	simi m (plural simis)
terapeuta	Noun	terapeuta m, f (plural terapeutes)
globus	Noun	globus m (plural globus)
menjar	Noun	menjar m (plural menjars)
tenista	Noun	tenista m, f (plural tenistes)
sols	Noun	sols
festival	Noun	festival m (plural festivals)
ermita	Noun	ermita f (plural ermites)
gujarati	Noun	gujarati m (uncountable)
fluid	Noun	fluid m (plural fluids)
pop	Noun	pop m (plural pops)
volta	Noun	volta f (plural voltes)
cafeteria	Noun	cafeteria f (plural cafeteries)
celta	Noun	celta m, f (plural celtes)
troposfera	Noun	troposfera f (plural troposferes)
testament	Noun	testament m (plural testaments)
pe	Noun	pe f (plural pes)
fet	Noun	fet m (plural fets)
multa	Noun	multa f (plural multes)
rot	Noun	rot m (plural rots)
tron	Noun	tron m (plural trons)
orb	Noun	orb m (uncountable)
vampir	Noun	vampir m (plural vampirs)
blanc	Noun	blanc m (plural blancs)
antropomorfisme	Noun	antropomorfisme m (plural antropomorfismes)
granit	Noun	granit m (plural granits)
ironia	Noun	ironia f (plural ironies)
home	Noun	home m (plural homes or hòmens)
zero	Noun	zero m (plural zeros)
bel	Noun	bel m (plural bels)
desena	Noun	desena f (plural desenes)
corona	Noun	corona f (plural corones)
fusta	Noun	fusta f (plural fustes)
seu	Noun	seu m (plural seus)
via	Noun	via f (plural vies)
aspa	Noun	aspa f (plural aspes)
barri	Noun	barri m (plural barris)
irlandés	Noun	irlandés m (plural irlandesos, feminine irlandesa)
molt	Noun	molt m (uncountable)
anatomia	Noun	anatomia f (plural anatomies)
film	Noun	film m (plural films)
tanc	Noun	tanc m (plural tancs)
sinus	Noun	sinus m (plural sinus)
circular	Noun	circular f (plural circulars)
gelada	Noun	gelada f (plural gelades)
pilota	Noun	pilota f (plural pilotes)
ruptura	Noun	ruptura f (plural ruptures)
geografia	Noun	geografia f (plural geografies)
creditor	Noun	creditor m (plural creditors, feminine creditora)
patriota	Noun	patriota m, f (plural patriotes)
lava	Noun	lava f (plural laves)
vidus	Noun	vidus
ant	Noun	ant m (plural ants)
fit	Noun	fit m (plural fits)
rem	Noun	rem m (plural rems)
tapa	Noun	tapa f (plural tapes)
minut	Noun	minut m (plural minuts)
ge	Noun	ge f (plural ges)
culpa	Noun	culpa f (plural culpes)
riure	Noun	riure m (plural riures)
ex	Noun	ex m, f (plural ex)
censura	Noun	censura f (plural censures)
coiot	Noun	coiot m (plural coiots)
sud	Noun	sud m (uncountable)
partitura	Noun	partitura f (plural partitures)
maraca	Noun	maraca f (plural maraques)
vas	Noun	vas m (plural vasos)
gir	Noun	gir f (plural girs)
onomatopeia	Noun	onomatopeia f (plural onomatopeies)
tap	Noun	tap m (plural taps)
cim	Noun	cim m (plural cims)
lector	Noun	lector m (plural lectors)
tara	Noun	tara f (plural tares)
bocs	Noun	bocs
discurs	Noun	discurs m (plural discursos)
honor	Noun	honor m (plural honors)
zona	Noun	zona f (plural zones)
ves	Noun	ves
vaga	Noun	vaga f (plural vagues)
tapes	Noun	tapes
pelvis	Noun	pelvis f (plural pelvis)
pastor	Noun	pastor m (plural pastors)
tip	Noun	tip m (plural tips)
mitologia	Noun	mitologia f (plural mitologies)
mem	Noun	mem m (plural mems)
fagot	Noun	fagot m (plural fagots)
infant	Noun	infant m (plural infants)
epitafi	Noun	epitafi m (plural epitafis)
narval	Noun	narval m (plural narvals)
calamar	Noun	calamar m (plural calamars)
khmer	Noun	khmer m, f (plural khmers)
manat	Noun	manat m (plural manats)
calor	Noun	calor f (plural calors)
model	Noun	model m (plural models)
dada	Noun	dada f (plural dades)
host	Noun	host m (plural hosts or hostos)
fat	Noun	fat m (uncountable)
soja	Noun	soja f (plural soges)
cella	Noun	cella f (plural celles)
ésser	Noun	ésser m (plural éssers)
pilots	Noun	pilots
palla	Noun	palla f (plural palles)
meteorit	Noun	meteorit m (plural meteorits)
idea	Noun	idea f (plural idees)
costa	Noun	costa f (plural costes)
ascensor	Noun	ascensor m (plural ascensors)
coa	Noun	coa f (plural coes)
so	Noun	so m (plural sons)
empatia	Noun	empatia f (plural empaties)
mel	Noun	mel f (plural mels)
anus	Noun	anus m (plural anus)
altar	Noun	altar m (plural altars)
buc	Noun	buc m (plural bucs)
literatura	Noun	literatura f (plural literatures)
gen	Noun	gen m (plural gens)
ordi	Noun	ordi m (plural ordis)
sonda	Noun	sonda f (plural sondes)
e	Noun	e f (plural es)
metre	Noun	metre m (plural metres)
metil	Noun	metil m (plural metils)
ballet	Noun	ballet m (plural ballets)
unió	Noun	unió f (plural unions)
oasi	Noun	oasi m (plural oasis)
lira	Noun	lira f (plural lires)
got	Noun	got m (plural gots)
got	Noun	got m (plural gots, feminine goda)
as	Noun	as m (plural asos)
as	Noun	as m (plural asos)
as	Noun	as
optimista	Noun	optimista m, f (plural optimistes)
prototip	Noun	prototip m (plural prototips)
cometa	Noun	cometa m (plural cometes)
cometa	Noun	cometa f (plural cometes)
feroés	Noun	feroés m (plural feroesos, feminine feroesa)
drac	Noun	drac m (plural dracs)
gaiter	Noun	gaiter m (plural gaiters)
endorfina	Noun	endorfina f (plural endorfines)
deure	Noun	deure m (plural deures)
fraseologia	Noun	fraseologia f (plural fraseologies)
roda	Noun	roda f (plural rodes)
referent	Noun	referent m (plural referents)
protons	Noun	protons
beat	Noun	beat m (plural beats)
planeta	Noun	planeta m (plural planetes)
planeta	Noun	planeta f (plural planetes)
cala	Noun	cala f (plural cales)
secret	Noun	secret m (plural secrets)
vies	Noun	vies
asexual	Noun	asexual m, f (plural asexuals)
manga	Noun	manga m (plural mangues)
flauta	Noun	flauta f (plural flautes)
fragment	Noun	fragment m (plural fragments)
sexisme	Noun	sexisme m (uncountable)
bronze	Noun	bronze m (plural bronzes)
paella	Noun	paella f (plural paelles)
longitud	Noun	longitud f (plural longituds)
reforma	Noun	reforma f (plural reformes)
safir	Noun	safir m (plural safirs)
bateria	Noun	bateria f (plural bateries)
ull	Noun	ull m (plural ulls)
maig	Noun	maig m (plural maigs)
marina	Noun	marina f (plural marines)
aeroport	Noun	aeroport m (plural aeroports)
pacient	Noun	pacient m, f (plural pacients)
avet	Noun	avet m (plural avets)
mot	Noun	mot m (plural mots)
monegasc	Noun	monegasc m (plural monegascs or monegascos, feminine monegasca)
teorema	Noun	teorema m (plural teoremes)
komi	Noun	komi m, f (plural komis)
nova	Noun	nova f (plural noves)
violoncel	Noun	violoncel m (plural violoncels)
cent	Noun	cent m (plural cents)
cent	Noun	cent m (plural cents)
avis	Noun	avis
prefix	Noun	prefix m (plural prefixos)
om	Noun	om m (plural oms)
metans	Noun	metans
extrem	Noun	extrem m (plural extrems)
vi	Noun	vi m (plural vins)
temperatura	Noun	temperatura f (plural temperatures)
monoteista	Noun	monoteista m, f (plural monoteistes)
corner	Noun	corner m (plural corners)
acord	Noun	acord m (plural acords)
robot	Noun	robot m (plural robots)
argó	Noun	argó m (uncountable)
elf	Noun	elf m (plural elfs)
bé	Noun	bé m (plural béns)
arc	Noun	arc m (plural arcs)
gent	Noun	gent f (uncountable)
perineu	Noun	perineu m (plural perineus)
figura	Noun	figura f (plural figures)
demagog	Noun	demagog m (plural demagogs, feminine demagoga)
urologia	Noun	urologia f (uncountable)
plural	Noun	plural m (plural plurals)
zebra	Noun	zebra f (plural zebres)
tuli	Noun	tuli m (uncountable)
mariner	Noun	mariner m (plural mariners, feminine marinera)
cep	Noun	cep m (plural ceps)
mandarina	Noun	mandarina f (plural mandarines)
fresa	Noun	fresa m (plural freses)
fonologia	Noun	fonologia f (plural fonologies)
doll	Noun	doll m (plural dolls)
cantautor	Noun	cantautor m (plural cantautors, feminine cantautora)
tassa	Noun	tassa f (plural tasses)
gel	Noun	gel m (plural gels)
certamen	Noun	certamen m (plural certàmens)
terrorista	Noun	terrorista m, f (plural terroristes)
monitor	Noun	monitor m (plural monitors)
epidemiologia	Noun	epidemiologia f (uncountable)
vagina	Noun	vagina f (plural vagines)
contra	Noun	contra m (plural contres)
bit	Noun	bit m (plural bits)
barra	Noun	barra f (plural barres)
banya	Noun	banya f (plural banyes)
labor	Noun	labor m (plural labors)
brigada	Noun	brigada f (plural brigades)
tribus	Noun	tribus
vicis	Noun	vicis
eben	Noun	eben m (plural ébens)
mirra	Noun	mirra f (uncountable)
bota	Noun	bota f (plural botes)
vicepresident	Noun	vicepresident m (plural vicepresidents, feminine vicepresidenta)
pols	Noun	pols m (plural polsos)
pols	Noun	pols f (plural pols)
pols	Noun	pols
amor	Noun	amor m (plural amors)
sort	Noun	sort f (uncountable)
parada	Noun	parada f (plural parades)
prosa	Noun	prosa f (uncountable)
hidrat	Noun	hidrat m (plural hidrats)
palmes	Noun	palmes
sitja	Noun	sitja f (plural sitges)
abadia	Noun	abadia f (plural abadies)
cambra	Noun	cambra f (plural cambres)
massa	Noun	massa f (plural masses)
gustos	Noun	gustos
professor	Noun	professor m (plural professors, feminine professora)
coure	Noun	coure m (uncountable)
ari	Noun	ari m (plural aris, feminine ària)
cubans	Noun	cubans
pica	Noun	pica f (plural piques)
medicament	Noun	medicament m (plural medicaments)
ni	Noun	ni f (plural nis)
bolis	Noun	bolis
musa	Noun	musa f (plural muses)
alens	Noun	alens
bíblia	Noun	bíblia f (plural bíblies)
armer	Noun	armer m (plural armers)
ren	Noun	ren m (plural rens)
elements	Noun	elements
genealogia	Noun	genealogia f (plural genealogies)
tirans	Noun	tirans
becs	Noun	becs
gener	Noun	gener m (plural geners)
barber	Noun	barber m (plural barbers, feminine barbera)
manifest	Noun	manifest m (plural manifests or manifestos)
arquer	Noun	arquer m (plural arquers, feminine arquera)
realista	Noun	realista m, f (plural realistes)
carpa	Noun	carpa f (plural carpes)
tons	Noun	tons
captura	Noun	captura f (plural captures)
ena	Noun	ena f (plural enes)
be	Noun	be f (plural bes)
be	Noun	be m (plural bens)
fauna	Noun	fauna f (plural faunes)
adult	Noun	adult m (plural adults, feminine adulta)
sigma	Noun	sigma f (plural sigmes)
ges	Noun	ges
alfabet	Noun	alfabet m (plural alfabets)
poeta	Noun	poeta m, f (plural poetes)
holmi	Noun	holmi m (uncountable)
conseller	Noun	conseller m (plural consellers, feminine consellera)
emir	Noun	emir m (plural emirs)
mineralogia	Noun	mineralogia f (plural mineralogies)
polla	Noun	polla f (plural polles)
boca	Noun	boca f (plural boques)
cocoter	Noun	cocoter m (plural cocoters)
mes	Noun	mes m (plural mesos)
costum	Noun	costum m (plural costums)
impuls	Noun	impuls m (plural impulsos)
interval	Noun	interval m (plural intervals)
conductor	Noun	conductor m (plural conductors)
misa	Noun	misa m (plural mises)
teoria	Noun	teoria f (plural teories)
categoria	Noun	categoria f (plural categories)
marxisme	Noun	marxisme m (plural marxismes)
cor	Noun	cor m (plural cors)
cor	Noun	cor m (plural cors)
mica	Noun	mica f (plural miques)
son	Noun	son m (plural sons)
son	Noun	son f (plural sons)
tutela	Noun	tutela f (plural tuteles)
flota	Noun	flota f (plural flotes)
exemplar	Noun	exemplar m (plural exemplars)
popa	Noun	popa f (plural popes)
colon	Noun	colon m (plural colons)
aranya	Noun	aranya f (plural aranyes)
fus	Noun	fus m (plural fusos)
terror	Noun	terror m, f (plural terrors)
malla	Noun	malla f (plural malles)
tetralogia	Noun	tetralogia f (plural tetralogies)
tortura	Noun	tortura f (plural tortures)
miss	Noun	miss f (plural misses)
temps	Noun	temps m (plural temps)
panorama	Noun	panorama m (plural panorames)
vela	Noun	vela f (plural veles)
pansexual	Noun	pansexual m, f (plural pansexuals)
eta	Noun	eta f (plural etes)
soldat	Noun	soldat m (plural soldats)
egoista	Noun	egoista m, f (plural egoistes)
roba	Noun	roba f (plural robes)
perla	Noun	perla f (plural perles)
defensor	Noun	defensor m (plural defensors)
pol	Noun	pol m, f (plural pols)
foc	Noun	foc m (plural focs)
ritus	Noun	ritus
esmorzar	Noun	esmorzar m (plural esmorzars)
tro	Noun	tro m (plural trons)
pesta	Noun	pesta f (plural pestes)
maga	Noun	maga f (plural magues)
crom	Noun	crom m (uncountable)
continent	Noun	continent m (plural continents)
ales	Noun	ales
ona	Noun	ona f (plural ones)
verb	Noun	verb m (plural verbs)
open	Noun	open m (plural open or òpens)
antropologia	Noun	antropologia f (uncountable)
abdomen	Noun	abdomen m (plural abdòmens)
ve	Noun	ve f (plural ves)
ionosfera	Noun	ionosfera f (plural ionosferes)
virus	Noun	virus m (plural virus)
patologia	Noun	patologia f (uncountable)
val	Noun	val m (plural vals)
delta	Noun	delta f (plural deltes)
mas	Noun	mas m (plural masos)
variant	Noun	variant m (plural variants)
tempo	Noun	tempo m (plural tempos)
cau	Noun	cau m (plural caus)
diftong	Noun	diftong m (plural diftongs)
selva	Noun	selva f (plural selves)
adrenalina	Noun	adrenalina f (uncountable)
brot	Noun	brot m (plural brots)
pis	Noun	pis m (plural pisos)
gust	Noun	gust m (plural gusts or gustos)
pet	Noun	pet m (plural pets)
material	Noun	material m (plural materials)
trames	Noun	trames
vespa	Noun	vespa f (plural vespes)
final	Noun	final m (plural finals)
final	Noun	final f (plural finals)
suc	Noun	suc m (plural sucs)
suma	Noun	suma m (plural sumes)
trama	Noun	trama f (plural trames)
termosfera	Noun	termosfera f (plural termosferes)
arts	Noun	arts
xaman	Noun	xaman m (plural xamans)
rus	Noun	rus m (plural russos, feminine russa)
joc	Noun	joc m (plural jocs)
punta	Noun	punta m (plural puntes)
droga	Noun	droga f (plural drogues)
basa	Noun	basa f (plural bases)
beta	Noun	beta f (plural betes)
beta	Noun	beta f (plural betes)
viure	Noun	viure m (uncountable)
intervenció	Noun	intervenció f (plural intervencions)
pipa	Noun	pipa f (plural pipes)
mul	Noun	mul m (plural muls)
portal	Noun	portal m (plural portals)
alfa	Noun	alfa f (plural alfes)
fotó	Noun	fotó m (plural fotons)
coll	Noun	coll m (plural colls)
protocol	Noun	protocol m (plural protocols)
algoritme	Noun	algoritme m (plural algoritmes)
flegma	Noun	flegma f (plural flegmes)
nens	Noun	nens
assistent	Noun	assistent m (plural assistents)
planta	Noun	planta f (plural plantes)
marc	Noun	marc m (plural marcs)
ministeri	Noun	ministeri m (plural ministeris)
principat	Noun	principat m (plural principats)
conclave	Noun	conclave m (plural conclaves)
logo	Noun	logo m (plural logos)
gnom	Noun	gnom m (plural gnoms)
armada	Noun	armada f (plural armades)
diner	Noun	diner m (plural diners)
etnocentrisme	Noun	etnocentrisme m (plural etnocentrismes)
por	Noun	por m (plural pors)
humans	Noun	humans
resultat	Noun	resultat m (plural resultats)
fura	Noun	fura f (plural fures)
mode	Noun	mode m (plural modes)
maionesa	Noun	maionesa f (plural maioneses)
rudiment	Noun	rudiment m (plural rudiments)
la	Noun	la m (plural las)
heterosexual	Noun	heterosexual m, f (plural heterosexuals)
bord	Noun	bord m (plural bords)
marca	Noun	marca f (plural marques)
autor	Noun	autor m (plural autors, feminine autora)
fera	Noun	fera f (plural feres)
pilar	Noun	pilar m (plural pilares)
islandés	Noun	islandés m (plural islandesos, feminine islandesa)
rival	Noun	rival m, f (plural rivals)
dolor	Noun	dolor m, f (plural dolors)
fa	Noun	fa m (plural fes)
autonomia	Noun	autonomia f (plural autonomies)
instant	Noun	instant m (plural instants)
banda	Noun	banda f (plural bandes)
columna	Noun	columna f (plural columnes)
rat	Noun	rat m (plural rats)
meta	Noun	meta f (plural metes)
boda	Noun	boda f (plural bodes)
volt	Noun	volt m (plural volts)
princesa	Noun	princesa f (plural princeses)
enzim	Noun	enzim m (plural enzims)
San	Noun	San m
superior	Noun	superior m, f (plural superiors)
auto	Noun	auto m (plural autos)
vector	Noun	vector m (plural vectors)
gall	Noun	gall m (plural galls)
argument	Noun	argument m (plural arguments)
coca	Noun	coca f (plural coques)
idioma	Noun	idioma m (plural idiomes)
visita	Noun	visita f (plural visites)
somali	Noun	somali m, f (plural somalis)
gemma	Noun	gemma f (plural gemmes)
palpebra	Noun	palpebra f (plural palpebres)
pes	Noun	pes m (plural pesos)
sang	Noun	sang f (plural sangs)
propaganda	Noun	propaganda f (plural propagandes)
jou	Noun	jou m (plural jous)
terminal	Noun	terminal m (plural terminals)
savi	Noun	savi m (plural savis, feminine sàvia)
membrana	Noun	membrana f (plural membranes)
avi	Noun	avi m (plural avis, feminine àvia)
magistrat	Noun	magistrat m, f (plural magistrats)
franc	Noun	franc m (plural francs)
clamor	Noun	clamor m, f (plural clamors)
miliard	Noun	miliard m (plural miliards)
adorer	Noun	adorer m (plural adorers, feminine adorera)
sonet	Noun	sonet m (plural sonets)
tres	Noun	tres m (plural tresos)
baptista	Noun	baptista m, f (plural baptistes)
exilis	Noun	exilis
total	Noun	total m (plural totals)
neula	Noun	neula f (plural neules)
deserts	Noun	deserts
traductor	Noun	traductor m (plural traductors, feminine traductora)
comerciant	Noun	comerciant m (plural comerciants)
falla	Noun	falla f (plural falles)
falla	Noun	falla f (plural falles)
disciplina	Noun	disciplina f (plural disciplines)
trampa	Noun	trampa f (plural trampes)
gol	Noun	gol m (plural gols)
parta	Noun	parta f (plural partes)
mort	Noun	mort f (uncountable)
duel	Noun	duel m (plural duels)
imam	Noun	imam m (plural imams)
merder	Noun	merder f (plural merders)
instruments	Noun	instruments
basc	Noun	basc m (plural bascs or bascos, feminine basca)
vot	Noun	vot m (plural vots)
bala	Noun	bala f (plural bales)
transport	Noun	transport m (plural transports)
euro	Noun	euro m (plural euros)
abats	Noun	abats
poll	Noun	poll m (plural polls)
poll	Noun	poll m (plural polls)
nina	Noun	nina f (plural nines, masculine nin)
talent	Noun	talent m (plural talents)
jazz	Noun	jazz m (plural jazz)
monopoli	Noun	monopoli m (plural monopolis)
factor	Noun	factor m (plural factors)
poema	Noun	poema m (plural poemes)
gastronomia	Noun	gastronomia f (plural gastronomies)
analogia	Noun	analogia f (plural analogies)
fibra	Noun	fibra f (plural fibres)
bigot	Noun	bigot m (plural bigots)
cortina	Noun	cortina f (plural cortines)
vol	Noun	vol m (plural vols)
blau	Noun	blau m (plural blaus)
castor	Noun	castor m (plural castors)
recepta	Noun	recepta f (plural receptes)
ceba	Noun	ceba f (plural cebes)
fila	Noun	fila f (plural files)
caput	Noun	caput m (uncountable)
santa	Noun	santa f (plural santes)
dona	Noun	dona f (plural dones)
mut	Noun	mut m (plural muts, feminine muda)
terra	Noun	terra f (plural terres)
terra	Noun	terra m (plural terres)
aorta	Noun	aorta f (plural aortes)
rendes	Noun	rendes
moll	Noun	moll m (uncountable)
moll	Noun	moll m (plural molls)
moll	Noun	moll m (plural molls)
flux	Noun	flux m (plural fluxos)
tema	Noun	tema m (plural temes)
sals	Noun	sals
vint	Noun	vint m (plural vints)
financer	Noun	financer m (plural financers, feminine financera)
cora	Noun	cora f (plural cores)
pinta	Noun	pinta f (plural pintes)
pinta	Noun	pinta f (plural pintes)
agenda	Noun	agenda f (plural agendes)
nena	Noun	nena f (plural nenes, masculine nen)
dots	Noun	dots
lema	Noun	lema m (plural lemes)
mundial	Noun	mundial m (plural mundials)
domini	Noun	domini m (plural dominis)
rata	Noun	rata f (plural rates)
estri	Noun	estri m (plural estris)
oficial	Noun	oficial m (plural oficials)
metres	Noun	metres
casa	Noun	casa f (plural cases)
larva	Noun	larva f (plural larves)
pota	Noun	pota f (plural potes)
te	Noun	te f (plural tes)
te	Noun	te m (plural tes)
atribut	Noun	atribut m (plural atributs)
bits	Noun	bits
prostituta	Noun	prostituta f (plural prostitutes)
ritual	Noun	ritual m (plural rituals)
doctor	Noun	doctor m (plural doctors)
sol	Noun	sol m (plural sols)
sol	Noun	sol m (plural sols)
sol	Noun	sol m (plural sols)
president	Noun	president m (plural presidents)
antimoni	Noun	antimoni m (uncountable)
cuir	Noun	cuir m (plural cuirs)
uns	Noun	uns
herois	Noun	herois
pausa	Noun	pausa f (plural pauses)
rock	Noun	rock m (uncountable)
lavabo	Noun	lavabo m (plural lavabos)
or	Noun	or m (plural ors)
flor	Noun	flor f (plural flors)
amo	Noun	amo m (plural amos, feminine ama)
gran	Noun	gran m (plural grans)
tau	Noun	tau f (plural taus)
gallina	Noun	gallina f (plural gallines)
pianista	Noun	pianista m, f (plural pianistes)
far	Noun	far m (plural fars)
plat	Noun	plat m (plural plats)
risc	Noun	risc m (plural riscs or riscos)
hindi	Noun	hindi m (uncountable)
mandra	Noun	mandra f (plural mandres)
boc	Noun	boc m (plural bocs)
dansa	Noun	dansa f (plural danses)
marxista	Noun	marxista m, f (plural marxistes)
tub	Noun	tub m (plural tubs)
fiola	Noun	fiola f (plural fioles)
collar	Noun	collar m (plural collars)
liti	Noun	liti m (uncountable)
oca	Noun	oca f (plural oques)
terminologia	Noun	terminologia f (plural terminologies)
ou	Noun	ou m (plural ous)
gerundi	Noun	gerundi m (plural gerundis)
meló	Noun	meló m (plural melons)
moda	Noun	moda f (plural modes)
gas	Noun	gas m (plural gasos)
carrer	Noun	carrer m (plural carrers)
biografia	Noun	biografia f (plural biografies)
cuc	Noun	cuc m (plural cucs)
sons	Noun	sons
aula	Noun	aula f (plural aules)
acer	Noun	acer m (uncountable)
hac	Noun	hac f (plural hacs)
plasma	Noun	plasma m (plural plasmes)
deus	Noun	deus
mag	Noun	mag m (plural mags, feminine maga)
de	Noun	de f (plural des)
caiman	Noun	caiman m (plural caimans)
vermut	Noun	vermut m (plural vermuts)
zeta	Noun	zeta f (plural zetes)
cometes	Noun	cometes
latitud	Noun	latitud m (plural latituds)
bibliografia	Noun	bibliografia f (plural bibliografies)
organisme	Noun	organisme m (plural organismes)
semifinal	Noun	semifinal m (plural semifinals)
pirata	Noun	pirata m, f (plural pirates)
voler	Noun	voler m (plural volers)
salts	Noun	salts
maori	Noun	maori m, f (plural maoris)
capsa	Noun	capsa f (plural capses)
expert	Noun	expert m (plural experts, feminine experta)
serra	Noun	serra f (plural serres)
lapsus	Noun	lapsus m (plural lapsus)
barba	Noun	barba f (plural barbes)
successor	Noun	successor m (plural successors)
faraó	Noun	faraó m (plural faraons, feminine faraona)
kurd	Noun	kurd m (plural kurds, feminine kurda)
paleta	Noun	paleta m, f (plural paletes)
peli	Noun	peli f (plural pelis)
metall	Noun	metall m (plural metalls)
petroli	Noun	petroli m (plural petrolis)
bisexual	Noun	bisexual m, f (plural bisexuals)
mico	Noun	mico m (plural micos)
gata	Noun	gata f (plural gates)
liberalisme	Noun	liberalisme m (plural liberalismes)
fil	Noun	fil m (plural fils)
interior	Noun	interior m (plural interiors)
eines	Noun	eines
pista	Noun	pista f (plural pistes)
fred	Noun	fred m, f (plural freds)
catapulta	Noun	catapulta f (plural catapultes)
focus	Noun	focus m (plural focus)
resta	Noun	resta f (plural restes)
teologia	Noun	teologia f (plural teologies)
arma	Noun	arma f (plural armes)
inventor	Noun	inventor m (plural inventors, feminine inventora)
radis	Noun	radis
niobi	Noun	niobi m (uncountable)
plata	Noun	plata f (uncountable)
talp	Noun	talp m (plural talps)
dieta	Noun	dieta f (plural dietes)
valentia	Noun	valentia f (plural valenties)
barca	Noun	barca f (plural barques)
vuit	Noun	vuit m (plural vuits)
dei	Noun	dei f (plural deis)
tona	Noun	tona f (plural tones)
melodia	Noun	melodia f (plural melodies)
racista	Noun	racista m, f (plural racistes)
bot	Noun	bot m (plural bots)
bot	Noun	bot m (plural bots)
bot	Noun	bot m (plural bots)
biga	Noun	biga f (plural bigues)
tsar	Noun	tsar m (plural tsars)
branca	Noun	branca f (plural branques)
ornitorinc	Noun	ornitorinc m (plural ornitorincs)
absurd	Noun	absurd m (plural absurds)
